College,Branch,Exam,Year,Tuition_Fee,Hostel_Fee,Misc_Fee,OneTime_Fee,Total_First_Year,Total_Annual,Scholarship_Eligible
ACU,Electrical and Electronics Engineering,KCET,2024,79439,83817,10903,21558,195717,174159,Yes
MVJCE,Mechanical Engineering,KCET,2023,82321,76001,19740,20552,198614,178062,No
SDMIT,Computer Science and Engineering,COMEDK,2024,200074,93310,13272,28731,335387,306656,No
DSATM,Robotics and Automation Engineering,KCET,2023,60387,75364,9277,11199,156227,145028,Yes
MSRUAS,Data Science,COMEDK,2023,218574,90518,11512,24907,345511,320604,No
ACU,Aerospace Engineering,KCET,2023,66558,65655,18943,28667,179823,151156,Yes
RIT,Chemical Engineering,COMEDK,2023,187984,85266,18943,14627,306820,292193,No
RVCE,Artificial Intelligence and Data Science,KCET,2024,50007,83549,11391,21262,166209,144947,No
VVCE,Computer Science and Engineering,COMEDK,2023,175358,84966,9572,15736,285632,269896,Yes
JIT,Mechanical Engineering,KCET,2024,70118,86954,10438,20801,188311,167510,No
RNSIT,Chemical Engineering,COMEDK,2024,205130,91492,16287,14544,327453,312909,Yes
GMIT,Mechanical Engineering,KCET,2023,79289,63277,15199,21557,179322,157765,No
GMIT,Data Science,COMEDK,2023,184864,74408,9351,17898,286521,268623,No
RAIT,Chemical Engineering,COMEDK,2024,223111,76514,9964,11029,320618,309589,Yes
DrAIT,Electronics and Communication Engineering,COMEDK,2023,211779,86467,14577,20015,332838,312823,Yes
VVIT,Artificial Intelligence and Data Science,KCET,2023,73909,76169,16447,17660,184185,166525,Yes
SIT,Electrical and Electronics Engineering,COMEDK,2024,166353,70447,8129,15261,260190,244929,Yes
YKCE,Aerospace Engineering,COMEDK,2024,232729,78020,12753,18322,341824,323502,Yes
RIT,Mechanical Engineering,COMEDK,2024,243074,89987,11192,15685,359938,344253,Yes
RIT,Robotics and Automation Engineering,COMEDK,2024,193480,93444,14699,22085,323708,301623,Yes
CITGubbi,Artificial Intelligence and Data Science,KCET,2024,80308,90359,13845,13145,197657,184512,No
MVJCE,Electrical and Electronics Engineering,KCET,2023,51981,82879,14149,14007,163016,149009,Yes
NIE,Robotics and Automation Engineering,COMEDK,2023,226264,83549,11613,16735,338161,321426,No
GMIT,Computer Science and Engineering,COMEDK,2024,248141,77049,12607,26189,363986,337797,No
RAIT,Chemical Engineering,KCET,2023,68811,73875,13577,16232,172495,156263,Yes
UVCE,Civil Engineering,KCET,2023,73014,76767,15499,23860,189140,165280,No
MSRUAS,Electrical and Electronics Engineering,COMEDK,2023,230363,90710,10184,24814,356071,331257,No
KLSGIT,Data Science,KCET,2024,72953,64610,17683,10593,165839,155246,No
RVCE,Civil Engineering,COMEDK,2024,249601,67220,18932,15034,350787,335753,Yes
EastPoint,Electronics and Communication Engineering,COMEDK,2024,202355,88243,18664,13264,322526,309262,No
JNNCE,Civil Engineering,COMEDK,2024,172729,61840,17827,17266,269662,252396,Yes
AEC,Aerospace Engineering,COMEDK,2023,167345,91892,9917,11762,280916,269154,No
PESCE,Electrical and Electronics Engineering,COMEDK,2023,215486,80545,12706,16562,325299,308737,No
GMIT,Electronics and Communication Engineering,KCET,2023,52606,60392,13098,12186,138282,126096,Yes
SCEM,Mechanical Engineering,COMEDK,2024,196015,93981,11724,13035,314755,301720,Yes
VemanaIT,Biotechnology,COMEDK,2024,191599,93094,18892,24514,328099,303585,Yes
DSATM,Mechanical Engineering,KCET,2024,83826,82879,15898,20223,202826,182603,Yes
KSIT,Biotechnology,KCET,2024,59588,81082,19236,21642,181548,159906,No
AITM,Computer Science and Engineering,COMEDK,2024,193799,73666,11966,21908,301339,279431,Yes
RNSIT,Chemical Engineering,KCET,2023,83002,65972,15875,19461,184310,164849,No
DSCE,Biotechnology,COMEDK,2023,217869,70918,9381,29485,327653,298168,Yes
RIT,Information Science and Engineering,KCET,2024,62422,83735,16099,21188,183444,162256,No
MVJCE,Electronics and Communication Engineering,KCET,2023,63256,62210,12527,15448,153441,137993,Yes
NMIT,Artificial Intelligence and Data Science,KCET,2024,61765,89109,19970,14967,185811,170844,Yes
EastPoint,Chemical Engineering,KCET,2024,63633,85065,9571,15254,173523,158269,No
RIT,Artificial Intelligence and Data Science,KCET,2024,75076,65356,15185,11370,166987,155617,No
AITM,Chemical Engineering,KCET,2024,78815,77148,10250,24882,191095,166213,Yes
SDMIT,Computer Science and Engineering,KCET,2024,81146,82660,18829,17475,200110,182635,Yes
UVCE,Biotechnology,KCET,2023,58476,91113,12202,18755,180546,161791,Yes
KLEIT,Data Science,COMEDK,2024,235694,78941,13404,24864,352903,328039,Yes
RVCE,Data Science,KCET,2023,72378,88578,13111,17345,191412,174067,No
VVIT,Computer Science and Engineering,COMEDK,2024,245934,68339,18691,18859,351823,332964,Yes
RNSIT,Artificial Intelligence and Data Science,COMEDK,2024,184261,87898,15932,29111,317202,288091,Yes
RNSIT,Robotics and Automation Engineering,KCET,2024,54242,76620,9847,18027,158736,140709,No
AECMandya,Information Science and Engineering,KCET,2023,75722,92982,10586,23427,202717,179290,Yes
PRES,Civil Engineering,KCET,2024,60544,72840,8870,24938,167192,142254,Yes
AEC,Mechanical Engineering,COMEDK,2023,198375,81236,19523,14306,313440,299134,Yes
VIT,Mechanical Engineering,KCET,2024,81427,77115,9996,21937,190475,168538,No
SDMIT,Electrical and Electronics Engineering,COMEDK,2023,219755,91262,16643,29976,357636,327660,Yes
MSRUAS,Chemical Engineering,KCET,2024,50480,71156,12386,23144,157166,134022,No
REVA,Biotechnology,KCET,2024,65968,78343,13907,18803,177021,158218,Yes
NMIT,Computer Science and Engineering,KCET,2024,51654,68652,10470,26355,157131,130776,No
CMRIT,Biotechnology,KCET,2023,72575,83561,19490,26666,202292,175626,Yes
BMIT,Data Science,COMEDK,2023,236894,81746,15999,16254,350893,334639,Yes
NIE,Electronics and Communication Engineering,COMEDK,2023,201314,73424,12292,17420,304450,287030,No
SIT,Computer Science and Engineering,KCET,2023,62798,60407,15526,19185,157916,138731,No
BIT,Data Science,COMEDK,2024,211757,60979,8488,16003,297227,281224,Yes
VIT,Civil Engineering,COMEDK,2024,214050,75251,13621,26466,329388,302922,Yes
SJBCE,Aerospace Engineering,COMEDK,2023,186780,81729,13434,22694,304637,281943,No
BNMIT,Civil Engineering,KCET,2023,54757,74779,10929,13045,153510,140465,Yes
BNMIT,Electrical and Electronics Engineering,COMEDK,2024,188155,94146,8045,10009,300355,290346,Yes
DrAIT,Biotechnology,KCET,2024,72699,63156,19608,13777,169240,155463,No
BMIT,Artificial Intelligence and Data Science,COMEDK,2023,234456,82994,9509,12420,339379,326959,Yes
KLEIT,Chemical Engineering,KCET,2023,82180,65432,8915,22286,178813,156527,No
SJBCE,Computer Science and Engineering,COMEDK,2024,194280,64867,13502,20194,292843,272649,Yes
AIT,Electronics and Communication Engineering,COMEDK,2023,177287,62586,13554,23409,276836,253427,Yes
AECMandya,Electronics and Communication Engineering,COMEDK,2024,223327,86944,14123,27173,351567,324394,No
PESCE,Electronics and Communication Engineering,COMEDK,2023,222236,80851,10376,27580,341043,313463,Yes
JIT,Chemical Engineering,COMEDK,2023,209498,68381,11627,26666,316172,289506,No
SDMCET,Aerospace Engineering,KCET,2023,68886,63711,8061,10713,151371,140658,Yes
SITM,Information Science and Engineering,COMEDK,2023,248163,64980,10956,15665,339764,324099,No
AEC,Electronics and Communication Engineering,COMEDK,2024,236012,92945,16129,17613,362699,345086,Yes
NIE,Aerospace Engineering,COMEDK,2024,187992,68546,18374,25704,300616,274912,No
RVCE,Aerospace Engineering,COMEDK,2023,189571,82240,17955,22628,312394,289766,Yes
PESCE,Biotechnology,KCET,2024,71584,78865,14223,25074,189746,164672,Yes
SDMCET,Computer Science and Engineering,COMEDK,2023,175551,69035,14695,15511,274792,259281,Yes
RAIT,Computer Science and Engineering,KCET,2023,81791,63803,18216,29858,193668,163810,Yes
SCEM,Aerospace Engineering,COMEDK,2023,214382,71130,15462,21865,322839,300974,No
RVCE,Mechanical Engineering,COMEDK,2023,165652,82950,12001,12421,273024,260603,Yes
PRES,Information Science and Engineering,COMEDK,2023,219748,77719,10025,11819,319311,307492,No
AITM,Artificial Intelligence and Data Science,KCET,2023,57403,85823,15091,27342,185659,158317,No
NCET,Robotics and Automation Engineering,KCET,2024,54204,93947,10463,21279,179893,158614,Yes
REVA,Aerospace Engineering,COMEDK,2023,202787,83624,13522,12342,312275,299933,No
PESU,Computer Science and Engineering,COMEDK,2024,204160,61892,18348,19425,303825,284400,No
VemanaIT,Biotechnology,COMEDK,2023,194594,86608,18606,12085,311893,299808,No
RIT,Biotechnology,COMEDK,2024,169870,89709,15883,27080,302542,275462,Yes
RVCE,Electrical and Electronics Engineering,KCET,2023,51515,91858,18270,15902,177545,161643,No
GIT,Mechanical Engineering,COMEDK,2023,216089,70771,8244,12284,307388,295104,No
AITM,Electronics and Communication Engineering,COMEDK,2024,224519,91577,16605,26901,359602,332701,Yes
SCEM,Electronics and Communication Engineering,COMEDK,2024,198281,74783,8307,23388,304759,281371,No
VVIT,Computer Science and Engineering,KCET,2023,63233,79915,8207,15636,166991,151355,Yes
DrAIT,Data Science,KCET,2024,73613,69204,14297,10151,167265,157114,No
HKBK,Electrical and Electronics Engineering,COMEDK,2024,187118,72810,17312,21725,298965,277240,No
VSM,Robotics and Automation Engineering,COMEDK,2023,162218,89350,12074,25988,289630,263642,No
RVCE,Computer Science and Engineering,COMEDK,2024,243774,94759,11995,15614,366142,350528,Yes
REVA,Aerospace Engineering,COMEDK,2024,216303,84727,10200,15189,326419,311230,Yes
RVCE,Chemical Engineering,KCET,2023,66419,87825,18869,23341,196454,173113,No
PESU,Electronics and Communication Engineering,COMEDK,2023,169203,84839,8412,16253,278707,262454,No
SJBCE,Electrical and Electronics Engineering,COMEDK,2024,218634,87277,11911,12299,330121,317822,Yes
SJBCE,Mechanical Engineering,COMEDK,2023,197630,69032,17615,27768,312045,284277,Yes
SDMIT,Chemical Engineering,COMEDK,2023,192464,87854,9887,22627,312832,290205,Yes
BMSCE,Civil Engineering,KCET,2023,75850,81584,12406,13021,182861,169840,Yes
VSM,Civil Engineering,KCET,2023,52199,88132,18133,11119,169583,158464,No
REVA,Data Science,COMEDK,2023,199104,87715,19358,24289,330466,306177,No
CMRIT,Computer Science and Engineering,COMEDK,2023,238174,70170,18160,18271,344775,326504,Yes
MSRIT,Artificial Intelligence and Data Science,KCET,2023,69117,91223,11814,13440,185594,172154,No
AIT,Mechanical Engineering,COMEDK,2024,238960,75381,18316,29387,362044,332657,Yes
CMRIT,Information Science and Engineering,KCET,2023,53536,66761,16450,23317,160064,136747,Yes
KSIT,Computer Science and Engineering,KCET,2024,50154,84825,17849,11109,163937,152828,Yes
AIT,Civil Engineering,KCET,2024,59020,71360,9556,10421,150357,139936,No
PESU,Aerospace Engineering,KCET,2024,80942,64960,18042,21810,185754,163944,No
NHCE,Mechanical Engineering,COMEDK,2024,186852,77998,13468,15469,293787,278318,No
SDMCET,Robotics and Automation Engineering,KCET,2024,65688,62561,13920,14479,156648,142169,No
GMIT,Civil Engineering,COMEDK,2023,222732,93380,8400,19053,343565,324512,Yes
KSIT,Information Science and Engineering,COMEDK,2024,248512,78133,12914,21046,360605,339559,No
NIE,Electrical and Electronics Engineering,KCET,2023,80893,63348,14900,25940,185081,159141,No
SCEM,Electrical and Electronics Engineering,COMEDK,2023,233674,92361,15610,22717,364362,341645,Yes
AEC,Mechanical Engineering,COMEDK,2024,243673,76061,10923,19187,349844,330657,Yes
PRES,Electronics and Communication Engineering,KCET,2024,74480,64002,8107,28160,174749,146589,No
PRES,Mechanical Engineering,KCET,2023,51859,83004,17043,25831,177737,151906,No
VVCE,Civil Engineering,COMEDK,2023,190337,63825,15499,27218,296879,269661,Yes
AECMandya,Electrical and Electronics Engineering,KCET,2024,67519,66930,13390,17649,165488,147839,Yes
BNMIT,Civil Engineering,COMEDK,2023,238172,66547,19884,11788,336391,324603,Yes
SJBCE,Chemical Engineering,COMEDK,2023,195709,71771,16940,29665,314085,284420,Yes
NHCE,Data Science,KCET,2023,64474,75722,10930,13619,164745,151126,No
BMIT,Civil Engineering,COMEDK,2024,234166,70041,14034,23744,341985,318241,Yes
DrAIT,Electronics and Communication Engineering,COMEDK,2024,245361,72056,10539,16393,344349,327956,Yes
PRES,Computer Science and Engineering,COMEDK,2023,175558,69227,13759,14232,272776,258544,No
DBIT,Information Science and Engineering,COMEDK,2023,173941,62294,15281,25868,277384,251516,No
RVUNIV,Computer Science and Engineering,COMEDK,2024,225285,83367,12575,12266,333493,321227,No
SDMIT,Computer Science and Engineering,COMEDK,2023,192549,83097,13734,17275,306655,289380,Yes
EastPoint,Electrical and Electronics Engineering,KCET,2023,76999,79122,8722,17249,182092,164843,Yes
DBIT,Mechanical Engineering,COMEDK,2023,216357,82812,14629,15645,329443,313798,Yes
SCEM,Information Science and Engineering,COMEDK,2024,243203,80821,17595,14628,356247,341619,No
BMSCE,Civil Engineering,COMEDK,2023,164867,61695,8605,24518,259685,235167,Yes
SDMCET,Mechanical Engineering,COMEDK,2024,170625,74242,13304,17144,275315,258171,No
SDMCET,Electronics and Communication Engineering,KCET,2023,75670,67779,12645,29413,185507,156094,No
SJBIT,Computer Science and Engineering,COMEDK,2024,180357,80275,8259,20753,289644,268891,Yes
SDMIT,Information Science and Engineering,KCET,2024,57539,80873,8797,12282,159491,147209,Yes
PESU,Artificial Intelligence and Data Science,COMEDK,2023,227920,61000,11017,21814,321751,299937,Yes
UVCE,Aerospace Engineering,COMEDK,2024,160181,93902,16541,29670,300294,270624,Yes
BNMIT,Civil Engineering,COMEDK,2023,189973,89916,13488,17333,310710,293377,Yes
SIT,Computer Science and Engineering,KCET,2024,52203,83510,12816,26811,175340,148529,No
SDMCET,Electronics and Communication Engineering,KCET,2024,66233,61798,8036,11503,147570,136067,No
VSM,Robotics and Automation Engineering,COMEDK,2023,208843,87753,10081,14520,321197,306677,No
AIT,Robotics and Automation Engineering,COMEDK,2023,214102,78415,13536,28773,334826,306053,No
NMIT,Mechanical Engineering,KCET,2023,53424,91575,13298,11139,169436,158297,No
KLSGIT,Computer Science and Engineering,COMEDK,2023,166907,71487,12822,18060,269276,251216,Yes
EastPoint,Mechanical Engineering,COMEDK,2023,247989,80607,15438,22544,366578,344034,Yes
NHCE,Information Science and Engineering,COMEDK,2023,160147,89001,9443,22868,281459,258591,Yes
SIT,Artificial Intelligence and Data Science,COMEDK,2023,181458,63852,11461,12626,269397,256771,No
AITM,Data Science,COMEDK,2023,234134,80184,14761,22202,351281,329079,No
SCEM,Mechanical Engineering,COMEDK,2024,197183,76252,8968,13361,295764,282403,Yes
JNNCE,Chemical Engineering,KCET,2024,72010,88790,17319,27841,205960,178119,No
MVJCE,Information Science and Engineering,KCET,2023,83423,60537,17358,29172,190490,161318,No
AITM,Computer Science and Engineering,COMEDK,2023,166145,77910,14118,23655,281828,258173,No
BMIT,Robotics and Automation Engineering,COMEDK,2024,185157,69108,19503,18394,292162,273768,Yes
CITGubbi,Civil Engineering,KCET,2023,59004,93407,11082,25481,188974,163493,Yes
SITM,Information Science and Engineering,COMEDK,2023,223815,69845,17469,17344,328473,311129,No
SIT,Chemical Engineering,KCET,2024,60822,88258,14058,17406,180544,163138,No
SJBIT,Aerospace Engineering,KCET,2023,51857,67308,16832,27975,163972,135997,Yes
GMIT,Electronics and Communication Engineering,COMEDK,2024,179476,77904,15488,26601,299469,272868,Yes
VIT,Information Science and Engineering,KCET,2024,55963,65581,16457,23797,161798,138001,No
SJBIT,Aerospace Engineering,COMEDK,2023,167642,90687,10458,17573,286360,268787,Yes
NMIT,Artificial Intelligence and Data Science,COMEDK,2023,229244,70386,15389,23237,338256,315019,No
VIT,Artificial Intelligence and Data Science,KCET,2023,53317,60954,9124,26932,150327,123395,No
BMIT,Biotechnology,COMEDK,2024,166522,73539,17122,26666,283849,257183,Yes
BITM,Electronics and Communication Engineering,KCET,2023,63949,77551,13912,13795,169207,155412,Yes
AECMandya,Electrical and Electronics Engineering,COMEDK,2024,160928,69551,14497,10688,255664,244976,Yes
BMSIT,Information Science and Engineering,COMEDK,2024,249346,61464,8281,13638,332729,319091,Yes
SJBCE,Electronics and Communication Engineering,KCET,2024,52243,70615,11572,22479,156909,134430,Yes
DrAIT,Aerospace Engineering,KCET,2023,62091,93695,11383,17805,184974,167169,Yes
JSSSTU,Electronics and Communication Engineering,KCET,2024,81027,73365,14226,17694,186312,168618,No
SCEM,Civil Engineering,KCET,2024,54358,92590,13561,19032,179541,160509,Yes
AITM,Information Science and Engineering,COMEDK,2023,202433,79469,11831,13205,306938,293733,No
JSSSTU,Robotics and Automation Engineering,COMEDK,2024,203526,64840,10608,19052,298026,278974,Yes
VIT,Robotics and Automation Engineering,KCET,2023,67839,73024,16516,11952,169331,157379,No
CITGubbi,Artificial Intelligence and Data Science,COMEDK,2023,187878,71822,13463,29171,302334,273163,No
KLSGIT,Electrical and Electronics Engineering,KCET,2023,63606,89051,17128,16579,186364,169785,Yes
NHCE,Mechanical Engineering,COMEDK,2023,233848,75523,12398,23435,345204,321769,Yes
BMIT,Computer Science and Engineering,KCET,2023,62718,87138,13043,25553,188452,162899,No
VemanaIT,Data Science,KCET,2023,57322,93761,12680,21635,185398,163763,Yes
VemanaIT,Chemical Engineering,KCET,2024,51119,93152,9780,15670,169721,154051,Yes
BMSIT,Civil Engineering,COMEDK,2024,168323,88794,8810,10528,276455,265927,No
RAIT,Civil Engineering,KCET,2023,64202,84735,17619,29121,195677,166556,Yes
BMIT,Information Science and Engineering,COMEDK,2023,185288,78816,17553,24142,305799,281657,No
RNSIT,Artificial Intelligence and Data Science,KCET,2024,78732,73679,13737,20343,186491,166148,No
KLEIT,Mechanical Engineering,COMEDK,2024,161427,83931,16303,21731,283392,261661,Yes
SJBCE,Civil Engineering,COMEDK,2024,174810,78727,11916,13564,279017,265453,No
SDMCET,Computer Science and Engineering,COMEDK,2024,165598,75561,11435,14468,267062,252594,Yes
DrAIT,Computer Science and Engineering,COMEDK,2023,198000,72471,14950,24449,309870,285421,No
BMSCE,Computer Science and Engineering,COMEDK,2024,201270,62623,10314,13962,288169,274207,No
BMIT,Robotics and Automation Engineering,COMEDK,2023,165839,68758,15644,29065,279306,250241,Yes
SDMIT,Electronics and Communication Engineering,KCET,2023,76970,78034,10692,22839,188535,165696,No
YKCE,Robotics and Automation Engineering,COMEDK,2024,240574,68106,16997,11752,337429,325677,Yes
SDMCET,Artificial Intelligence and Data Science,COMEDK,2023,200922,79766,13250,22584,316522,293938,Yes
SJBCE,Robotics and Automation Engineering,COMEDK,2023,175557,90361,10861,23356,300135,276779,No
KLEIT,Mechanical Engineering,COMEDK,2023,233236,74701,8958,14348,331243,316895,Yes
SIT,Robotics and Automation Engineering,KCET,2024,66943,69813,10470,11795,159021,147226,Yes
AITM,Electrical and Electronics Engineering,COMEDK,2024,161187,74202,18075,18006,271470,253464,Yes
KLEIT,Robotics and Automation Engineering,KCET,2023,64049,89780,10983,16197,181009,164812,No
DBIT,Data Science,KCET,2024,69218,79530,16194,25704,190646,164942,No
SDMCET,Data Science,COMEDK,2023,196467,94360,15233,25726,331786,306060,Yes
SDMIT,Chemical Engineering,KCET,2024,65708,64347,11450,19069,160574,141505,Yes
SJBCE,Computer Science and Engineering,KCET,2024,66235,66851,17723,13164,163973,150809,Yes
DBIT,Mechanical Engineering,COMEDK,2023,236800,70665,19536,20837,347838,327001,Yes
MVJCE,Computer Science and Engineering,KCET,2024,54089,64872,9779,23384,152124,128740,Yes
KLEIT,Aerospace Engineering,COMEDK,2023,199877,80239,10449,20055,310620,290565,No
KLEIT,Computer Science and Engineering,COMEDK,2023,177564,66785,17519,14453,276321,261868,Yes
JNNCE,Data Science,KCET,2023,74995,71778,15545,28202,190520,162318,Yes
MSRUAS,Aerospace Engineering,KCET,2024,62477,84067,14356,10688,171588,160900,No
GMIT,Data Science,COMEDK,2024,234450,86667,11544,13479,346140,332661,No
PESCE,Chemical Engineering,COMEDK,2024,160975,70162,13260,10164,254561,244397,No
VSM,Robotics and Automation Engineering,KCET,2024,75667,84491,14773,17401,192332,174931,Yes
RVUNIV,Civil Engineering,KCET,2024,76463,82622,9908,29580,198573,168993,Yes
UVCE,Electronics and Communication Engineering,KCET,2024,83735,75742,15907,20617,196001,175384,Yes
JSSSTU,Robotics and Automation Engineering,COMEDK,2024,165211,74655,18525,27965,286356,258391,No
SJBCE,Chemical Engineering,KCET,2024,51899,83382,14730,11074,161085,150011,No
PRES,Data Science,COMEDK,2023,188918,76191,18283,14605,297997,283392,No
NIE,Mechanical Engineering,COMEDK,2023,197204,78278,12786,24240,312508,288268,No
SIT,Electrical and Electronics Engineering,KCET,2024,72569,80545,17347,25685,196146,170461,Yes
RVCE,Computer Science and Engineering,COMEDK,2024,201935,66606,10532,25549,304622,279073,Yes
SIT,Chemical Engineering,COMEDK,2024,224720,85285,13539,14975,338519,323544,No
HKBK,Electronics and Communication Engineering,KCET,2024,64688,75446,15439,10158,165731,155573,Yes
JIT,Biotechnology,COMEDK,2023,244775,74045,10999,29447,359266,329819,No
SJBCE,Electronics and Communication Engineering,KCET,2024,68782,77991,14277,29994,191044,161050,No
GIT,Chemical Engineering,KCET,2024,79529,79943,15115,14381,188968,174587,Yes
MSRUAS,Information Science and Engineering,COMEDK,2024,241003,85790,15070,22714,364577,341863,Yes
SDMIT,Data Science,COMEDK,2024,177562,84047,14474,27701,303784,276083,No
NCET,Aerospace Engineering,COMEDK,2023,202770,78911,18095,22395,322171,299776,No
MSRIT,Artificial Intelligence and Data Science,KCET,2024,65729,86277,9088,17656,178750,161094,Yes
NIE,Robotics and Automation Engineering,COMEDK,2024,204700,86155,10250,22578,323683,301105,Yes
RNSIT,Robotics and Automation Engineering,KCET,2023,78397,67873,19059,11415,176744,165329,No
GMIT,Chemical Engineering,KCET,2023,53338,70481,18914,20530,163263,142733,No
AITM,Chemical Engineering,COMEDK,2024,240105,78672,13118,17532,349427,331895,No
JIT,Civil Engineering,COMEDK,2023,225362,77203,15422,10542,328529,317987,Yes
VVCE,Aerospace Engineering,KCET,2024,81460,90344,9887,27085,208776,181691,Yes
NCET,Data Science,KCET,2023,83305,75731,8983,14327,182346,168019,No
SJBIT,Data Science,KCET,2024,77253,76694,12175,24361,190483,166122,Yes
BMSCE,Information Science and Engineering,COMEDK,2023,223522,73412,14214,12031,323179,311148,Yes
BITM,Computer Science and Engineering,KCET,2023,80376,64262,17329,22515,184482,161967,No
VSM,Information Science and Engineering,COMEDK,2024,200671,91264,17785,12053,321773,309720,No
YKCE,Aerospace Engineering,KCET,2023,69825,93141,18695,11322,192983,181661,No
VemanaIT,Chemical Engineering,COMEDK,2024,249170,70606,8470,13840,342086,328246,No
VSM,Electronics and Communication Engineering,COMEDK,2024,195563,79750,17674,14301,307288,292987,Yes
DSATM,Civil Engineering,KCET,2023,52666,88030,15834,14802,171332,156530,Yes
KSIT,Data Science,KCET,2023,81105,94237,18354,22641,216337,193696,No
MSRIT,Biotechnology,COMEDK,2024,176220,78654,17911,18346,291131,272785,Yes
SDMCET,Mechanical Engineering,COMEDK,2024,221837,85881,19441,10527,337686,327159,No
AEC,Aerospace Engineering,KCET,2023,83526,91955,13659,20068,209208,189140,Yes
NMIT,Information Science and Engineering,KCET,2024,71727,89061,12909,13521,187218,173697,Yes
NCET,Aerospace Engineering,COMEDK,2023,224303,92327,14221,12697,343548,330851,No
SIT,Robotics and Automation Engineering,COMEDK,2023,179948,83175,12117,15643,290883,275240,Yes
AEC,Electrical and Electronics Engineering,KCET,2023,84316,77881,17741,13081,193019,179938,No
KSIT,Aerospace Engineering,COMEDK,2024,193362,60380,13000,13523,280265,266742,Yes
BITM,Electrical and Electronics Engineering,COMEDK,2023,165734,82396,16614,29020,293764,264744,No
DSCE,Aerospace Engineering,COMEDK,2024,187088,64788,16939,13719,282534,268815,No
VVIT,Computer Science and Engineering,KCET,2024,66056,80646,11071,10117,167890,157773,No
BMSCE,Computer Science and Engineering,COMEDK,2023,224405,68145,13835,25882,332267,306385,Yes
VSM,Computer Science and Engineering,KCET,2024,82249,71242,10269,11652,175412,163760,No
REVA,Electronics and Communication Engineering,KCET,2023,78037,80673,10754,17450,186914,169464,No
VSM,Artificial Intelligence and Data Science,KCET,2023,76405,65927,14889,13278,170499,157221,No
MVJCE,Mechanical Engineering,KCET,2023,68055,90879,16284,15565,190783,175218,Yes
GIT,Mechanical Engineering,KCET,2024,74309,76757,16877,14879,182822,167943,Yes
SCEM,Mechanical Engineering,KCET,2023,62694,77611,17896,10401,168602,158201,Yes
RIT,Information Science and Engineering,KCET,2023,72730,86723,13954,23263,196670,173407,Yes
NCET,Biotechnology,COMEDK,2023,244268,67144,8464,15063,334939,319876,No
BITM,Mechanical Engineering,KCET,2023,67064,94911,12114,29165,203254,174089,Yes
NCET,Mechanical Engineering,KCET,2023,70998,88026,8560,21625,189209,167584,No
KLEIT,Civil Engineering,KCET,2023,61932,62974,14565,17662,157133,139471,No
DrAIT,Biotechnology,COMEDK,2024,223884,66096,10633,16969,317582,300613,No
VemanaIT,Chemical Engineering,KCET,2024,84336,70804,9456,13442,178038,164596,Yes
EastPoint,Chemical Engineering,KCET,2023,55526,88883,11873,25505,181787,156282,No
JNNCE,Computer Science and Engineering,KCET,2023,79985,92913,11184,27468,211550,184082,No
YKCE,Computer Science and Engineering,COMEDK,2024,183807,91446,15982,22027,313262,291235,No
AITM,Mechanical Engineering,COMEDK,2024,219853,90583,12853,11273,334562,323289,No
BNMIT,Artificial Intelligence and Data Science,KCET,2023,81776,90156,8055,19444,199431,179987,No
VemanaIT,Robotics and Automation Engineering,KCET,2024,80051,72555,14172,17342,184120,166778,No
KLEIT,Civil Engineering,KCET,2024,60161,66132,10777,19838,156908,137070,Yes
PRES,Robotics and Automation Engineering,KCET,2024,57711,91070,12843,21591,183215,161624,Yes
RVCE,Electrical and Electronics Engineering,KCET,2024,65792,76090,11647,17011,170540,153529,Yes
RVCE,Mechanical Engineering,KCET,2024,67838,67016,11890,13967,160711,146744,Yes
YKCE,Information Science and Engineering,COMEDK,2023,176496,63258,17482,24951,282187,257236,No
DSCE,Aerospace Engineering,COMEDK,2024,187581,60204,18075,29391,295251,265860,No
SITM,Computer Science and Engineering,KCET,2023,58342,77345,15685,19328,170700,151372,No
PRES,Aerospace Engineering,KCET,2024,50668,76364,18529,24761,170322,145561,No
SIT,Electrical and Electronics Engineering,COMEDK,2023,175899,66359,18021,24233,284512,260279,No
SJBIT,Electrical and Electronics Engineering,KCET,2024,69167,92226,16814,22645,200852,178207,No
PRES,Aerospace Engineering,KCET,2024,66003,74010,19203,15358,174574,159216,Yes
JSSSTU,Information Science and Engineering,COMEDK,2024,239336,60681,19338,16503,335858,319355,Yes
YKCE,Civil Engineering,KCET,2023,71467,63010,10133,19157,163767,144610,No
SJBIT,Chemical Engineering,KCET,2023,84689,73928,10636,15939,185192,169253,Yes
GMIT,Data Science,KCET,2023,74295,74381,15077,13404,177157,163753,Yes
BITM,Artificial Intelligence and Data Science,KCET,2023,70172,91431,8722,27384,197709,170325,No
PESCE,Mechanical Engineering,KCET,2023,72056,72834,18017,23405,186312,162907,No
VIT,Electronics and Communication Engineering,KCET,2024,68600,64894,14490,23317,171301,147984,No
NCET,Mechanical Engineering,COMEDK,2023,225766,89124,13052,26066,354008,327942,No
DSATM,Chemical Engineering,KCET,2024,66080,81444,14004,25113,186641,161528,Yes
BMIT,Electrical and Electronics Engineering,COMEDK,2023,244068,62849,10520,17023,334460,317437,No
JIT,Information Science and Engineering,KCET,2023,65031,84733,14063,17230,181057,163827,No
MSRUAS,Robotics and Automation Engineering,KCET,2024,73059,78702,18567,25734,196062,170328,No
KLEIT,Robotics and Automation Engineering,COMEDK,2023,184457,90642,19900,17020,312019,294999,No
MSRUAS,Civil Engineering,COMEDK,2023,246386,92085,17410,11819,367700,355881,Yes
HKBK,Information Science and Engineering,KCET,2023,57341,86350,19749,27577,191017,163440,No
AITM,Electrical and Electronics Engineering,KCET,2024,64578,67441,16237,28085,176341,148256,No
AITM,Electronics and Communication Engineering,KCET,2023,54717,61751,9539,16473,142480,126007,No
PRES,Electrical and Electronics Engineering,COMEDK,2023,219496,77146,15935,13411,325988,312577,Yes
YKCE,Data Science,KCET,2023,60271,89375,8655,14545,172846,158301,Yes
BMSCE,Computer Science and Engineering,KCET,2023,77883,75804,14984,14379,183050,168671,No
SIT,Biotechnology,COMEDK,2024,236397,64229,11477,25826,337929,312103,No
CITGubbi,Data Science,KCET,2024,82613,72456,13788,24805,193662,168857,Yes
KLEIT,Electronics and Communication Engineering,KCET,2024,54913,82868,15878,12225,165884,153659,No
DSATM,Civil Engineering,COMEDK,2024,226633,73490,14758,10501,325382,314881,No
BMIT,Civil Engineering,KCET,2023,61447,77554,9154,18645,166800,148155,Yes
DBIT,Computer Science and Engineering,COMEDK,2024,216156,85585,18424,22232,342397,320165,Yes
BNMIT,Electrical and Electronics Engineering,COMEDK,2023,227277,69063,10063,17497,323900,306403,Yes
PESCE,Data Science,KCET,2024,74096,63837,19082,16022,173037,157015,No
MSRUAS,Robotics and Automation Engineering,KCET,2023,78019,60087,13665,28818,180589,151771,No
GMIT,Civil Engineering,KCET,2024,79797,90987,12268,14702,197754,183052,Yes
CMRIT,Data Science,KCET,2024,64091,80998,16072,19132,180293,161161,Yes
VIT,Data Science,KCET,2024,84948,68202,8377,22924,184451,161527,No
BMSIT,Electronics and Communication Engineering,COMEDK,2024,179918,93766,13511,25266,312461,287195,No
CMRIT,Information Science and Engineering,COMEDK,2023,166598,61949,8931,25351,262829,237478,Yes
SDMIT,Chemical Engineering,COMEDK,2023,193558,67986,15027,12158,288729,276571,No
DSATM,Mechanical Engineering,COMEDK,2024,193614,64380,19613,13780,291387,277607,Yes
RVUNIV,Electronics and Communication Engineering,KCET,2024,75699,66710,12920,19786,175115,155329,No
GMIT,Civil Engineering,COMEDK,2024,184122,70800,10529,26072,291523,265451,Yes
JIT,Aerospace Engineering,COMEDK,2023,213874,74856,16668,11151,316549,305398,No
BMSCE,Chemical Engineering,COMEDK,2023,196535,71472,10270,28937,307214,278277,Yes
KLEIT,Electronics and Communication Engineering,KCET,2024,66531,67306,9098,27737,170672,142935,No
MVJCE,Information Science and Engineering,COMEDK,2023,232089,92081,15738,22933,362841,339908,Yes
SDMIT,Robotics and Automation Engineering,KCET,2024,84162,68474,9996,14412,177044,162632,No
DrAIT,Electronics and Communication Engineering,COMEDK,2023,249738,85688,13027,29694,378147,348453,No
CMRIT,Information Science and Engineering,COMEDK,2023,206532,64021,8803,12543,291899,279356,Yes
BITM,Civil Engineering,COMEDK,2023,226733,77325,9351,18954,332363,313409,Yes
AIT,Biotechnology,KCET,2023,75960,71913,14353,24775,187001,162226,Yes
CMRIT,Biotechnology,KCET,2024,59612,63105,8674,18058,149449,131391,No
RVUNIV,Civil Engineering,COMEDK,2023,217206,73479,15764,14848,321297,306449,Yes
SJBIT,Biotechnology,COMEDK,2024,249559,66326,10844,16030,342759,326729,No
BNMIT,Information Science and Engineering,KCET,2023,65537,82933,14328,28896,191694,162798,No
HKBK,Electronics and Communication Engineering,KCET,2024,74859,86781,12238,16173,190051,173878,Yes
SITM,Civil Engineering,COMEDK,2024,205733,65656,18085,23291,312765,289474,No
BMSCE,Mechanical Engineering,COMEDK,2024,175267,73102,12892,28017,289278,261261,No
JSSSTU,Electronics and Communication Engineering,KCET,2023,67217,79748,15028,23937,185930,161993,No
YKCE,Biotechnology,KCET,2024,60952,69479,12607,17975,161013,143038,Yes
MSRUAS,Robotics and Automation Engineering,COMEDK,2024,179967,79763,19337,29604,308671,279067,No
VVIT,Mechanical Engineering,COMEDK,2023,226910,67010,19250,29673,342843,313170,Yes
CITGubbi,Robotics and Automation Engineering,COMEDK,2024,244953,63637,18821,20061,347472,327411,No
MSRUAS,Civil Engineering,COMEDK,2023,246709,81210,9009,26028,362956,336928,Yes
RIT,Mechanical Engineering,COMEDK,2024,238180,76870,14310,14107,343467,329360,No
SCEM,Artificial Intelligence and Data Science,COMEDK,2024,179744,67758,13465,18731,279698,260967,No
MSRUAS,Electrical and Electronics Engineering,COMEDK,2023,216182,90733,9201,24613,340729,316116,No
BITM,Electronics and Communication Engineering,KCET,2023,82475,86502,11980,22627,203584,180957,Yes
UVCE,Aerospace Engineering,KCET,2023,79485,91516,9277,24245,204523,180278,Yes
NMIT,Civil Engineering,COMEDK,2024,217538,65817,12510,14456,310321,295865,No
SIT,Civil Engineering,COMEDK,2023,169673,83638,8703,26365,288379,262014,Yes
GMIT,Civil Engineering,KCET,2023,56534,74264,16849,18379,166026,147647,No
ACU,Civil Engineering,COMEDK,2023,178251,90398,18767,12626,300042,287416,No
EastPoint,Civil Engineering,KCET,2024,65958,60293,14771,20057,161079,141022,No
ACU,Civil Engineering,KCET,2023,51455,84589,19716,26366,182126,155760,Yes
ACU,Electronics and Communication Engineering,COMEDK,2024,216617,92982,18761,24019,352379,328360,Yes
CITGubbi,Robotics and Automation Engineering,COMEDK,2024,222058,81334,17637,21728,342757,321029,No
KLSGIT,Electronics and Communication Engineering,KCET,2023,53545,65764,10728,15560,145597,130037,Yes
BITM,Artificial Intelligence and Data Science,COMEDK,2024,174521,88986,13878,22937,300322,277385,No
VemanaIT,Electrical and Electronics Engineering,KCET,2024,79010,62030,8407,18729,168176,149447,Yes
VemanaIT,Data Science,KCET,2023,64151,84763,12361,22104,183379,161275,Yes
EastPoint,Biotechnology,COMEDK,2023,171443,62755,9565,27267,271030,243763,No
VVCE,Aerospace Engineering,KCET,2024,80395,66461,18970,12799,178625,165826,Yes
VemanaIT,Civil Engineering,KCET,2024,77039,93502,10908,16535,197984,181449,Yes
PESU,Aerospace Engineering,COMEDK,2023,203009,71327,16980,16836,308152,291316,No
NIE,Electrical and Electronics Engineering,KCET,2023,69688,69795,9509,14658,163650,148992,No
VVIT,Biotechnology,COMEDK,2024,224959,92902,19445,29278,366584,337306,No
RAIT,Computer Science and Engineering,COMEDK,2023,211566,78659,19689,16157,326071,309914,No
PRES,Electronics and Communication Engineering,KCET,2023,56052,90257,17912,19565,183786,164221,Yes
RIT,Information Science and Engineering,COMEDK,2023,180077,70843,8453,10617,269990,259373,Yes
KLSGIT,Mechanical Engineering,KCET,2024,76393,85115,19592,19838,200938,181100,No
AECMandya,Information Science and Engineering,COMEDK,2023,245828,78044,17691,22076,363639,341563,No
YKCE,Electronics and Communication Engineering,COMEDK,2023,167198,65071,8536,25727,266532,240805,No
PESCE,Data Science,KCET,2024,54620,81474,8361,17191,161646,144455,No
YKCE,Electronics and Communication Engineering,KCET,2024,55333,75106,11790,13710,155939,142229,No
BMIT,Mechanical Engineering,COMEDK,2023,213724,87879,8111,29165,338879,309714,No
NCET,Electrical and Electronics Engineering,KCET,2023,70239,72734,18587,29315,190875,161560,No
CITGubbi,Chemical Engineering,KCET,2024,55773,70709,9755,12567,148804,136237,Yes
DSATM,Biotechnology,COMEDK,2024,180886,74127,12168,25662,292843,267181,No
NHCE,Electrical and Electronics Engineering,COMEDK,2023,171581,92632,15072,14183,293468,279285,No
MSRIT,Civil Engineering,KCET,2023,52697,89620,13296,16700,172313,155613,Yes
HKBK,Data Science,KCET,2023,53726,84330,11020,28679,177755,149076,No
BMSCE,Biotechnology,KCET,2023,67458,60449,16665,27908,172480,144572,Yes
JIT,Information Science and Engineering,KCET,2024,81817,68017,17819,16624,184277,167653,Yes
JIT,Artificial Intelligence and Data Science,COMEDK,2023,246545,79018,16467,24753,366783,342030,No
SIT,Data Science,KCET,2023,77370,84970,15908,27030,205278,178248,Yes
GIT,Aerospace Engineering,KCET,2024,74795,76784,16278,26063,193920,167857,Yes
REVA,Electrical and Electronics Engineering,COMEDK,2023,241991,91373,11381,23892,368637,344745,No
DrAIT,Electrical and Electronics Engineering,COMEDK,2023,248523,73681,10182,28204,360590,332386,No
DBIT,Aerospace Engineering,KCET,2023,57850,93426,17972,25404,194652,169248,No
SJBIT,Aerospace Engineering,COMEDK,2024,238665,61453,17550,27443,345111,317668,No
EastPoint,Biotechnology,COMEDK,2024,176581,84879,13960,22791,298211,275420,No
DSCE,Information Science and Engineering,COMEDK,2023,242123,75772,18746,29130,365771,336641,No
AEC,Mechanical Engineering,COMEDK,2023,205218,68887,16638,13325,304068,290743,Yes
RNSIT,Civil Engineering,KCET,2023,80037,82025,16442,19235,197739,178504,No
CMRIT,Mechanical Engineering,KCET,2023,67792,94597,17543,22967,202899,179932,No
SJBCE,Civil Engineering,COMEDK,2024,176350,83293,15728,12201,287572,275371,Yes
SITM,Chemical Engineering,COMEDK,2024,188457,87900,17681,26055,320093,294038,Yes
VIT,Civil Engineering,COMEDK,2023,241867,74877,9810,23877,350431,326554,No
SJBCE,Civil Engineering,COMEDK,2023,198562,82462,16400,28198,325622,297424,No
DBIT,Chemical Engineering,COMEDK,2023,202344,81617,11443,11436,306840,295404,Yes
NIE,Chemical Engineering,COMEDK,2023,177884,71189,11298,20319,280690,260371,Yes
SIT,Electrical and Electronics Engineering,KCET,2023,79797,66428,12551,20261,179037,158776,No
BMSCE,Electronics and Communication Engineering,KCET,2024,60634,62798,11415,26309,161156,134847,Yes
BIT,Information Science and Engineering,COMEDK,2024,162725,77049,10347,20181,270302,250121,Yes
SJBIT,Robotics and Automation Engineering,KCET,2023,63475,91576,13237,11249,179537,168288,No
VIT,Mechanical Engineering,COMEDK,2023,191267,69488,13216,13726,287697,273971,No
BNMIT,Computer Science and Engineering,COMEDK,2023,165168,94228,15332,17599,292327,274728,Yes
NMIT,Civil Engineering,COMEDK,2023,199938,75127,9867,11245,296177,284932,No
CITGubbi,Mechanical Engineering,KCET,2023,76526,81183,18009,27970,203688,175718,Yes
RAIT,Biotechnology,COMEDK,2023,194470,90007,19372,21430,325279,303849,Yes
PESCE,Artificial Intelligence and Data Science,KCET,2023,62173,65079,14426,15058,156736,141678,Yes
VIT,Electrical and Electronics Engineering,KCET,2024,82652,81116,9346,19917,193031,173114,Yes
AIT,Civil Engineering,KCET,2023,81150,72243,14560,27615,195568,167953,Yes
MSRIT,Robotics and Automation Engineering,COMEDK,2024,166243,64038,16937,10854,258072,247218,Yes
SJBIT,Robotics and Automation Engineering,KCET,2024,84763,66484,16832,10059,178138,168079,No
PESCE,Aerospace Engineering,KCET,2023,81713,63205,12385,10024,167327,157303,No
GMIT,Artificial Intelligence and Data Science,COMEDK,2024,238833,94273,13696,15020,361822,346802,No
SJBCE,Aerospace Engineering,KCET,2024,77735,80458,19334,25812,203339,177527,No
VemanaIT,Electronics and Communication Engineering,COMEDK,2024,205290,85755,17645,23703,332393,308690,No
VVIT,Computer Science and Engineering,KCET,2024,79315,70773,14134,13059,177281,164222,Yes
NHCE,Civil Engineering,KCET,2024,55412,61783,18671,22224,158090,135866,No
BIT,Computer Science and Engineering,COMEDK,2023,228930,76707,11713,12332,329682,317350,No
DBIT,Computer Science and Engineering,COMEDK,2023,188391,65818,19048,15641,288898,273257,Yes
BMSCE,Electrical and Electronics Engineering,KCET,2024,66884,93503,10978,20253,191618,171365,No
KLSGIT,Electrical and Electronics Engineering,KCET,2024,51721,80447,12225,25862,170255,144393,Yes
BITM,Aerospace Engineering,KCET,2023,65541,66915,19721,23545,175722,152177,Yes
PRES,Electrical and Electronics Engineering,KCET,2024,69992,83838,13998,19821,187649,167828,Yes
DBIT,Civil Engineering,COMEDK,2023,223252,77906,11630,12056,324844,312788,Yes
DSCE,Computer Science and Engineering,KCET,2023,69137,75827,18522,15981,179467,163486,No
GIT,Robotics and Automation Engineering,KCET,2023,83855,92279,12811,26800,215745,188945,Yes
VVIT,Mechanical Engineering,COMEDK,2023,198993,67286,18377,12602,297258,284656,Yes
KSIT,Robotics and Automation Engineering,KCET,2024,70630,80686,17995,20120,189431,169311,No
BMIT,Civil Engineering,COMEDK,2024,171091,90732,16280,28350,306453,278103,Yes
DSCE,Data Science,KCET,2023,62263,82322,17115,12099,173799,161700,No
NCET,Robotics and Automation Engineering,COMEDK,2023,176837,82212,15872,18675,293596,274921,No
VVCE,Computer Science and Engineering,COMEDK,2024,211117,94376,12852,23429,341774,318345,Yes
DBIT,Aerospace Engineering,KCET,2023,54666,93493,16243,10427,174829,164402,No
SJBIT,Electronics and Communication Engineering,KCET,2023,57519,92335,15276,11261,176391,165130,Yes
MSRUAS,Robotics and Automation Engineering,KCET,2024,56749,76971,10454,28720,172894,144174,No
AIT,Electrical and Electronics Engineering,KCET,2024,65272,63714,14456,28580,172022,143442,No
DSCE,Biotechnology,COMEDK,2024,203125,89976,19999,12327,325427,313100,Yes
VemanaIT,Robotics and Automation Engineering,KCET,2024,52493,87044,14288,14560,168385,153825,Yes
PESCE,Data Science,COMEDK,2023,183599,63138,13118,21781,281636,259855,Yes
CITGubbi,Chemical Engineering,COMEDK,2023,204225,66667,15328,19033,305253,286220,Yes
NHCE,Aerospace Engineering,KCET,2023,53584,78746,12574,23456,168360,144904,Yes
NMIT,Robotics and Automation Engineering,COMEDK,2023,185435,68545,8439,14339,276758,262419,No
SCEM,Biotechnology,COMEDK,2024,162342,79857,14008,29752,285959,256207,Yes
BNMIT,Information Science and Engineering,KCET,2024,55756,66670,9194,18184,149804,131620,No
SCEM,Robotics and Automation Engineering,COMEDK,2023,214801,67028,9620,11437,302886,291449,No
RVCE,Biotechnology,KCET,2024,68574,66959,18261,12222,166016,153794,No
JNNCE,Electronics and Communication Engineering,COMEDK,2023,209277,76922,12429,18633,317261,298628,No
RVUNIV,Electronics and Communication Engineering,KCET,2024,77503,82541,14310,22030,196384,174354,Yes
CITGubbi,Electronics and Communication Engineering,KCET,2024,70788,89319,9552,23540,193199,169659,No
RAIT,Information Science and Engineering,KCET,2024,63005,63671,16349,21863,164888,143025,No
SDMCET,Electronics and Communication Engineering,COMEDK,2024,223588,64817,16356,25602,330363,304761,Yes
NIE,Artificial Intelligence and Data Science,KCET,2024,84349,93737,12760,17343,208189,190846,Yes
VVIT,Artificial Intelligence and Data Science,COMEDK,2024,232254,71703,15655,18186,337798,319612,Yes
AECMandya,Biotechnology,KCET,2024,53899,86397,8632,29253,178181,148928,No
MVJCE,Biotechnology,KCET,2024,63467,81056,18199,16485,179207,162722,No
SDMIT,Mechanical Engineering,KCET,2024,51679,82112,8502,28489,170782,142293,Yes
SCEM,Biotechnology,KCET,2023,69340,79596,10507,11611,171054,159443,Yes
BITM,Civil Engineering,COMEDK,2023,181144,67155,16370,11130,275799,264669,Yes
SDMCET,Electrical and Electronics Engineering,COMEDK,2024,230693,86371,13622,13923,344609,330686,No
RIT,Chemical Engineering,KCET,2023,50282,68384,12829,18871,150366,131495,No
VSM,Electronics and Communication Engineering,COMEDK,2023,172179,77949,11053,28223,289404,261181,No
ACU,Electrical and Electronics Engineering,KCET,2024,63449,71132,8689,12143,155413,143270,Yes
NCET,Aerospace Engineering,KCET,2024,67941,87879,10317,17528,183665,166137,Yes
UVCE,Electrical and Electronics Engineering,COMEDK,2023,220662,85387,10620,19415,336084,316669,Yes
VIT,Data Science,COMEDK,2024,241341,88699,8424,10935,349399,338464,Yes
GMIT,Artificial Intelligence and Data Science,COMEDK,2023,218301,89290,16735,14968,339294,324326,No
SDMCET,Artificial Intelligence and Data Science,KCET,2024,70839,85781,17101,26148,199869,173721,No
VVIT,Electronics and Communication Engineering,KCET,2024,83770,69714,9315,11598,174397,162799,Yes
AECMandya,Information Science and Engineering,COMEDK,2024,201974,77428,10559,12515,302476,289961,Yes
PESCE,Electrical and Electronics Engineering,KCET,2024,77866,85440,11545,25003,199854,174851,Yes
KSIT,Artificial Intelligence and Data Science,KCET,2024,52702,86041,16033,22841,177617,154776,No
SDMIT,Artificial Intelligence and Data Science,KCET,2023,74144,89258,11256,27350,202008,174658,No
PESU,Electrical and Electronics Engineering,COMEDK,2023,237576,70623,12176,28611,348986,320375,No
DSATM,Electrical and Electronics Engineering,KCET,2023,53123,88399,16335,21622,179479,157857,No
GMIT,Aerospace Engineering,COMEDK,2023,209776,93107,10728,22256,335867,313611,No
CITGubbi,Electronics and Communication Engineering,COMEDK,2023,174150,87707,10286,20485,292628,272143,No
SDMCET,Computer Science and Engineering,COMEDK,2023,220616,89190,16815,28777,355398,326621,No
BMSCE,Artificial Intelligence and Data Science,COMEDK,2023,163223,66975,11498,11826,253522,241696,No
RVCE,Aerospace Engineering,COMEDK,2024,192455,86077,15215,23102,316849,293747,No
DSCE,Mechanical Engineering,KCET,2024,51348,93720,17243,27670,189981,162311,No
VSM,Chemical Engineering,COMEDK,2023,175655,92242,12781,16436,297114,280678,No
BIT,Electronics and Communication Engineering,COMEDK,2024,245224,78542,10825,12460,347051,334591,Yes
AECMandya,Aerospace Engineering,KCET,2024,51153,80080,9050,23814,164097,140283,Yes
SJBCE,Mechanical Engineering,KCET,2024,60847,68244,9718,25517,164326,138809,Yes
AEC,Mechanical Engineering,COMEDK,2023,182813,62393,14412,18897,278515,259618,Yes
RVCE,Artificial Intelligence and Data Science,COMEDK,2023,232486,75240,18349,23571,349646,326075,Yes
NIE,Civil Engineering,COMEDK,2024,160480,69995,10833,14950,256258,241308,No
AITM,Biotechnology,COMEDK,2024,233901,84839,14240,29566,362546,332980,Yes
BMSIT,Data Science,COMEDK,2023,248502,78225,9946,18862,355535,336673,No
BMSCE,Electronics and Communication Engineering,COMEDK,2024,177870,87608,17287,19762,302527,282765,No
CITGubbi,Data Science,KCET,2024,78721,73385,12415,28349,192870,164521,No
PESCE,Data Science,COMEDK,2023,166953,84494,11477,24191,287115,262924,Yes
NHCE,Electrical and Electronics Engineering,KCET,2023,71954,71744,11120,26376,181194,154818,No
VemanaIT,Computer Science and Engineering,COMEDK,2024,239902,90284,19215,12750,362151,349401,No
REVA,Robotics and Automation Engineering,KCET,2023,80197,61941,9188,29336,180662,151326,No
VVCE,Data Science,COMEDK,2023,205207,85434,8355,22393,321389,298996,Yes
KLEIT,Artificial Intelligence and Data Science,COMEDK,2024,240706,62769,19309,15584,338368,322784,Yes
NHCE,Civil Engineering,KCET,2023,61352,92139,13336,15519,182346,166827,Yes
CMRIT,Computer Science and Engineering,COMEDK,2024,228874,64210,18360,29988,341432,311444,Yes
VSM,Data Science,KCET,2023,71919,87885,15836,17375,193015,175640,No
JIT,Artificial Intelligence and Data Science,KCET,2024,65618,80660,11100,20224,177602,157378,Yes
SJBCE,Computer Science and Engineering,COMEDK,2023,183165,67892,10044,20389,281490,261101,No
JIT,Mechanical Engineering,KCET,2023,66893,76629,14557,12345,170424,158079,No
SIT,Chemical Engineering,COMEDK,2023,195866,65189,13742,10541,285338,274797,Yes
VVCE,Computer Science and Engineering,COMEDK,2023,203662,72945,10314,23409,310330,286921,No
SITM,Biotechnology,KCET,2023,60844,77643,16566,13607,168660,155053,Yes
CMRIT,Robotics and Automation Engineering,KCET,2023,80720,78408,15269,16140,190537,174397,Yes
MVJCE,Information Science and Engineering,KCET,2023,56548,88368,10075,13920,168911,154991,Yes
AECMandya,Civil Engineering,KCET,2024,75279,94919,9379,11565,191142,179577,Yes
BMIT,Chemical Engineering,COMEDK,2024,198049,81715,13882,21807,315453,293646,No
NIE,Information Science and Engineering,COMEDK,2023,225327,78706,14797,23374,342204,318830,No
RIT,Mechanical Engineering,COMEDK,2023,245662,93704,18439,11445,369250,357805,Yes
DBIT,Information Science and Engineering,KCET,2024,82241,94578,18504,14307,209630,195323,No
VSM,Mechanical Engineering,COMEDK,2024,227382,89620,12901,21414,351317,329903,Yes
RVUNIV,Civil Engineering,KCET,2024,59741,78059,19964,27795,185559,157764,Yes
DSCE,Robotics and Automation Engineering,COMEDK,2023,172759,63167,8852,15067,259845,244778,Yes
UVCE,Chemical Engineering,KCET,2024,69003,87375,11347,15129,182854,167725,No
VVCE,Information Science and Engineering,COMEDK,2023,220392,68180,10515,21535,320622,299087,Yes
PESU,Artificial Intelligence and Data Science,COMEDK,2023,174802,87165,17378,16238,295583,279345,Yes
CITGubbi,Chemical Engineering,COMEDK,2023,208573,76945,13992,10948,310458,299510,No
NHCE,Chemical Engineering,KCET,2023,58969,68083,13381,22250,162683,140433,Yes
PESU,Electronics and Communication Engineering,KCET,2024,78626,82017,9121,19834,189598,169764,Yes
ACU,Electronics and Communication Engineering,COMEDK,2023,223568,79661,9429,21753,334411,312658,Yes
DSATM,Computer Science and Engineering,COMEDK,2024,200633,62416,12072,11093,286214,275121,No
BNMIT,Aerospace Engineering,COMEDK,2023,207411,78939,17215,13928,317493,303565,No
SCEM,Information Science and Engineering,KCET,2023,70984,71435,19508,27083,189010,161927,No
NIE,Aerospace Engineering,KCET,2024,79542,73254,8103,25429,186328,160899,Yes
VemanaIT,Data Science,COMEDK,2024,199274,88235,9572,22076,319157,297081,Yes
RAIT,Biotechnology,KCET,2024,83811,81615,18916,25174,209516,184342,Yes
KLEIT,Aerospace Engineering,COMEDK,2024,228886,88985,16097,14265,348233,333968,No
BMSCE,Aerospace Engineering,KCET,2024,80422,88863,8846,23698,201829,178131,No
SIT,Electrical and Electronics Engineering,KCET,2024,79543,94275,8067,28960,210845,181885,No
AEC,Robotics and Automation Engineering,KCET,2023,79799,61328,8883,19981,169991,150010,No
JNNCE,Electronics and Communication Engineering,KCET,2023,76849,78561,10428,25201,191039,165838,Yes
BIT,Information Science and Engineering,KCET,2024,70989,60661,16635,29960,178245,148285,Yes
DrAIT,Data Science,COMEDK,2024,223812,88651,13180,28995,354638,325643,Yes
PESU,Data Science,COMEDK,2023,187579,73531,16279,14896,292285,277389,No
DSATM,Electrical and Electronics Engineering,COMEDK,2024,238725,90171,18602,11204,358702,347498,Yes
DSCE,Information Science and Engineering,COMEDK,2024,170629,72092,9482,12204,264407,252203,No
VemanaIT,Data Science,COMEDK,2023,209525,69293,19064,23813,321695,297882,No
BMSIT,Data Science,KCET,2024,56962,64282,15222,15546,152012,136466,No
GMIT,Artificial Intelligence and Data Science,COMEDK,2023,198982,90822,19936,17954,327694,309740,Yes
SJBIT,Electrical and Electronics Engineering,KCET,2023,81493,64219,9524,10084,165320,155236,Yes
BMSIT,Robotics and Automation Engineering,COMEDK,2023,224990,65914,19104,29672,339680,310008,No
NHCE,Chemical Engineering,KCET,2024,57669,77237,10137,12557,157600,145043,No
BMSCE,Biotechnology,COMEDK,2023,161949,87000,18976,18147,286072,267925,Yes
SJBIT,Information Science and Engineering,KCET,2023,63768,74908,10542,28873,178091,149218,Yes
DSATM,Information Science and Engineering,KCET,2023,55075,64710,15090,25648,160523,134875,Yes
AIT,Electrical and Electronics Engineering,COMEDK,2024,223746,89443,13209,28689,355087,326398,No
SCEM,Aerospace Engineering,COMEDK,2024,179409,86852,17488,16648,300397,283749,Yes
BIT,Artificial Intelligence and Data Science,KCET,2024,67914,85839,16238,23685,193676,169991,Yes
DrAIT,Data Science,KCET,2023,50363,67698,17115,20767,155943,135176,No
MSRUAS,Electronics and Communication Engineering,KCET,2024,65809,66926,12610,28301,173646,145345,Yes
KSIT,Civil Engineering,KCET,2023,56428,67706,19273,28243,171650,143407,Yes
RIT,Data Science,KCET,2023,57972,85507,9576,14030,167085,153055,No
JSSSTU,Biotechnology,COMEDK,2023,206329,84173,10498,20543,321543,301000,No
PESCE,Data Science,COMEDK,2024,200683,93680,13089,15222,322674,307452,No
RIT,Civil Engineering,COMEDK,2023,202477,87666,11450,13955,315548,301593,No
SDMIT,Data Science,KCET,2024,51757,71133,18435,10544,151869,141325,No
DrAIT,Electronics and Communication Engineering,KCET,2023,53865,75618,10304,14392,154179,139787,Yes
KSIT,Artificial Intelligence and Data Science,KCET,2023,67130,86506,19005,11923,184564,172641,No
CMRIT,Artificial Intelligence and Data Science,KCET,2024,55358,91463,16705,19526,183052,163526,No
SJBIT,Data Science,COMEDK,2023,191416,89719,14298,22190,317623,295433,Yes
SCEM,Information Science and Engineering,COMEDK,2024,243516,76383,12077,27053,359029,331976,No
RIT,Electronics and Communication Engineering,COMEDK,2023,235964,68325,12994,11897,329180,317283,Yes
YKCE,Electronics and Communication Engineering,COMEDK,2024,232874,72225,16407,14572,336078,321506,Yes
BNMIT,Information Science and Engineering,COMEDK,2023,215159,64209,19948,13227,312543,299316,No
AEC,Information Science and Engineering,KCET,2023,68037,72632,13496,15551,169716,154165,No
JIT,Information Science and Engineering,COMEDK,2024,166249,68085,18818,21838,274990,253152,No
AECMandya,Chemical Engineering,KCET,2023,74506,80104,11925,21912,188447,166535,Yes
DSATM,Civil Engineering,KCET,2024,58763,76102,16350,21381,172596,151215,Yes
SJBCE,Artificial Intelligence and Data Science,KCET,2024,60076,88281,9514,28138,186009,157871,No
BMSCE,Robotics and Automation Engineering,COMEDK,2023,204251,90342,14454,18888,327935,309047,Yes
AITM,Robotics and Automation Engineering,COMEDK,2023,236280,94536,12104,15611,358531,342920,No
JNNCE,Robotics and Automation Engineering,KCET,2023,82684,74649,19372,26676,203381,176705,Yes
RVCE,Civil Engineering,COMEDK,2024,243822,75910,9268,28513,357513,329000,No
AEC,Data Science,KCET,2023,75207,81676,10607,21390,188880,167490,Yes
VVIT,Biotechnology,KCET,2024,59375,69868,15413,23774,168430,144656,No
NIE,Information Science and Engineering,KCET,2024,60737,90706,15553,27761,194757,166996,Yes
GMIT,Robotics and Automation Engineering,COMEDK,2023,235398,61193,19517,18383,334491,316108,Yes
SITM,Artificial Intelligence and Data Science,COMEDK,2024,214688,82697,15588,15374,328347,312973,No
JNNCE,Aerospace Engineering,COMEDK,2023,217415,88805,16059,26055,348334,322279,Yes
KLEIT,Civil Engineering,COMEDK,2023,233307,69970,17039,10943,331259,320316,Yes
RVCE,Mechanical Engineering,COMEDK,2024,242157,89255,10541,18620,360573,341953,No
DSATM,Biotechnology,KCET,2023,83589,82643,17947,18515,202694,184179,No
BNMIT,Electronics and Communication Engineering,KCET,2023,72648,79682,18397,22661,193388,170727,Yes
UVCE,Chemical Engineering,KCET,2023,79416,69957,13670,18599,181642,163043,No
SJBIT,Information Science and Engineering,COMEDK,2023,164573,67843,11877,13943,258236,244293,No
EastPoint,Aerospace Engineering,COMEDK,2024,240874,74275,12922,23480,351551,328071,No
RNSIT,Electrical and Electronics Engineering,KCET,2023,62075,68995,9898,15614,156582,140968,Yes
JIT,Mechanical Engineering,KCET,2024,57468,63122,16741,18943,156274,137331,Yes
SJBCE,Electronics and Communication Engineering,KCET,2023,60705,80778,17408,28588,187479,158891,Yes
VemanaIT,Information Science and Engineering,KCET,2023,64774,61306,16114,20622,162816,142194,Yes
KSIT,Chemical Engineering,COMEDK,2024,190433,76996,11105,14045,292579,278534,No
YKCE,Chemical Engineering,COMEDK,2024,202149,62485,12653,18151,295438,277287,Yes
VVIT,Artificial Intelligence and Data Science,COMEDK,2023,248119,72721,10967,13794,345601,331807,Yes
KSIT,Biotechnology,KCET,2024,63270,83825,18018,20366,185479,165113,No
BMSIT,Electrical and Electronics Engineering,KCET,2023,80791,83492,16953,20201,201437,181236,No
SIT,Information Science and Engineering,KCET,2023,78620,82230,12426,25991,199267,173276,No
SCEM,Electrical and Electronics Engineering,KCET,2023,59180,64757,9533,10048,143518,133470,Yes
REVA,Biotechnology,KCET,2024,78742,64348,9273,16981,169344,152363,Yes
AECMandya,Aerospace Engineering,KCET,2023,67839,71524,10409,20777,170549,149772,Yes
VSM,Data Science,COMEDK,2023,168978,70123,16174,12210,267485,255275,No
BMSIT,Data Science,COMEDK,2023,240155,79585,9253,20468,349461,328993,No
HKBK,Artificial Intelligence and Data Science,COMEDK,2023,220731,62244,12352,19504,314831,295327,No
EastPoint,Data Science,COMEDK,2024,202476,69504,16411,13098,301489,288391,No
NMIT,Electrical and Electronics Engineering,COMEDK,2023,233086,73937,14035,13797,334855,321058,Yes
SCEM,Electronics and Communication Engineering,KCET,2024,51064,90176,18360,19919,179519,159600,No
HKBK,Information Science and Engineering,COMEDK,2024,246730,75412,9966,17328,349436,332108,Yes
MVJCE,Data Science,KCET,2024,58528,84350,12532,24590,180000,155410,Yes
SJBCE,Civil Engineering,COMEDK,2024,229577,94561,16949,17126,358213,341087,Yes
NMIT,Aerospace Engineering,KCET,2023,79420,79998,11074,18790,189282,170492,Yes
NCET,Biotechnology,COMEDK,2023,241397,89967,10008,29294,370666,341372,No
VIT,Electrical and Electronics Engineering,KCET,2024,71374,74628,14287,10256,170545,160289,No
MSRIT,Artificial Intelligence and Data Science,KCET,2023,54560,73529,16786,23844,168719,144875,No
DSATM,Civil Engineering,KCET,2023,70335,79618,14885,13555,178393,164838,Yes
PESCE,Robotics and Automation Engineering,COMEDK,2024,245386,85708,10539,28763,370396,341633,No
SITM,Data Science,COMEDK,2024,198408,78973,8461,17986,303828,285842,No
HKBK,Information Science and Engineering,COMEDK,2023,247062,71032,8756,10617,337467,326850,Yes
BMSCE,Data Science,KCET,2024,67076,94151,15858,11317,188402,177085,Yes
AIT,Information Science and Engineering,KCET,2023,68619,61159,18210,22136,170124,147988,No
CITGubbi,Mechanical Engineering,COMEDK,2023,244829,82116,9232,14464,350641,336177,Yes
BIT,Information Science and Engineering,KCET,2023,53872,88555,11622,17737,171786,154049,No
CITGubbi,Civil Engineering,COMEDK,2024,246605,88534,16355,16895,368389,351494,No
AEC,Chemical Engineering,COMEDK,2024,208405,77479,17384,12228,315496,303268,No
GIT,Artificial Intelligence and Data Science,KCET,2024,59181,76460,9248,15510,160399,144889,Yes
RAIT,Data Science,KCET,2024,55693,75282,12435,28047,171457,143410,Yes
CMRIT,Mechanical Engineering,KCET,2023,50206,74102,16468,12239,153015,140776,Yes
NCET,Aerospace Engineering,KCET,2024,81116,76642,16293,12352,186403,174051,No
NHCE,Artificial Intelligence and Data Science,COMEDK,2024,219860,77424,9696,11701,318681,306980,Yes
KSIT,Electronics and Communication Engineering,COMEDK,2024,216447,76106,13880,23409,329842,306433,Yes
BNMIT,Chemical Engineering,KCET,2024,83361,76282,11116,25037,195796,170759,Yes
JIT,Information Science and Engineering,COMEDK,2023,242890,85516,17170,15564,361140,345576,Yes
RNSIT,Electronics and Communication Engineering,KCET,2024,56366,67754,13745,29780,167645,137865,Yes
JIT,Robotics and Automation Engineering,COMEDK,2024,193111,81386,14053,17800,306350,288550,No
AEC,Artificial Intelligence and Data Science,KCET,2023,54495,77887,12044,21966,166392,144426,Yes
SITM,Biotechnology,COMEDK,2023,240627,64743,14196,26777,346343,319566,Yes
BMIT,Information Science and Engineering,COMEDK,2024,223218,81741,11385,15157,331501,316344,No
PESU,Robotics and Automation Engineering,KCET,2024,82520,86735,14654,27653,211562,183909,Yes
CITGubbi,Information Science and Engineering,COMEDK,2023,162868,83059,18643,17106,281676,264570,No
BITM,Data Science,KCET,2024,60892,90114,11238,28298,190542,162244,No
GMIT,Artificial Intelligence and Data Science,COMEDK,2023,205070,93430,15672,18365,332537,314172,Yes
VIT,Information Science and Engineering,KCET,2023,63005,89977,11725,23998,188705,164707,Yes
DSATM,Artificial Intelligence and Data Science,COMEDK,2024,188534,80002,19422,16831,304789,287958,Yes
BMSIT,Civil Engineering,COMEDK,2024,231654,78855,8970,14876,334355,319479,Yes
AIT,Artificial Intelligence and Data Science,KCET,2024,69411,66056,18160,17098,170725,153627,No
VVCE,Computer Science and Engineering,KCET,2023,66109,84625,18672,14998,184404,169406,Yes
KSIT,Electrical and Electronics Engineering,KCET,2023,65746,66658,18721,11610,162735,151125,Yes
UVCE,Mechanical Engineering,COMEDK,2024,211819,67506,13153,17389,309867,292478,No
NCET,Data Science,COMEDK,2023,221665,72120,19168,20482,333435,312953,No
KLSGIT,Information Science and Engineering,COMEDK,2024,183891,68925,10604,24796,288216,263420,Yes
PESCE,Chemical Engineering,KCET,2024,71086,68046,11713,29216,180061,150845,Yes
UVCE,Electrical and Electronics Engineering,KCET,2024,82739,93263,14596,13694,204292,190598,Yes
MVJCE,Chemical Engineering,KCET,2024,74955,75690,10421,10238,171304,161066,No
JIT,Robotics and Automation Engineering,KCET,2023,79669,65508,10466,26041,181684,155643,No
SITM,Artificial Intelligence and Data Science,COMEDK,2023,230393,88468,9385,28029,356275,328246,Yes
KLSGIT,Robotics and Automation Engineering,COMEDK,2024,196629,74921,8351,15247,295148,279901,Yes
MSRUAS,Aerospace Engineering,COMEDK,2023,220464,83285,11886,23485,339120,315635,Yes
SCEM,Computer Science and Engineering,KCET,2023,50804,69772,8655,11926,141157,129231,No
MSRUAS,Electrical and Electronics Engineering,KCET,2023,77082,80699,18772,20034,196587,176553,Yes
KLEIT,Robotics and Automation Engineering,COMEDK,2023,227020,69149,15463,15110,326742,311632,Yes
SJBCE,Chemical Engineering,COMEDK,2023,232579,89324,16927,28054,366884,338830,Yes
CITGubbi,Civil Engineering,COMEDK,2023,218427,87144,19969,24036,349576,325540,No
KSIT,Computer Science and Engineering,COMEDK,2024,230200,69468,8354,12196,320218,308022,No
PESU,Electrical and Electronics Engineering,COMEDK,2024,231709,72956,12995,19695,337355,317660,Yes
NMIT,Civil Engineering,COMEDK,2024,194210,91182,8408,17670,311470,293800,Yes
SCEM,Aerospace Engineering,COMEDK,2023,183988,77473,12714,23368,297543,274175,Yes
CITGubbi,Artificial Intelligence and Data Science,KCET,2023,83704,64516,12580,23954,184754,160800,No
KLSGIT,Electrical and Electronics Engineering,KCET,2024,74787,64449,12687,10703,162626,151923,Yes
RAIT,Mechanical Engineering,KCET,2023,61240,80005,13011,15975,170231,154256,No
ACU,Robotics and Automation Engineering,KCET,2023,66751,94224,11350,16497,188822,172325,Yes
PRES,Information Science and Engineering,KCET,2023,79958,70998,19110,25388,195454,170066,No
HKBK,Robotics and Automation Engineering,KCET,2023,60210,75276,17507,24876,177869,152993,Yes
VVCE,Data Science,KCET,2023,83298,71525,12030,27797,194650,166853,No
CITGubbi,Electronics and Communication Engineering,KCET,2023,77380,74272,12096,25705,189453,163748,Yes
RAIT,Biotechnology,KCET,2024,69785,61729,15743,14538,161795,147257,No
MSRIT,Mechanical Engineering,KCET,2024,83126,69014,13264,25030,190434,165404,Yes
REVA,Chemical Engineering,KCET,2024,79344,64431,16315,19356,179446,160090,Yes
VVIT,Aerospace Engineering,KCET,2023,57219,79746,9489,21195,167649,146454,No
NMIT,Data Science,KCET,2023,72237,77023,15094,16285,180639,164354,No
JSSSTU,Electronics and Communication Engineering,KCET,2023,78844,67587,16669,19817,182917,163100,Yes
JIT,Information Science and Engineering,COMEDK,2023,165134,79706,10832,26718,282390,255672,No
AIT,Aerospace Engineering,COMEDK,2023,208814,87830,12651,27974,337269,309295,No
MVJCE,Artificial Intelligence and Data Science,COMEDK,2023,174337,83016,8306,12880,278539,265659,Yes
VemanaIT,Chemical Engineering,KCET,2023,71542,83327,9577,29944,194390,164446,Yes
VemanaIT,Civil Engineering,COMEDK,2024,227371,81449,14456,11453,334729,323276,Yes
HKBK,Artificial Intelligence and Data Science,COMEDK,2024,212603,78641,12596,23091,326931,303840,No
SIT,Data Science,COMEDK,2023,239044,62958,9841,22938,334781,311843,Yes
DrAIT,Data Science,COMEDK,2023,175845,64373,10491,22159,272868,250709,No
KSIT,Information Science and Engineering,KCET,2024,84999,60000,11470,13830,170299,156469,No
RVUNIV,Biotechnology,KCET,2023,70651,86801,17563,24233,199248,175015,Yes
BNMIT,Electrical and Electronics Engineering,COMEDK,2024,202921,71168,18332,15466,307887,292421,No
AEC,Robotics and Automation Engineering,KCET,2024,66679,73525,17242,12213,169659,157446,No
BMIT,Robotics and Automation Engineering,COMEDK,2024,247424,78225,10223,27878,363750,335872,No
RAIT,Information Science and Engineering,COMEDK,2024,192688,64579,13698,16793,287758,270965,Yes
VVCE,Electronics and Communication Engineering,KCET,2023,81584,85746,11112,24625,203067,178442,Yes
MSRIT,Civil Engineering,KCET,2023,51853,79433,12965,28157,172408,144251,No
GMIT,Electronics and Communication Engineering,COMEDK,2024,185470,77215,19022,24049,305756,281707,No
SJBCE,Chemical Engineering,KCET,2024,73678,86151,19966,11235,191030,179795,No
SJBIT,Biotechnology,COMEDK,2024,248781,84905,12678,25329,371693,346364,No
KSIT,Electronics and Communication Engineering,KCET,2024,59739,75693,10728,21078,167238,146160,Yes
RVUNIV,Artificial Intelligence and Data Science,KCET,2023,65815,62701,10433,19508,158457,138949,Yes
RVUNIV,Information Science and Engineering,COMEDK,2024,185331,72924,8037,26530,292822,266292,Yes
VemanaIT,Robotics and Automation Engineering,COMEDK,2023,204974,66422,13000,14010,298406,284396,Yes
HKBK,Computer Science and Engineering,KCET,2024,84437,92748,19262,26580,223027,196447,No
UVCE,Computer Science and Engineering,KCET,2024,58399,63544,18859,28891,169693,140802,No
MSRIT,Artificial Intelligence and Data Science,KCET,2024,58311,63479,14110,12575,148475,135900,Yes
KLEIT,Data Science,KCET,2023,50172,87281,9598,11442,158493,147051,Yes
REVA,Civil Engineering,COMEDK,2023,227446,70798,15170,25424,338838,313414,No
BITM,Information Science and Engineering,KCET,2024,78131,84513,11610,11536,185790,174254,No
JIT,Electronics and Communication Engineering,KCET,2024,81215,80357,15268,14321,191161,176840,Yes
VIT,Mechanical Engineering,COMEDK,2023,189448,63668,13831,20465,287412,266947,No
JIT,Electrical and Electronics Engineering,KCET,2024,76362,76237,16759,13580,182938,169358,No
NMIT,Chemical Engineering,COMEDK,2023,161454,77521,16123,22069,277167,255098,No
CMRIT,Aerospace Engineering,KCET,2024,83967,71997,11469,23670,191103,167433,Yes
CITGubbi,Electronics and Communication Engineering,KCET,2023,62640,70155,19867,25878,178540,152662,No
RAIT,Robotics and Automation Engineering,KCET,2024,81103,90339,12247,12938,196627,183689,No
NMIT,Mechanical Engineering,KCET,2023,63387,94841,9995,16839,185062,168223,No
GIT,Electrical and Electronics Engineering,COMEDK,2023,206354,62709,14027,16860,299950,283090,No
SJBCE,Information Science and Engineering,KCET,2023,83075,67240,18450,19109,187874,168765,No
JIT,Biotechnology,COMEDK,2024,192525,66149,18328,24709,301711,277002,No
DrAIT,Chemical Engineering,COMEDK,2024,238050,64114,9142,27302,338608,311306,Yes
JNNCE,Aerospace Engineering,COMEDK,2024,193403,72249,10558,22881,299091,276210,No
AIT,Mechanical Engineering,COMEDK,2024,186949,69065,14736,13393,284143,270750,No
AECMandya,Electrical and Electronics Engineering,COMEDK,2023,179597,62190,15194,20556,277537,256981,Yes
YKCE,Chemical Engineering,KCET,2023,50370,65247,15295,20768,151680,130912,Yes
BIT,Data Science,KCET,2024,82161,87753,15353,18391,203658,185267,No
RVUNIV,Artificial Intelligence and Data Science,COMEDK,2023,221785,72192,12155,28055,334187,306132,Yes
ACU,Computer Science and Engineering,COMEDK,2023,240552,87726,17399,27599,373276,345677,Yes
JNNCE,Electronics and Communication Engineering,COMEDK,2024,196909,80676,17212,25440,320237,294797,Yes
BNMIT,Data Science,KCET,2024,66822,79148,19092,13891,178953,165062,Yes
NCET,Biotechnology,KCET,2024,61147,69342,12237,23128,165854,142726,No
KLSGIT,Artificial Intelligence and Data Science,KCET,2024,73063,93825,10504,28268,205660,177392,No
CMRIT,Computer Science and Engineering,COMEDK,2024,167476,86750,13842,28846,296914,268068,No
VVCE,Information Science and Engineering,KCET,2023,74345,90079,12379,25126,201929,176803,Yes
KLEIT,Chemical Engineering,COMEDK,2023,194199,87098,17704,15453,314454,299001,No
SJBCE,Chemical Engineering,COMEDK,2023,187190,87082,16110,24143,314525,290382,No
EastPoint,Aerospace Engineering,KCET,2023,60161,87416,16873,23244,187694,164450,No
KLEIT,Biotechnology,KCET,2023,54943,74028,17097,19156,165224,146068,No
NHCE,Artificial Intelligence and Data Science,KCET,2024,58672,71556,10189,26274,166691,140417,Yes
SCEM,Information Science and Engineering,KCET,2023,52084,72473,14945,26015,165517,139502,Yes
GIT,Artificial Intelligence and Data Science,KCET,2024,57331,77720,8827,10832,154710,143878,Yes
MSRUAS,Electronics and Communication Engineering,COMEDK,2023,203046,84832,11806,25389,325073,299684,Yes
MSRIT,Aerospace Engineering,KCET,2023,52649,94178,13245,18543,178615,160072,Yes
YKCE,Robotics and Automation Engineering,KCET,2024,54767,61706,13476,14886,144835,129949,No
CMRIT,Biotechnology,KCET,2023,57965,86844,18683,18274,181766,163492,Yes
PRES,Computer Science and Engineering,COMEDK,2024,198439,90848,18153,15156,322596,307440,Yes
GMIT,Electrical and Electronics Engineering,KCET,2023,53812,65865,11366,23497,154540,131043,No
BNMIT,Mechanical Engineering,COMEDK,2024,222124,82811,11998,21118,338051,316933,No
DSATM,Biotechnology,KCET,2024,81559,75814,13458,22383,193214,170831,No
NCET,Biotechnology,KCET,2024,81736,72812,17214,16448,188210,171762,Yes
SJBCE,Computer Science and Engineering,KCET,2024,71033,73253,13232,20804,178322,157518,Yes
REVA,Electrical and Electronics Engineering,KCET,2023,79256,86533,14389,13293,193471,180178,Yes
JSSSTU,Robotics and Automation Engineering,COMEDK,2023,225481,92522,11816,22814,352633,329819,No
AEC,Civil Engineering,KCET,2024,65513,60881,12410,10316,149120,138804,No
GMIT,Computer Science and Engineering,KCET,2023,61681,92059,18783,17264,189787,172523,Yes
VemanaIT,Robotics and Automation Engineering,COMEDK,2024,210730,84159,16227,21584,332700,311116,Yes
DBIT,Mechanical Engineering,COMEDK,2024,191273,79287,15333,25367,311260,285893,Yes
KLSGIT,Artificial Intelligence and Data Science,COMEDK,2023,223644,84682,13518,15744,337588,321844,Yes
RVUNIV,Computer Science and Engineering,COMEDK,2023,189079,94224,17101,26933,327337,300404,Yes
MSRUAS,Computer Science and Engineering,COMEDK,2024,247282,61204,8048,18166,334700,316534,Yes
PRES,Data Science,KCET,2023,65804,93494,19058,27368,205724,178356,Yes
HKBK,Computer Science and Engineering,COMEDK,2023,202050,72883,19140,10724,304797,294073,Yes
BITM,Computer Science and Engineering,KCET,2023,57400,70188,14181,25932,167701,141769,Yes
SIT,Electronics and Communication Engineering,KCET,2023,50063,67638,12054,26796,156551,129755,No
JNNCE,Electrical and Electronics Engineering,KCET,2023,77111,68731,17558,13413,176813,163400,Yes
NHCE,Robotics and Automation Engineering,COMEDK,2023,198670,70988,11620,29006,310284,281278,No
AEC,Mechanical Engineering,COMEDK,2023,185160,82555,19936,25126,312777,287651,Yes
KLEIT,Electrical and Electronics Engineering,KCET,2023,57032,72688,18826,26876,175422,148546,Yes
RNSIT,Electronics and Communication Engineering,COMEDK,2023,220656,88178,15773,29166,353773,324607,Yes
DrAIT,Robotics and Automation Engineering,KCET,2023,52058,65579,10718,18701,147056,128355,Yes
MSRIT,Electronics and Communication Engineering,KCET,2023,52644,67712,10677,17017,148050,131033,No
KLSGIT,Computer Science and Engineering,COMEDK,2024,171996,91279,12926,26305,302506,276201,No
BMSIT,Electrical and Electronics Engineering,KCET,2023,76377,84230,9018,12063,181688,169625,Yes
KSIT,Civil Engineering,COMEDK,2023,210855,66683,16638,28920,323096,294176,No
KSIT,Electronics and Communication Engineering,COMEDK,2024,182992,88790,17432,27260,316474,289214,Yes
YKCE,Mechanical Engineering,COMEDK,2024,223506,83630,13046,25805,345987,320182,No
VemanaIT,Mechanical Engineering,COMEDK,2023,161571,68562,10230,12097,252460,240363,Yes
JSSSTU,Biotechnology,KCET,2024,69874,91854,14485,17059,193272,176213,Yes
RAIT,Information Science and Engineering,KCET,2023,76881,74519,16807,22159,190366,168207,No
NHCE,Electronics and Communication Engineering,COMEDK,2023,175678,91109,13870,25656,306313,280657,Yes
NHCE,Computer Science and Engineering,COMEDK,2024,218404,77275,14182,23355,333216,309861,Yes
DBIT,Chemical Engineering,KCET,2024,65464,74358,9804,12594,162220,149626,Yes
SIT,Data Science,COMEDK,2024,216582,85079,13894,20013,335568,315555,Yes
GIT,Chemical Engineering,COMEDK,2024,208874,84935,19463,24891,338163,313272,Yes
DBIT,Aerospace Engineering,KCET,2024,60010,77216,11588,10941,159755,148814,Yes
DSATM,Artificial Intelligence and Data Science,COMEDK,2023,182680,73459,14486,22044,292669,270625,No
RAIT,Artificial Intelligence and Data Science,COMEDK,2024,211307,64968,13311,16813,306399,289586,Yes
VIT,Artificial Intelligence and Data Science,COMEDK,2024,192612,60392,10428,22394,285826,263432,No
AIT,Chemical Engineering,KCET,2024,82590,82120,14791,28585,208086,179501,Yes
DrAIT,Information Science and Engineering,KCET,2024,57621,93612,14069,22347,187649,165302,No
VSM,Artificial Intelligence and Data Science,KCET,2024,67521,61959,12693,24558,166731,142173,Yes
NIE,Information Science and Engineering,KCET,2023,66418,69303,14378,24760,174859,150099,Yes
NHCE,Data Science,KCET,2024,78105,60213,12064,14370,164752,150382,Yes
SITM,Chemical Engineering,KCET,2023,60830,69239,18939,13545,162553,149008,Yes
BMSCE,Civil Engineering,KCET,2024,68561,62216,12463,24750,167990,143240,No
VemanaIT,Electrical and Electronics Engineering,COMEDK,2024,232620,72793,10955,15923,332291,316368,No
VIT,Artificial Intelligence and Data Science,KCET,2023,60425,84242,15461,16471,176599,160128,No
VSM,Chemical Engineering,COMEDK,2023,230331,66095,11737,10684,318847,308163,Yes
MSRUAS,Artificial Intelligence and Data Science,COMEDK,2023,167992,88824,9248,24198,290262,266064,Yes
RNSIT,Civil Engineering,KCET,2023,54252,76419,14246,12833,157750,144917,Yes
CMRIT,Data Science,KCET,2023,79733,80542,14378,25131,199784,174653,Yes
NMIT,Artificial Intelligence and Data Science,KCET,2024,82491,63903,19490,26336,192220,165884,No
BNMIT,Electronics and Communication Engineering,KCET,2024,55691,72780,17950,19195,165616,146421,No
BITM,Mechanical Engineering,COMEDK,2024,207202,64483,15411,24542,311638,287096,No
AIT,Artificial Intelligence and Data Science,COMEDK,2023,237458,76450,8323,16256,338487,322231,No
PESU,Information Science and Engineering,COMEDK,2024,202026,75625,17788,15117,310556,295439,No
EastPoint,Electronics and Communication Engineering,COMEDK,2024,196909,73024,9755,16104,295792,279688,Yes
REVA,Biotechnology,COMEDK,2024,176557,88999,19548,10783,295887,285104,Yes
UVCE,Biotechnology,KCET,2024,78543,93099,14213,28680,214535,185855,Yes
SDMCET,Chemical Engineering,KCET,2024,69051,89533,17810,24131,200525,176394,Yes
MSRIT,Chemical Engineering,COMEDK,2023,238628,82694,8561,26916,356799,329883,No
BMSIT,Computer Science and Engineering,KCET,2023,52914,84679,11153,22383,171129,148746,No
DrAIT,Electronics and Communication Engineering,KCET,2024,70229,63321,18714,22519,174783,152264,No
GIT,Data Science,COMEDK,2023,208210,86590,17347,29833,341980,312147,Yes
AEC,Biotechnology,KCET,2023,65798,66305,8130,24900,165133,140233,No
MSRUAS,Robotics and Automation Engineering,COMEDK,2024,198447,78063,9613,29639,315762,286123,Yes
BMIT,Civil Engineering,KCET,2023,51203,65611,12555,17601,146970,129369,Yes
BNMIT,Biotechnology,KCET,2023,67941,67082,8392,19400,162815,143415,Yes
BIT,Electrical and Electronics Engineering,KCET,2024,50168,72151,11518,20053,153890,133837,Yes
DSCE,Robotics and Automation Engineering,COMEDK,2024,163183,72642,13481,18623,267929,249306,Yes
NHCE,Robotics and Automation Engineering,COMEDK,2023,166426,87782,11831,26532,292571,266039,No
CMRIT,Mechanical Engineering,COMEDK,2024,204805,60249,13528,26381,304963,278582,Yes
VemanaIT,Electronics and Communication Engineering,COMEDK,2023,167521,83819,9606,29516,290462,260946,Yes
VIT,Robotics and Automation Engineering,COMEDK,2024,181989,77471,10834,19466,289760,270294,Yes
DrAIT,Robotics and Automation Engineering,COMEDK,2024,186766,85171,13968,15934,301839,285905,No
BNMIT,Computer Science and Engineering,KCET,2023,83505,91495,12807,10759,198566,187807,Yes
ACU,Computer Science and Engineering,KCET,2024,60883,84630,14378,14718,174609,159891,No
NIE,Aerospace Engineering,COMEDK,2023,197172,80817,18944,10489,307422,296933,No
JNNCE,Data Science,COMEDK,2023,171465,68178,10743,29785,280171,250386,Yes
SJBIT,Robotics and Automation Engineering,COMEDK,2023,213954,68038,10002,24975,316969,291994,No
YKCE,Aerospace Engineering,KCET,2024,71074,73275,10944,14468,169761,155293,Yes
ACU,Aerospace Engineering,KCET,2023,79089,62117,8109,16988,166303,149315,Yes
SITM,Computer Science and Engineering,KCET,2024,51849,69876,15537,14535,151797,137262,Yes
EastPoint,Electronics and Communication Engineering,COMEDK,2023,161343,64867,9085,19396,254691,235295,Yes
SJBIT,Aerospace Engineering,COMEDK,2023,182199,88103,11501,27112,308915,281803,Yes
UVCE,Chemical Engineering,COMEDK,2023,178868,86650,11267,29938,306723,276785,No
MVJCE,Data Science,COMEDK,2023,216088,66340,8068,18815,309311,290496,Yes
NHCE,Robotics and Automation Engineering,COMEDK,2024,248194,89033,17016,13232,367475,354243,No
DSCE,Artificial Intelligence and Data Science,COMEDK,2023,213934,87215,8242,11966,321357,309391,Yes
JNNCE,Electronics and Communication Engineering,COMEDK,2024,211910,78045,12515,13309,315779,302470,Yes
SDMIT,Biotechnology,COMEDK,2024,167789,81271,19798,16319,285177,268858,Yes
PESU,Electronics and Communication Engineering,KCET,2023,58200,91500,11988,24333,186021,161688,No
SITM,Data Science,COMEDK,2023,242972,84956,8441,20734,357103,336369,Yes
DSATM,Aerospace Engineering,KCET,2024,62906,72285,14659,24104,173954,149850,No
DrAIT,Information Science and Engineering,KCET,2024,55782,64446,16882,14932,152042,137110,No
PESU,Aerospace Engineering,COMEDK,2024,167618,88407,17387,10972,284384,273412,No
SCEM,Electronics and Communication Engineering,COMEDK,2023,233199,67974,17846,25577,344596,319019,No
DBIT,Data Science,COMEDK,2024,234540,94621,20000,15971,365132,349161,No
AIT,Information Science and Engineering,COMEDK,2023,197513,90512,12893,22991,323909,300918,Yes
MVJCE,Artificial Intelligence and Data Science,KCET,2023,78364,86519,15851,15201,195935,180734,Yes
SJBCE,Electronics and Communication Engineering,COMEDK,2024,161896,61164,8736,25463,257259,231796,Yes
BNMIT,Artificial Intelligence and Data Science,KCET,2024,72041,60752,8341,26798,167932,141134,Yes
DBIT,Mechanical Engineering,KCET,2024,61156,72314,9238,24110,166818,142708,Yes
AIT,Aerospace Engineering,KCET,2023,53727,68091,11535,14702,148055,133353,Yes
GMIT,Biotechnology,KCET,2023,62246,90290,10106,21254,183896,162642,Yes
AIT,Artificial Intelligence and Data Science,COMEDK,2023,239153,91468,11955,23650,366226,342576,No
JIT,Aerospace Engineering,COMEDK,2024,187686,84643,13664,12797,298790,285993,No
BMSCE,Electronics and Communication Engineering,COMEDK,2024,163993,79167,13018,19184,275362,256178,Yes
KLSGIT,Aerospace Engineering,COMEDK,2024,203692,66302,19518,18415,307927,289512,No
SCEM,Electrical and Electronics Engineering,KCET,2024,54084,92794,19268,14402,180548,166146,No
NHCE,Robotics and Automation Engineering,COMEDK,2023,233953,68153,19273,20375,341754,321379,No
SIT,Robotics and Automation Engineering,KCET,2023,69332,82431,19441,28277,199481,171204,No
BMSCE,Chemical Engineering,COMEDK,2024,197944,92468,14256,12829,317497,304668,Yes
UVCE,Electronics and Communication Engineering,KCET,2023,65356,64879,19217,27272,176724,149452,Yes
VVIT,Information Science and Engineering,COMEDK,2023,218963,71383,17455,18497,326298,307801,No
JNNCE,Data Science,COMEDK,2024,162434,78090,11078,28129,279731,251602,Yes
SIT,Chemical Engineering,COMEDK,2023,201748,76265,14701,25695,318409,292714,No
RIT,Mechanical Engineering,KCET,2024,65231,64462,9535,10537,149765,139228,No
MSRUAS,Mechanical Engineering,COMEDK,2024,178661,83206,9266,28307,299440,271133,No
RNSIT,Computer Science and Engineering,COMEDK,2024,225329,80779,13366,20721,340195,319474,No
NIE,Biotechnology,COMEDK,2024,228951,75751,18814,15108,338624,323516,Yes
RVUNIV,Chemical Engineering,KCET,2024,79609,91200,18772,12746,202327,189581,Yes
MSRUAS,Artificial Intelligence and Data Science,COMEDK,2023,206298,72449,10629,17854,307230,289376,No
BNMIT,Biotechnology,COMEDK,2023,245643,87465,12102,11433,356643,345210,No
RNSIT,Artificial Intelligence and Data Science,COMEDK,2024,241755,78224,10458,15936,346373,330437,No
VemanaIT,Information Science and Engineering,COMEDK,2023,168763,65402,14570,17848,266583,248735,No
NHCE,Civil Engineering,KCET,2023,65141,68599,10979,11815,156534,144719,Yes
RAIT,Aerospace Engineering,COMEDK,2024,232131,60252,19583,22479,334445,311966,Yes
KLSGIT,Information Science and Engineering,COMEDK,2023,193835,71538,19947,12272,297592,285320,Yes
AITM,Information Science and Engineering,COMEDK,2024,210235,94928,15683,23333,344179,320846,No
GIT,Mechanical Engineering,COMEDK,2023,232560,94188,14634,22199,363581,341382,Yes
EastPoint,Data Science,KCET,2024,69801,83102,9683,29653,192239,162586,No
AECMandya,Information Science and Engineering,COMEDK,2024,221215,93916,12020,10964,338115,327151,No
JSSSTU,Civil Engineering,KCET,2024,73840,80571,18527,28599,201537,172938,Yes
DSATM,Data Science,COMEDK,2024,181290,93696,8317,19833,303136,283303,Yes
REVA,Data Science,KCET,2023,75102,86015,9474,27939,198530,170591,Yes
DSATM,Information Science and Engineering,COMEDK,2023,209327,71465,19025,17322,317139,299817,Yes
REVA,Aerospace Engineering,COMEDK,2023,181215,80917,9471,20387,291990,271603,No
UVCE,Electrical and Electronics Engineering,COMEDK,2023,179622,84531,12808,24213,301174,276961,No
BNMIT,Mechanical Engineering,COMEDK,2023,196518,89787,12312,10964,309581,298617,Yes
DSATM,Aerospace Engineering,COMEDK,2023,165590,69401,12054,21020,268065,247045,No
REVA,Computer Science and Engineering,KCET,2024,80858,77805,10350,12788,181801,169013,Yes
RNSIT,Electrical and Electronics Engineering,KCET,2023,84820,64716,12196,24461,186193,161732,Yes
GMIT,Biotechnology,COMEDK,2024,205976,74273,13476,21744,315469,293725,No
SCEM,Electronics and Communication Engineering,COMEDK,2023,175536,80460,9568,24664,290228,265564,Yes
KLEIT,Robotics and Automation Engineering,KCET,2023,52800,68225,18738,11018,150781,139763,No
NIE,Chemical Engineering,KCET,2024,53658,85752,9234,16516,165160,148644,No
RNSIT,Information Science and Engineering,COMEDK,2024,242334,74607,17678,13784,348403,334619,No
JSSSTU,Artificial Intelligence and Data Science,KCET,2024,75050,94825,16476,12289,198640,186351,No
NIE,Computer Science and Engineering,COMEDK,2024,222181,74300,8593,25000,330074,305074,Yes
JNNCE,Data Science,KCET,2023,60831,75050,14268,14100,164249,150149,Yes
KLSGIT,Chemical Engineering,KCET,2024,53839,68687,19921,25380,167827,142447,Yes
BMSCE,Civil Engineering,KCET,2024,57996,60508,16786,28280,163570,135290,No
MSRIT,Chemical Engineering,KCET,2023,56039,75417,16429,21704,169589,147885,No
AITM,Civil Engineering,COMEDK,2024,211367,77528,11975,29616,330486,300870,No
AITM,Civil Engineering,COMEDK,2024,243351,83727,11278,13856,352212,338356,No
RNSIT,Robotics and Automation Engineering,KCET,2023,55448,69183,13589,23248,161468,138220,Yes
AIT,Aerospace Engineering,KCET,2024,70963,85071,12825,24564,193423,168859,No
GIT,Robotics and Automation Engineering,KCET,2024,54721,94846,15617,26638,191822,165184,No
ACU,Civil Engineering,COMEDK,2023,188523,76065,16411,13456,294455,280999,No
HKBK,Biotechnology,KCET,2023,57536,83936,13206,28179,182857,154678,No
BMIT,Artificial Intelligence and Data Science,COMEDK,2024,218150,87021,16796,29910,351877,321967,No
KLEIT,Mechanical Engineering,COMEDK,2023,239132,69428,18643,14167,341370,327203,No
DrAIT,Artificial Intelligence and Data Science,COMEDK,2024,200176,73041,17763,14073,305053,290980,No
KSIT,Biotechnology,KCET,2023,51678,85406,19476,17940,174500,156560,Yes
BITM,Electronics and Communication Engineering,KCET,2024,76346,81747,16110,21585,195788,174203,Yes
SIT,Biotechnology,KCET,2023,81776,78167,13534,11630,185107,173477,No
PRES,Information Science and Engineering,KCET,2023,79101,74377,8898,11565,173941,162376,No
RVCE,Information Science and Engineering,COMEDK,2024,218317,75576,17601,10839,322333,311494,Yes
RAIT,Electronics and Communication Engineering,KCET,2023,65255,60519,13575,27188,166537,139349,No
BMIT,Electrical and Electronics Engineering,COMEDK,2024,170267,83680,16598,14848,285393,270545,Yes
EastPoint,Artificial Intelligence and Data Science,KCET,2023,61225,84962,16803,26019,189009,162990,Yes
VemanaIT,Data Science,KCET,2023,71273,74701,11477,10166,167617,157451,No
NMIT,Aerospace Engineering,KCET,2024,65383,71490,9273,15266,161412,146146,Yes
RVCE,Biotechnology,KCET,2024,52639,83889,8739,14747,160014,145267,No
BMIT,Artificial Intelligence and Data Science,COMEDK,2024,193949,94836,13666,24740,327191,302451,No
KLSGIT,Aerospace Engineering,KCET,2023,75205,68158,13583,21350,178296,156946,No
ACU,Electrical and Electronics Engineering,COMEDK,2023,207998,73014,19711,25205,325928,300723,No
NMIT,Artificial Intelligence and Data Science,COMEDK,2023,197671,81450,13254,28210,320585,292375,Yes
NCET,Biotechnology,KCET,2023,64221,82359,13077,13922,173579,159657,Yes
BMSCE,Civil Engineering,COMEDK,2024,204459,93059,11858,16728,326104,309376,Yes
AECMandya,Chemical Engineering,KCET,2024,77028,80030,12595,22425,192078,169653,No
BITM,Aerospace Engineering,COMEDK,2023,194082,82932,18190,28386,323590,295204,No
MSRIT,Artificial Intelligence and Data Science,COMEDK,2024,186278,87696,14306,16971,305251,288280,No
YKCE,Data Science,KCET,2023,80210,65425,17268,23960,186863,162903,Yes
GMIT,Data Science,KCET,2024,84770,60249,17639,25469,188127,162658,Yes
BNMIT,Civil Engineering,KCET,2024,53284,74981,17149,25521,170935,145414,No
JIT,Biotechnology,COMEDK,2024,189896,65617,13039,12224,280776,268552,Yes
NHCE,Artificial Intelligence and Data Science,KCET,2024,83209,84545,14669,11075,193498,182423,No
AIT,Information Science and Engineering,KCET,2023,77449,62939,14977,17874,173239,155365,Yes
BIT,Computer Science and Engineering,KCET,2023,74252,82305,12170,10398,179125,168727,Yes
BMSCE,Electronics and Communication Engineering,COMEDK,2023,233293,62764,11258,21715,329030,307315,Yes
CITGubbi,Biotechnology,KCET,2023,53416,83873,14661,13213,165163,151950,No
GMIT,Artificial Intelligence and Data Science,KCET,2023,69604,87839,17770,13875,189088,175213,Yes
MSRUAS,Mechanical Engineering,COMEDK,2024,171028,60238,19284,26728,277278,250550,Yes
BNMIT,Data Science,COMEDK,2023,192096,86054,19051,22477,319678,297201,Yes
SDMCET,Mechanical Engineering,KCET,2023,80899,80230,15168,23913,200210,176297,Yes
JIT,Aerospace Engineering,COMEDK,2023,217950,60129,12620,26121,316820,290699,No
MSRUAS,Computer Science and Engineering,COMEDK,2023,229865,88220,10012,16604,344701,328097,Yes
MSRIT,Electrical and Electronics Engineering,KCET,2024,76296,80016,16729,18597,191638,173041,No
DSATM,Information Science and Engineering,COMEDK,2024,238982,92768,12351,27848,371949,344101,Yes
MSRIT,Electronics and Communication Engineering,KCET,2023,71711,71281,11380,10553,164925,154372,Yes
RAIT,Biotechnology,COMEDK,2023,219135,74499,16813,24108,334555,310447,Yes
RAIT,Electronics and Communication Engineering,COMEDK,2024,220048,76109,12389,14944,323490,308546,Yes
DSCE,Aerospace Engineering,COMEDK,2024,236447,73913,13332,22094,345786,323692,No
MSRUAS,Mechanical Engineering,KCET,2023,54759,89169,9656,18322,171906,153584,Yes
SDMCET,Aerospace Engineering,COMEDK,2023,177842,83153,14663,14843,290501,275658,Yes
MVJCE,Chemical Engineering,COMEDK,2024,181321,94232,12725,21646,309924,288278,No
RNSIT,Civil Engineering,KCET,2024,63100,81908,8566,15575,169149,153574,No
VSM,Data Science,KCET,2023,53087,88867,15423,13766,171143,157377,No
KLSGIT,Chemical Engineering,KCET,2023,83536,93423,15969,24350,217278,192928,Yes
KLSGIT,Computer Science and Engineering,KCET,2023,68139,81140,12019,20707,182005,161298,No
CITGubbi,Computer Science and Engineering,KCET,2023,64150,89056,19669,13385,186260,172875,No
RVCE,Chemical Engineering,KCET,2023,84403,76828,17611,19563,198405,178842,No
AEC,Artificial Intelligence and Data Science,COMEDK,2024,231638,71385,17729,18892,339644,320752,Yes
RNSIT,Civil Engineering,KCET,2024,74589,80816,10821,26749,192975,166226,Yes
VIT,Electronics and Communication Engineering,KCET,2023,54853,91029,13810,29809,189501,159692,Yes
ACU,Biotechnology,COMEDK,2024,184267,63216,10500,17416,275399,257983,No
VSM,Aerospace Engineering,COMEDK,2023,174783,87759,12713,28448,303703,275255,No
VVIT,Civil Engineering,KCET,2024,76386,80764,14659,24693,196502,171809,No
YKCE,Electronics and Communication Engineering,COMEDK,2024,232422,74716,14851,27025,349014,321989,Yes
DSATM,Biotechnology,KCET,2023,59417,75576,8172,14179,157344,143165,No
JSSSTU,Civil Engineering,KCET,2024,51175,74220,13779,19063,158237,139174,Yes
DBIT,Electronics and Communication Engineering,COMEDK,2023,202193,82958,12850,23660,321661,298001,No
VVCE,Electrical and Electronics Engineering,KCET,2024,54044,78553,13471,19888,165956,146068,Yes
PESCE,Aerospace Engineering,COMEDK,2023,208330,83618,11154,19949,323051,303102,Yes
AECMandya,Information Science and Engineering,COMEDK,2024,184700,91258,10795,22676,309429,286753,No
JIT,Electrical and Electronics Engineering,COMEDK,2023,168380,74553,12426,21989,277348,255359,Yes
REVA,Information Science and Engineering,COMEDK,2023,191862,62200,16241,24121,294424,270303,No
KLSGIT,Artificial Intelligence and Data Science,COMEDK,2023,212058,83591,11370,16602,323621,307019,Yes
VVCE,Data Science,KCET,2024,82185,68558,11200,26422,188365,161943,Yes
NHCE,Data Science,COMEDK,2023,231362,64315,8106,23319,327102,303783,No
GIT,Data Science,KCET,2024,54893,62189,14701,10427,142210,131783,Yes
SDMIT,Aerospace Engineering,COMEDK,2024,176957,92939,13600,18238,301734,283496,No
BMIT,Data Science,COMEDK,2023,246053,91764,13385,14083,365285,351202,No
BNMIT,Electrical and Electronics Engineering,COMEDK,2024,188912,73751,16015,16562,295240,278678,No
AECMandya,Biotechnology,KCET,2023,58652,88221,11545,17596,176014,158418,Yes
RVUNIV,Information Science and Engineering,KCET,2023,69376,72124,9244,29451,180195,150744,No
JSSSTU,Electrical and Electronics Engineering,COMEDK,2023,209336,71045,18632,11620,310633,299013,Yes
GMIT,Artificial Intelligence and Data Science,COMEDK,2023,242571,69747,10472,14014,336804,322790,Yes
GIT,Civil Engineering,KCET,2024,67274,77384,18483,20522,183663,163141,No
NHCE,Civil Engineering,KCET,2024,59467,78562,10121,25068,173218,148150,No
BMIT,Aerospace Engineering,KCET,2023,78002,74323,12778,10646,175749,165103,No
SIT,Civil Engineering,COMEDK,2023,248889,86348,12775,22238,370250,348012,Yes
KLSGIT,Biotechnology,KCET,2024,59502,85847,14227,12151,171727,159576,Yes
BMIT,Civil Engineering,KCET,2023,71967,84715,18558,13134,188374,175240,No
SJBIT,Aerospace Engineering,KCET,2023,61249,78490,10355,21188,171282,150094,Yes
VIT,Biotechnology,KCET,2024,74251,81330,17425,15215,188221,173006,Yes
SDMIT,Biotechnology,KCET,2024,56125,91549,9183,21312,178169,156857,Yes
BMIT,Information Science and Engineering,KCET,2024,53429,64107,19280,26421,163237,136816,Yes
SDMIT,Electrical and Electronics Engineering,KCET,2024,78564,65512,11058,11600,166734,155134,Yes
PRES,Biotechnology,COMEDK,2024,209921,76988,12806,22014,321729,299715,No
KLEIT,Aerospace Engineering,COMEDK,2024,165955,92218,16556,27545,302274,274729,Yes
RNSIT,Electrical and Electronics Engineering,KCET,2023,52511,92196,15850,22552,183109,160557,Yes
KSIT,Robotics and Automation Engineering,COMEDK,2024,164374,66529,15129,12758,258790,246032,No
EastPoint,Electronics and Communication Engineering,KCET,2024,81786,65721,9679,14898,172084,157186,No
RNSIT,Mechanical Engineering,KCET,2024,53837,67680,16366,29222,167105,137883,No
BMSIT,Electrical and Electronics Engineering,COMEDK,2024,174378,86444,11381,24421,296624,272203,No
BITM,Aerospace Engineering,COMEDK,2024,197486,65481,10285,12772,286024,273252,No
BMSIT,Chemical Engineering,COMEDK,2023,201074,65228,15067,24202,305571,281369,Yes
AEC,Artificial Intelligence and Data Science,COMEDK,2023,216804,87497,8018,13784,326103,312319,Yes
BNMIT,Electronics and Communication Engineering,KCET,2024,80588,65488,11117,27246,184439,157193,No
RNSIT,Information Science and Engineering,KCET,2023,67336,82463,16309,14978,181086,166108,No
YKCE,Aerospace Engineering,COMEDK,2023,205269,73322,11356,21748,311695,289947,No
SJBCE,Mechanical Engineering,KCET,2024,70194,76115,16868,28214,191391,163177,No
BIT,Electrical and Electronics Engineering,COMEDK,2024,238232,64327,12822,15068,330449,315381,Yes
MVJCE,Data Science,COMEDK,2023,169547,77706,17695,12330,277278,264948,Yes
JIT,Aerospace Engineering,COMEDK,2023,166876,90461,8572,10170,276079,265909,Yes
NIE,Information Science and Engineering,COMEDK,2023,178104,60511,18158,16732,273505,256773,No
DSATM,Electrical and Electronics Engineering,COMEDK,2023,177766,81733,19917,25838,305254,279416,Yes
SDMCET,Electrical and Electronics Engineering,KCET,2023,53811,71968,12709,12479,150967,138488,No
AECMandya,Electrical and Electronics Engineering,KCET,2024,82797,73335,19053,26123,201308,175185,Yes
CMRIT,Computer Science and Engineering,KCET,2023,61792,88545,15807,16257,182401,166144,No
REVA,Robotics and Automation Engineering,KCET,2023,84491,72849,16977,28961,203278,174317,Yes
AITM,Data Science,KCET,2023,51797,65056,16404,25354,158611,133257,No
DrAIT,Computer Science and Engineering,KCET,2024,80336,75648,18749,11155,185888,174733,Yes
DSCE,Biotechnology,COMEDK,2024,228454,87021,10057,16019,341551,325532,No
KSIT,Data Science,KCET,2024,79056,81760,14918,24278,200012,175734,Yes
KLEIT,Information Science and Engineering,COMEDK,2023,244885,66279,15911,13314,340389,327075,Yes
UVCE,Data Science,COMEDK,2023,206895,74181,10148,17123,308347,291224,Yes
MSRUAS,Computer Science and Engineering,COMEDK,2024,213304,65393,9595,29804,318096,288292,Yes
BIT,Computer Science and Engineering,COMEDK,2024,215672,71478,15778,15862,318790,302928,No
AITM,Information Science and Engineering,COMEDK,2024,168775,88648,12137,26780,296340,269560,Yes
BMSCE,Robotics and Automation Engineering,COMEDK,2024,224930,84325,17796,22511,349562,327051,Yes
SJBCE,Robotics and Automation Engineering,KCET,2023,72193,87805,18494,12812,191304,178492,No
PESCE,Computer Science and Engineering,COMEDK,2023,222877,88838,9786,28541,350042,321501,No
SCEM,Robotics and Automation Engineering,KCET,2023,83370,83750,19031,14550,200701,186151,Yes
SCEM,Data Science,COMEDK,2023,231192,66147,8790,11262,317391,306129,No
SDMIT,Civil Engineering,KCET,2024,57923,75635,16441,11397,161396,149999,Yes
JNNCE,Information Science and Engineering,COMEDK,2024,213743,71824,11449,27203,324219,297016,No
SJBIT,Mechanical Engineering,KCET,2023,70570,81571,10266,19581,181988,162407,Yes
ACU,Data Science,COMEDK,2023,208313,78607,19822,15705,322447,306742,Yes
NIE,Aerospace Engineering,KCET,2024,77671,81836,13772,16346,189625,173279,No
PESU,Civil Engineering,KCET,2023,74666,65899,8314,24018,172897,148879,Yes
SJBCE,Robotics and Automation Engineering,COMEDK,2024,213758,62669,8231,20529,305187,284658,Yes
BMSIT,Information Science and Engineering,KCET,2024,71275,78210,16178,11915,177578,165663,No
AEC,Aerospace Engineering,COMEDK,2023,244288,73702,13803,28329,360122,331793,No
RVUNIV,Mechanical Engineering,KCET,2023,61655,61588,15586,10860,149689,138829,No
CITGubbi,Information Science and Engineering,COMEDK,2024,191414,81635,15923,22669,311641,288972,No
NHCE,Information Science and Engineering,KCET,2023,70691,83033,19412,26490,199626,173136,Yes
SJBIT,Data Science,KCET,2024,72372,90229,13511,22179,198291,176112,No
KLEIT,Electronics and Communication Engineering,COMEDK,2023,225268,87589,10013,20318,343188,322870,No
VVCE,Artificial Intelligence and Data Science,COMEDK,2023,191638,81761,17983,29417,320799,291382,Yes
BMIT,Electrical and Electronics Engineering,COMEDK,2023,173790,72780,15652,11832,274054,262222,Yes
SIT,Computer Science and Engineering,COMEDK,2023,231192,90485,12205,11538,345420,333882,No
VIT,Electrical and Electronics Engineering,KCET,2024,60836,68394,18026,11337,158593,147256,Yes
UVCE,Information Science and Engineering,COMEDK,2023,206317,77530,15134,13479,312460,298981,Yes
KLEIT,Civil Engineering,KCET,2024,73440,94238,17084,17689,202451,184762,No
AECMandya,Computer Science and Engineering,COMEDK,2024,225328,82767,19343,25799,353237,327438,No
KLSGIT,Civil Engineering,KCET,2023,50237,93266,9972,29453,182928,153475,No
SITM,Electrical and Electronics Engineering,COMEDK,2023,189682,62750,9876,14147,276455,262308,No
JIT,Electronics and Communication Engineering,KCET,2023,79380,79929,12443,15689,187441,171752,No
BIT,Robotics and Automation Engineering,KCET,2023,72254,78048,9748,12300,172350,160050,Yes
VemanaIT,Biotechnology,KCET,2024,55420,80246,19739,16466,171871,155405,No
GMIT,Chemical Engineering,KCET,2024,66150,84462,15595,24299,190506,166207,No
DSCE,Civil Engineering,COMEDK,2023,195059,89119,19673,21951,325802,303851,Yes
BMSCE,Electrical and Electronics Engineering,COMEDK,2024,213418,73312,17096,10091,313917,303826,Yes
RVUNIV,Aerospace Engineering,COMEDK,2023,164339,88350,19626,14796,287111,272315,Yes
RAIT,Electronics and Communication Engineering,KCET,2024,74999,73557,8951,23420,180927,157507,No
DSCE,Electrical and Electronics Engineering,KCET,2024,51529,66056,10354,20596,148535,127939,No
HKBK,Electronics and Communication Engineering,COMEDK,2024,164901,81635,14904,17870,279310,261440,Yes
AITM,Artificial Intelligence and Data Science,KCET,2024,68158,66587,10483,22352,167580,145228,No
YKCE,Biotechnology,COMEDK,2024,244871,91569,16595,20808,373843,353035,Yes
BIT,Robotics and Automation Engineering,COMEDK,2023,164023,74719,9205,17135,265082,247947,No
NMIT,Chemical Engineering,KCET,2024,58500,92661,8389,10407,169957,159550,Yes
NIE,Data Science,COMEDK,2024,184639,71905,19553,24001,300098,276097,Yes
VSM,Electronics and Communication Engineering,KCET,2023,55262,89843,17609,15187,177901,162714,No
BMSCE,Aerospace Engineering,COMEDK,2023,239213,75021,18198,18815,351247,332432,Yes
JNNCE,Biotechnology,KCET,2023,52552,64389,8786,24487,150214,125727,Yes
KSIT,Aerospace Engineering,KCET,2023,58705,87244,10082,16597,172628,156031,Yes
DSCE,Data Science,COMEDK,2024,184050,80234,8079,16253,288616,272363,No
RNSIT,Aerospace Engineering,KCET,2023,60276,84491,8853,27256,180876,153620,Yes
MVJCE,Electronics and Communication Engineering,KCET,2024,60122,63617,19391,18318,161448,143130,Yes
CITGubbi,Mechanical Engineering,KCET,2023,68120,85891,8783,24083,186877,162794,No
REVA,Mechanical Engineering,COMEDK,2024,228242,88388,14232,20760,351622,330862,No
PESCE,Civil Engineering,COMEDK,2024,222974,64280,16029,16809,320092,303283,Yes
VVCE,Civil Engineering,COMEDK,2023,188602,94832,11202,23192,317828,294636,Yes
BMSCE,Computer Science and Engineering,KCET,2024,83768,94696,13786,19260,211510,192250,No
BMSCE,Biotechnology,KCET,2024,51655,73130,11934,22479,159198,136719,No
NIE,Chemical Engineering,COMEDK,2024,224921,71984,18090,29550,344545,314995,Yes
SCEM,Aerospace Engineering,KCET,2023,55889,81107,9447,21525,167968,146443,No
RNSIT,Civil Engineering,KCET,2023,50220,76831,10777,18145,155973,137828,No
UVCE,Electrical and Electronics Engineering,COMEDK,2023,210211,94836,12560,11988,329595,317607,No
AECMandya,Robotics and Automation Engineering,COMEDK,2024,225179,86936,16044,17764,345923,328159,Yes
PESCE,Aerospace Engineering,COMEDK,2023,195866,81621,8139,19430,305056,285626,No
KLSGIT,Robotics and Automation Engineering,COMEDK,2023,243219,82437,16116,16951,358723,341772,No
KLSGIT,Electronics and Communication Engineering,KCET,2024,79524,69914,14981,11868,176287,164419,No
VVCE,Civil Engineering,COMEDK,2023,166819,82720,18273,10637,278449,267812,No
BMSIT,Computer Science and Engineering,COMEDK,2023,190171,87154,18785,27741,323851,296110,No
NMIT,Electronics and Communication Engineering,KCET,2023,62629,86027,13354,27701,189711,162010,No
JSSSTU,Robotics and Automation Engineering,KCET,2024,54927,91400,10360,28988,185675,156687,No
RVUNIV,Information Science and Engineering,COMEDK,2024,175734,88538,12631,21571,298474,276903,Yes
NCET,Civil Engineering,KCET,2024,75598,63008,12406,11626,162638,151012,Yes
PRES,Chemical Engineering,KCET,2023,64297,66795,15694,18305,165091,146786,Yes
VVCE,Aerospace Engineering,KCET,2023,82128,64828,9685,17564,174205,156641,Yes
SJBIT,Mechanical Engineering,COMEDK,2024,239938,74874,16766,23883,355461,331578,Yes
YKCE,Electronics and Communication Engineering,COMEDK,2024,245232,90827,11180,19310,366549,347239,No
SCEM,Electronics and Communication Engineering,KCET,2024,82792,79754,19483,12786,194815,182029,Yes
DSCE,Electronics and Communication Engineering,COMEDK,2023,176836,68419,14555,27347,287157,259810,No
YKCE,Robotics and Automation Engineering,KCET,2024,57776,60011,14688,24061,156536,132475,Yes
KSIT,Information Science and Engineering,KCET,2024,66061,68275,17301,26512,178149,151637,No
HKBK,Artificial Intelligence and Data Science,KCET,2023,52574,77348,18391,29186,177499,148313,No
NIE,Information Science and Engineering,KCET,2024,62458,81696,14235,26474,184863,158389,Yes
PESU,Data Science,COMEDK,2023,216836,60477,12454,19997,309764,289767,Yes
VVCE,Mechanical Engineering,COMEDK,2023,246284,65375,13216,24095,348970,324875,Yes
RIT,Chemical Engineering,KCET,2023,65759,77238,12042,29241,184280,155039,Yes
CMRIT,Mechanical Engineering,KCET,2024,70963,93490,13159,11829,189441,177612,No
AEC,Information Science and Engineering,COMEDK,2023,174335,93947,14253,19268,301803,282535,No
REVA,Artificial Intelligence and Data Science,COMEDK,2024,242681,85454,9684,10189,348008,337819,Yes
SJBIT,Computer Science and Engineering,KCET,2024,70498,83574,8959,20876,183907,163031,No
BMSCE,Civil Engineering,KCET,2023,65040,63373,9399,28674,166486,137812,No
DrAIT,Mechanical Engineering,KCET,2024,54617,84597,14469,12655,166338,153683,Yes
PESU,Data Science,COMEDK,2023,198656,62645,12228,20266,293795,273529,No
EastPoint,Computer Science and Engineering,COMEDK,2023,160607,72646,13802,19694,266749,247055,No
NCET,Data Science,KCET,2024,67433,68188,15866,27717,179204,151487,No
HKBK,Chemical Engineering,COMEDK,2024,195705,82551,11670,16295,306221,289926,No
MVJCE,Artificial Intelligence and Data Science,COMEDK,2024,219092,67939,13172,12727,312930,300203,No
ACU,Artificial Intelligence and Data Science,KCET,2024,82119,90736,12915,15136,200906,185770,Yes
AECMandya,Data Science,COMEDK,2024,227556,63240,18672,18270,327738,309468,No
SCEM,Electronics and Communication Engineering,COMEDK,2023,229391,60611,14958,24585,329545,304960,Yes
GMIT,Aerospace Engineering,COMEDK,2023,227173,78795,16905,10724,333597,322873,Yes
BMIT,Electronics and Communication Engineering,KCET,2023,80426,79771,12316,11982,184495,172513,No
BMSIT,Mechanical Engineering,KCET,2024,84525,66046,18688,20138,189397,169259,No
JSSSTU,Data Science,COMEDK,2024,166544,90097,17937,19928,294506,274578,No
VIT,Aerospace Engineering,COMEDK,2023,221605,88222,18302,11071,339200,328129,No
DSCE,Biotechnology,KCET,2024,81165,76915,16837,12410,187327,174917,No
RVCE,Electrical and Electronics Engineering,KCET,2023,84279,93042,18237,27486,223044,195558,No
BMSIT,Mechanical Engineering,COMEDK,2023,170908,86047,9997,22527,289479,266952,Yes
DBIT,Computer Science and Engineering,KCET,2024,76176,94012,19339,25737,215264,189527,Yes
BMIT,Biotechnology,COMEDK,2024,240105,66658,16790,28534,352087,323553,Yes
UVCE,Data Science,KCET,2023,82498,85379,13205,29579,210661,181082,No
MVJCE,Chemical Engineering,KCET,2024,73172,67496,9622,18683,168973,150290,No
PESCE,Data Science,KCET,2023,55913,74282,12360,12650,155205,142555,No
GMIT,Electronics and Communication Engineering,KCET,2023,59237,84818,10368,21585,176008,154423,Yes
NCET,Electrical and Electronics Engineering,COMEDK,2024,241971,60942,17201,21632,341746,320114,Yes
BITM,Artificial Intelligence and Data Science,COMEDK,2023,220361,89896,11997,26873,349127,322254,No
UVCE,Information Science and Engineering,COMEDK,2024,192491,69423,19106,18623,299643,281020,No
VIT,Electronics and Communication Engineering,COMEDK,2023,223045,63300,12535,23864,322744,298880,No
BIT,Civil Engineering,COMEDK,2023,202291,73670,11107,15389,302457,287068,Yes
RVCE,Biotechnology,KCET,2023,82211,93949,12752,21190,210102,188912,No
SDMCET,Mechanical Engineering,COMEDK,2023,228113,93986,13218,11346,346663,335317,No
RIT,Computer Science and Engineering,KCET,2023,77645,72397,13507,14260,177809,163549,No
KSIT,Electrical and Electronics Engineering,COMEDK,2024,245565,89912,18715,29024,383216,354192,No
DSCE,Robotics and Automation Engineering,COMEDK,2023,168210,83489,14501,13169,279369,266200,No
MSRUAS,Civil Engineering,COMEDK,2023,248924,93549,15994,12644,371111,358467,No
DSCE,Civil Engineering,KCET,2024,77175,83619,8547,29921,199262,169341,No
EastPoint,Electronics and Communication Engineering,KCET,2024,77845,65686,15842,26737,186110,159373,Yes
VVCE,Mechanical Engineering,KCET,2023,82761,70157,9041,22937,184896,161959,No
MSRUAS,Data Science,COMEDK,2023,241184,65924,10051,18346,335505,317159,No
GIT,Electrical and Electronics Engineering,KCET,2023,60234,93808,19888,23234,197164,173930,Yes
GIT,Mechanical Engineering,COMEDK,2023,238301,78207,8683,22569,347760,325191,No
UVCE,Civil Engineering,COMEDK,2023,220113,60238,13466,16495,310312,293817,No
SCEM,Artificial Intelligence and Data Science,KCET,2023,82509,60901,18272,17692,179374,161682,No
AITM,Chemical Engineering,COMEDK,2023,209488,73134,9978,22702,315302,292600,Yes
EastPoint,Civil Engineering,COMEDK,2023,177209,89426,11596,28166,306397,278231,No
SJBCE,Robotics and Automation Engineering,KCET,2023,68761,90258,9109,17629,185757,168128,Yes
SITM,Civil Engineering,COMEDK,2023,170287,65690,17797,28638,282412,253774,Yes
NMIT,Chemical Engineering,KCET,2024,78651,81389,10773,18765,189578,170813,Yes
AIT,Electrical and Electronics Engineering,COMEDK,2024,207238,71095,17820,10437,306590,296153,Yes
KSIT,Electrical and Electronics Engineering,COMEDK,2024,207135,74938,12037,14903,309013,294110,No
SIT,Chemical Engineering,KCET,2023,77029,78186,8413,18611,182239,163628,No
AIT,Mechanical Engineering,KCET,2023,82227,80849,9330,20896,193302,172406,No
NHCE,Biotechnology,COMEDK,2023,183064,76811,18657,21660,300192,278532,Yes
NCET,Robotics and Automation Engineering,KCET,2023,61711,87101,15613,20868,185293,164425,No
RVCE,Electronics and Communication Engineering,COMEDK,2023,246417,86464,11572,14595,359048,344453,Yes
JSSSTU,Mechanical Engineering,KCET,2024,68696,74605,19391,11119,173811,162692,No
RNSIT,Electronics and Communication Engineering,COMEDK,2023,218588,93487,12732,16520,341327,324807,Yes
BMIT,Data Science,KCET,2023,59105,67982,13646,14278,155011,140733,Yes
AEC,Biotechnology,KCET,2023,58266,83773,17590,27273,186902,159629,Yes
GIT,Aerospace Engineering,COMEDK,2023,185243,85350,15115,14287,299995,285708,No
DSCE,Information Science and Engineering,COMEDK,2024,191321,69795,8483,22640,292239,269599,Yes
NHCE,Biotechnology,COMEDK,2024,207824,82709,16138,20929,327600,306671,No
NIE,Artificial Intelligence and Data Science,COMEDK,2024,248495,64575,19737,10423,343230,332807,No
BNMIT,Electrical and Electronics Engineering,COMEDK,2024,195319,94785,8340,12580,311024,298444,Yes
BMSCE,Artificial Intelligence and Data Science,COMEDK,2023,216997,89641,10825,13918,331381,317463,No
SITM,Aerospace Engineering,KCET,2023,83718,69288,16851,16800,186657,169857,No
SITM,Electronics and Communication Engineering,KCET,2023,52991,92974,13340,21479,180784,159305,No
NHCE,Mechanical Engineering,COMEDK,2024,217053,85947,10134,19422,332556,313134,No
BMSCE,Civil Engineering,COMEDK,2024,231053,77916,18308,22218,349495,327277,Yes
HKBK,Electronics and Communication Engineering,COMEDK,2024,235853,77169,13702,23193,349917,326724,No
RNSIT,Electronics and Communication Engineering,COMEDK,2024,247937,88687,17990,13465,368079,354614,Yes
JSSSTU,Computer Science and Engineering,COMEDK,2023,242277,88791,18588,14027,363683,349656,Yes
AITM,Aerospace Engineering,COMEDK,2023,244349,75057,14159,23273,356838,333565,No
SDMCET,Biotechnology,KCET,2023,84253,83379,10813,24956,203401,178445,Yes
VVIT,Aerospace Engineering,COMEDK,2023,212536,63399,17019,28649,321603,292954,No
KLEIT,Electronics and Communication Engineering,COMEDK,2024,181078,89760,11559,19385,301782,282397,Yes
DSATM,Artificial Intelligence and Data Science,KCET,2024,70853,70500,14961,17219,173533,156314,No
NCET,Electronics and Communication Engineering,COMEDK,2023,166206,84425,19903,23532,294066,270534,Yes
SJBCE,Data Science,COMEDK,2024,236910,72814,12522,29102,351348,322246,No
PESU,Mechanical Engineering,KCET,2024,63212,79390,10208,18175,170985,152810,Yes
AEC,Aerospace Engineering,COMEDK,2024,171467,89034,19913,22681,303095,280414,Yes
RVUNIV,Electrical and Electronics Engineering,KCET,2023,73391,80555,11702,28231,193879,165648,No
GMIT,Biotechnology,KCET,2024,77947,83843,16482,19354,197626,178272,Yes
PESCE,Aerospace Engineering,KCET,2024,56806,73434,18740,16250,165230,148980,No
REVA,Chemical Engineering,KCET,2023,62370,92666,19506,14929,189471,174542,No
KLSGIT,Biotechnology,COMEDK,2023,244724,78161,13659,25260,361804,336544,Yes
PESU,Chemical Engineering,COMEDK,2023,216608,86451,18688,17679,339426,321747,Yes
AITM,Information Science and Engineering,KCET,2023,55894,90691,11940,17385,175910,158525,Yes
VemanaIT,Information Science and Engineering,KCET,2023,64637,89368,19511,18418,191934,173516,No
NHCE,Information Science and Engineering,KCET,2024,76790,93307,9105,14960,194162,179202,No
JIT,Artificial Intelligence and Data Science,COMEDK,2024,227307,74196,17860,15149,334512,319363,No
EastPoint,Chemical Engineering,COMEDK,2024,160411,60902,19374,29669,270356,240687,Yes
DSCE,Electronics and Communication Engineering,KCET,2023,72609,74075,8005,10567,165256,154689,No
VSM,Information Science and Engineering,COMEDK,2023,190975,69087,15940,28927,304929,276002,Yes
PRES,Chemical Engineering,COMEDK,2024,199999,77657,10472,29729,317857,288128,No
VSM,Aerospace Engineering,COMEDK,2024,174831,79714,14684,17768,286997,269229,No
VIT,Chemical Engineering,COMEDK,2023,248934,63995,17090,17423,347442,330019,No
CITGubbi,Data Science,KCET,2024,76068,82770,14952,14020,187810,173790,No
HKBK,Mechanical Engineering,COMEDK,2024,179424,84658,12652,23053,299787,276734,No
SITM,Biotechnology,KCET,2024,50871,62267,11729,26597,151464,124867,No
SCEM,Electronics and Communication Engineering,COMEDK,2023,232348,80963,8112,12139,333562,321423,Yes
KLSGIT,Mechanical Engineering,KCET,2023,78648,73336,19643,23515,195142,171627,Yes
MSRUAS,Electrical and Electronics Engineering,KCET,2024,83780,85771,12618,19708,201877,182169,No
CITGubbi,Aerospace Engineering,KCET,2024,73052,69852,17377,27150,187431,160281,No
KLSGIT,Robotics and Automation Engineering,KCET,2023,77942,69880,13473,14630,175925,161295,Yes
CITGubbi,Computer Science and Engineering,COMEDK,2023,192819,93030,19464,14398,319711,305313,Yes
RVUNIV,Robotics and Automation Engineering,KCET,2023,51148,92046,8840,29712,181746,152034,No
RAIT,Mechanical Engineering,KCET,2024,56608,75718,15320,23453,171099,147646,No
MSRUAS,Aerospace Engineering,KCET,2023,51668,69109,11936,23750,156463,132713,Yes
BMSCE,Electronics and Communication Engineering,KCET,2024,77950,70412,15637,14945,178944,163999,No
KLSGIT,Mechanical Engineering,COMEDK,2024,229584,91966,15072,12057,348679,336622,Yes
MSRUAS,Biotechnology,COMEDK,2024,186829,68664,18153,20687,294333,273646,No
RAIT,Electronics and Communication Engineering,COMEDK,2024,182621,84885,15351,18750,301607,282857,No
AIT,Aerospace Engineering,KCET,2024,63303,66009,15305,13544,158161,144617,No
SITM,Electrical and Electronics Engineering,COMEDK,2023,249956,61709,8682,28799,349146,320347,Yes
KLEIT,Electronics and Communication Engineering,KCET,2023,58414,75693,14872,15773,164752,148979,No
BMIT,Artificial Intelligence and Data Science,KCET,2023,75090,76611,19385,22205,193291,171086,No
SCEM,Biotechnology,COMEDK,2024,189367,73757,12864,17180,293168,275988,No
NMIT,Electrical and Electronics Engineering,COMEDK,2024,226402,77454,9533,26894,340283,313389,Yes
VVIT,Civil Engineering,KCET,2024,67167,70195,17988,14839,170189,155350,Yes
NMIT,Chemical Engineering,KCET,2023,67878,83691,18029,17990,187588,169598,No
AIT,Information Science and Engineering,COMEDK,2024,174190,65258,9995,19198,268641,249443,Yes
SJBIT,Artificial Intelligence and Data Science,COMEDK,2023,226672,84133,8623,13821,333249,319428,No
GMIT,Computer Science and Engineering,COMEDK,2024,167133,62438,9353,18742,257666,238924,No
SCEM,Mechanical Engineering,COMEDK,2023,236921,77140,14288,15391,343740,328349,No
PESCE,Artificial Intelligence and Data Science,KCET,2024,77756,67642,13106,20704,179208,158504,No
JIT,Electrical and Electronics Engineering,COMEDK,2024,196490,69341,12827,12451,291109,278658,No
SITM,Information Science and Engineering,KCET,2024,65072,71174,11337,19457,167040,147583,Yes
BMIT,Computer Science and Engineering,COMEDK,2023,180508,78089,16593,23618,298808,275190,No
KLEIT,Electrical and Electronics Engineering,COMEDK,2024,230544,91259,16350,12208,350361,338153,No
RNSIT,Aerospace Engineering,KCET,2024,76210,71310,15251,25972,188743,162771,Yes
SIT,Information Science and Engineering,KCET,2024,57210,75040,14449,22064,168763,146699,Yes
BNMIT,Data Science,COMEDK,2023,167705,91961,15044,18769,293479,274710,No
DSCE,Electronics and Communication Engineering,COMEDK,2023,228611,83546,9644,11293,333094,321801,Yes
MSRUAS,Civil Engineering,KCET,2024,70592,87556,17047,17454,192649,175195,Yes
NHCE,Computer Science and Engineering,KCET,2024,50489,94116,11088,14939,170632,155693,No
AIT,Electronics and Communication Engineering,KCET,2024,75507,80281,18234,21951,195973,174022,Yes
YKCE,Civil Engineering,COMEDK,2023,240005,83517,12386,14546,350454,335908,Yes
SCEM,Information Science and Engineering,KCET,2024,68319,92293,9385,23538,193535,169997,No
RVUNIV,Mechanical Engineering,KCET,2024,75928,85193,13088,27398,201607,174209,No
SCEM,Data Science,COMEDK,2023,229223,65846,12717,25643,333429,307786,Yes
REVA,Aerospace Engineering,KCET,2023,61406,63765,11667,19005,155843,136838,No
HKBK,Electronics and Communication Engineering,COMEDK,2023,180978,68802,12688,13077,275545,262468,No
VSM,Robotics and Automation Engineering,COMEDK,2023,185489,72569,12421,29601,300080,270479,Yes
SDMIT,Robotics and Automation Engineering,KCET,2024,80961,65635,10159,17411,174166,156755,Yes
RIT,Electrical and Electronics Engineering,COMEDK,2024,204692,79644,10782,11828,306946,295118,No
CITGubbi,Data Science,KCET,2023,82410,81799,13155,29190,206554,177364,Yes
PESU,Robotics and Automation Engineering,COMEDK,2023,233046,65732,16788,13813,329379,315566,No
AECMandya,Chemical Engineering,COMEDK,2024,213225,77591,15999,13708,320523,306815,Yes
MSRUAS,Data Science,COMEDK,2024,220972,89482,13475,24851,348780,323929,Yes
UVCE,Aerospace Engineering,KCET,2023,53764,93856,11158,15727,174505,158778,Yes
GIT,Electronics and Communication Engineering,KCET,2023,53295,84714,16723,15399,170131,154732,Yes
VVCE,Data Science,COMEDK,2024,204632,93518,18249,24408,340807,316399,No
KLEIT,Electrical and Electronics Engineering,COMEDK,2024,168556,65829,19114,25261,278760,253499,Yes
DrAIT,Electronics and Communication Engineering,KCET,2024,58894,70239,19601,13812,162546,148734,Yes
SDMCET,Data Science,KCET,2024,50172,65820,17782,28282,162056,133774,No
REVA,Mechanical Engineering,COMEDK,2023,161627,82848,16142,17039,277656,260617,No
AEC,Electrical and Electronics Engineering,KCET,2024,54438,68639,19162,19256,161495,142239,Yes
ACU,Data Science,COMEDK,2024,161835,74409,15996,26098,278338,252240,Yes
DBIT,Artificial Intelligence and Data Science,COMEDK,2023,249394,65628,15644,19993,350659,330666,Yes
REVA,Electrical and Electronics Engineering,KCET,2024,61826,72613,8684,13482,156605,143123,Yes
SCEM,Chemical Engineering,COMEDK,2024,221374,83996,14933,26484,346787,320303,Yes
AECMandya,Civil Engineering,COMEDK,2024,209393,60662,10787,28683,309525,280842,No
GIT,Biotechnology,COMEDK,2023,244894,92441,9475,23734,370544,346810,No
SIT,Biotechnology,KCET,2024,59967,84754,17008,22508,184237,161729,No
RIT,Robotics and Automation Engineering,KCET,2023,74183,74880,8854,17522,175439,157917,Yes
HKBK,Electronics and Communication Engineering,KCET,2023,75403,63585,10978,27233,177199,149966,Yes
HKBK,Artificial Intelligence and Data Science,KCET,2024,84207,80923,16427,27261,208818,181557,No
PESCE,Biotechnology,COMEDK,2023,161013,86897,15760,15284,278954,263670,Yes
PESCE,Chemical Engineering,COMEDK,2024,223580,68479,9069,16785,317913,301128,No
VSM,Robotics and Automation Engineering,KCET,2023,78213,73865,17548,16148,185774,169626,Yes
RVCE,Biotechnology,KCET,2023,66354,86863,17262,29723,200202,170479,No
BITM,Chemical Engineering,COMEDK,2024,174128,77573,11986,28937,292624,263687,No
ACU,Information Science and Engineering,KCET,2024,62467,92618,10520,17085,182690,165605,Yes
DSCE,Artificial Intelligence and Data Science,COMEDK,2024,179157,69375,13258,12558,274348,261790,No
DrAIT,Biotechnology,COMEDK,2023,207744,86934,12080,14788,321546,306758,No
AEC,Civil Engineering,KCET,2023,79041,70730,19627,12838,182236,169398,Yes
SJBCE,Robotics and Automation Engineering,COMEDK,2023,175993,76891,15141,11652,279677,268025,No
DBIT,Artificial Intelligence and Data Science,KCET,2023,74760,86217,18769,21163,200909,179746,Yes
JNNCE,Electronics and Communication Engineering,KCET,2023,62459,74937,16981,18956,173333,154377,No
PESU,Electrical and Electronics Engineering,KCET,2023,57362,77896,16770,13656,165684,152028,Yes
BNMIT,Information Science and Engineering,COMEDK,2023,210877,67894,19804,11841,310416,298575,No
ACU,Biotechnology,COMEDK,2024,200414,60643,10133,10513,281703,271190,No
REVA,Robotics and Automation Engineering,KCET,2023,69698,89921,12471,17931,190021,172090,No
BIT,Aerospace Engineering,COMEDK,2024,165193,60575,12286,22393,260447,238054,Yes
GIT,Artificial Intelligence and Data Science,KCET,2023,53132,65532,18596,10251,147511,137260,No
VVIT,Biotechnology,COMEDK,2024,246876,86011,16652,12229,361768,349539,No
NIE,Mechanical Engineering,KCET,2024,64061,65859,10735,25773,166428,140655,Yes
PESU,Robotics and Automation Engineering,KCET,2023,56008,66906,14817,26805,164536,137731,No
AIT,Information Science and Engineering,COMEDK,2024,160946,65085,18736,24376,269143,244767,Yes
BMSIT,Data Science,COMEDK,2023,245329,82092,15208,17730,360359,342629,No
UVCE,Electronics and Communication Engineering,KCET,2023,76031,65273,9016,21222,171542,150320,Yes
CMRIT,Chemical Engineering,COMEDK,2024,166821,70048,17434,13933,268236,254303,Yes
KLEIT,Data Science,COMEDK,2023,214902,83670,15111,29854,343537,313683,Yes
JNNCE,Robotics and Automation Engineering,KCET,2024,65884,83352,11960,19214,180410,161196,No
REVA,Aerospace Engineering,KCET,2023,50435,72702,19935,16988,160060,143072,No
CMRIT,Computer Science and Engineering,COMEDK,2023,187191,87829,13376,19584,307980,288396,No
GMIT,Biotechnology,COMEDK,2023,223152,68005,17794,16397,325348,308951,Yes
KLSGIT,Data Science,COMEDK,2024,179289,64416,14437,10104,268246,258142,No
VVCE,Biotechnology,COMEDK,2023,190394,60552,18344,11206,280496,269290,Yes
KSIT,Electronics and Communication Engineering,KCET,2023,60613,72528,19723,11192,164056,152864,No
VIT,Computer Science and Engineering,KCET,2024,74778,84671,18484,29192,207125,177933,No
RAIT,Artificial Intelligence and Data Science,KCET,2023,62193,91648,18438,16880,189159,172279,Yes
BIT,Chemical Engineering,COMEDK,2023,240076,86662,8593,14655,349986,335331,No
AIT,Information Science and Engineering,COMEDK,2024,236761,85815,10549,14580,347705,333125,Yes
KLSGIT,Electronics and Communication Engineering,KCET,2024,81847,92366,17666,19518,211397,191879,No
MVJCE,Aerospace Engineering,COMEDK,2023,238218,88316,13014,12296,351844,339548,No
RVUNIV,Data Science,KCET,2023,50558,71715,10412,27049,159734,132685,Yes
SDMIT,Civil Engineering,COMEDK,2023,209439,62595,11795,18493,302322,283829,Yes
VVIT,Aerospace Engineering,COMEDK,2023,217008,61868,13958,12569,305403,292834,Yes
DSCE,Data Science,KCET,2024,55559,70802,11957,27317,165635,138318,No
VIT,Aerospace Engineering,KCET,2024,79308,91936,11456,27734,210434,182700,No
JIT,Civil Engineering,COMEDK,2023,231389,91689,14300,29098,366476,337378,No
BMSCE,Data Science,COMEDK,2024,204874,90698,12428,21691,329691,308000,Yes
SDMIT,Electronics and Communication Engineering,KCET,2024,78860,79163,17789,23106,198918,175812,No
JIT,Mechanical Engineering,KCET,2024,64746,81567,18284,11336,175933,164597,Yes
REVA,Electrical and Electronics Engineering,COMEDK,2023,171584,83011,8929,26617,290141,263524,No
BMIT,Chemical Engineering,COMEDK,2023,179871,63823,18450,18872,281016,262144,Yes
JNNCE,Artificial Intelligence and Data Science,KCET,2024,83087,82703,11245,27775,204810,177035,Yes
SDMCET,Mechanical Engineering,COMEDK,2024,239077,84128,12946,18545,354696,336151,No
KLSGIT,Mechanical Engineering,COMEDK,2024,246590,94807,8285,26503,376185,349682,Yes
UVCE,Data Science,COMEDK,2024,175968,77551,18215,17414,289148,271734,Yes
AECMandya,Chemical Engineering,COMEDK,2023,166896,70956,12010,16635,266497,249862,Yes
BNMIT,Computer Science and Engineering,COMEDK,2024,249961,94310,15148,10373,369792,359419,No
SITM,Biotechnology,KCET,2024,59334,85865,17235,16375,178809,162434,Yes
KLSGIT,Computer Science and Engineering,KCET,2023,54320,93007,18420,13247,178994,165747,Yes
BMIT,Artificial Intelligence and Data Science,KCET,2024,77586,67489,17332,25057,187464,162407,Yes
CMRIT,Chemical Engineering,KCET,2023,78969,87778,18205,12488,197440,184952,Yes
DSCE,Data Science,COMEDK,2023,206088,71479,9183,26220,312970,286750,Yes
SIT,Information Science and Engineering,COMEDK,2023,175546,73869,14879,15988,280282,264294,No
SJBCE,Information Science and Engineering,COMEDK,2024,175424,73521,8402,22461,279808,257347,Yes
CITGubbi,Robotics and Automation Engineering,KCET,2023,70074,88896,10257,25913,195140,169227,No
PRES,Computer Science and Engineering,KCET,2024,64765,83010,19952,26119,193846,167727,Yes
RVCE,Chemical Engineering,COMEDK,2023,227105,75084,9708,10651,322548,311897,Yes
RNSIT,Computer Science and Engineering,KCET,2024,83582,79576,9600,10530,183288,172758,No
KLSGIT,Chemical Engineering,KCET,2024,74730,84441,9211,21242,189624,168382,No
BMSIT,Civil Engineering,KCET,2023,55178,68747,10190,25612,159727,134115,Yes
DrAIT,Information Science and Engineering,KCET,2023,51505,91798,11629,10668,165600,154932,No
GMIT,Mechanical Engineering,KCET,2024,51286,90448,18042,28839,188615,159776,No
BMIT,Civil Engineering,COMEDK,2023,234962,92592,17401,19042,363997,344955,No
GMIT,Civil Engineering,COMEDK,2023,226928,80844,8613,21493,337878,316385,No
KSIT,Mechanical Engineering,KCET,2023,53834,91319,19900,18385,183438,165053,Yes
RAIT,Robotics and Automation Engineering,COMEDK,2023,186490,78630,17648,16966,299734,282768,No
CMRIT,Robotics and Automation Engineering,COMEDK,2024,226885,74555,17735,13813,332988,319175,Yes
PRES,Mechanical Engineering,KCET,2024,57731,89319,10682,21414,179146,157732,Yes
RIT,Chemical Engineering,COMEDK,2023,218432,66087,18528,27979,331026,303047,No
RVUNIV,Electrical and Electronics Engineering,KCET,2024,75938,67950,16869,25261,186018,160757,Yes
SJBIT,Information Science and Engineering,KCET,2024,74178,73459,16110,17855,181602,163747,No
UVCE,Civil Engineering,COMEDK,2024,198228,65323,17697,12522,293770,281248,No
JIT,Civil Engineering,KCET,2023,61034,65887,18092,10861,155874,145013,No
VIT,Mechanical Engineering,KCET,2024,60948,87173,14401,12336,174858,162522,No
VVIT,Chemical Engineering,KCET,2023,51288,81275,19613,10650,162826,152176,Yes
SDMCET,Artificial Intelligence and Data Science,KCET,2024,65084,86992,12878,16200,181154,164954,No
JIT,Electronics and Communication Engineering,KCET,2024,65089,78359,9907,13358,166713,153355,No
NIE,Artificial Intelligence and Data Science,KCET,2023,82311,90878,9938,16668,199795,183127,Yes
SDMCET,Civil Engineering,KCET,2023,73956,85986,19772,19246,198960,179714,Yes
RAIT,Mechanical Engineering,KCET,2024,61960,76565,8422,17577,164524,146947,Yes
NIE,Chemical Engineering,KCET,2024,82496,87547,12961,23720,206724,183004,No
EastPoint,Mechanical Engineering,COMEDK,2023,238626,86207,11017,22309,358159,335850,Yes
EastPoint,Electrical and Electronics Engineering,COMEDK,2023,230012,61266,15628,11667,318573,306906,No
BITM,Information Science and Engineering,COMEDK,2024,198468,86627,8529,11611,305235,293624,Yes
DSATM,Artificial Intelligence and Data Science,KCET,2023,79479,90824,10032,12037,192372,180335,Yes
HKBK,Mechanical Engineering,KCET,2023,72020,79175,18049,15858,185102,169244,No
YKCE,Artificial Intelligence and Data Science,COMEDK,2023,245567,62187,10355,12942,331051,318109,No
RVUNIV,Data Science,KCET,2023,67399,78904,10096,21038,177437,156399,Yes
AEC,Electrical and Electronics Engineering,COMEDK,2024,163337,85599,11847,29332,290115,260783,No
ACU,Civil Engineering,KCET,2023,66047,85071,13010,24246,188374,164128,No
GMIT,Biotechnology,COMEDK,2023,192238,83819,16064,12035,304156,292121,No
SITM,Data Science,COMEDK,2023,220191,76264,17932,14696,329083,314387,No
KLSGIT,Electronics and Communication Engineering,KCET,2023,54152,91392,16607,27449,189600,162151,Yes
JNNCE,Aerospace Engineering,COMEDK,2023,233125,65249,18828,15564,332766,317202,Yes
JNNCE,Chemical Engineering,COMEDK,2023,160135,80744,9943,25341,276163,250822,Yes
DBIT,Mechanical Engineering,KCET,2023,74944,63873,17568,12542,168927,156385,Yes
MSRUAS,Chemical Engineering,KCET,2023,53785,66050,13717,12502,146054,133552,Yes
JSSSTU,Mechanical Engineering,COMEDK,2023,213227,90401,19745,20517,343890,323373,Yes
BMIT,Information Science and Engineering,COMEDK,2024,222608,62097,10523,19035,314263,295228,Yes
SJBCE,Computer Science and Engineering,KCET,2024,81179,80783,15890,19767,197619,177852,Yes
YKCE,Biotechnology,KCET,2023,61519,81015,9882,18713,171129,152416,Yes
KSIT,Chemical Engineering,KCET,2024,54078,73081,8252,21840,157251,135411,Yes
KSIT,Electrical and Electronics Engineering,KCET,2024,69207,75242,13364,16465,174278,157813,No
VVCE,Artificial Intelligence and Data Science,COMEDK,2024,219786,84035,14757,27835,346413,318578,No
VemanaIT,Civil Engineering,COMEDK,2023,161678,63551,14474,11725,251428,239703,Yes
JNNCE,Robotics and Automation Engineering,COMEDK,2024,187620,84584,10719,26964,309887,282923,Yes
KSIT,Aerospace Engineering,COMEDK,2023,203342,86609,13046,16553,319550,302997,No
PESCE,Aerospace Engineering,COMEDK,2023,248722,91365,18863,14643,373593,358950,Yes
HKBK,Aerospace Engineering,KCET,2023,69521,87438,12381,26691,196031,169340,Yes
NCET,Biotechnology,KCET,2024,82094,87731,17313,29399,216537,187138,Yes
RVCE,Computer Science and Engineering,KCET,2023,51653,75103,19050,18883,164689,145806,Yes
BMSCE,Data Science,COMEDK,2024,225413,63293,15903,13909,318518,304609,No
PESCE,Electrical and Electronics Engineering,COMEDK,2024,239932,83216,9213,13138,345499,332361,Yes
REVA,Mechanical Engineering,KCET,2023,65410,94144,16208,24342,200104,175762,Yes
RAIT,Chemical Engineering,COMEDK,2023,240888,77058,17254,14595,349795,335200,No
DrAIT,Artificial Intelligence and Data Science,KCET,2023,54788,84506,11041,17090,167425,150335,Yes
VVCE,Artificial Intelligence and Data Science,COMEDK,2024,233478,85712,11546,14686,345422,330736,No
NMIT,Aerospace Engineering,KCET,2023,70440,60671,10570,29057,170738,141681,Yes
VSM,Data Science,COMEDK,2023,174146,76476,14283,26348,291253,264905,No
NCET,Data Science,KCET,2023,72076,83963,19170,17436,192645,175209,No
CMRIT,Robotics and Automation Engineering,KCET,2024,58550,93500,12006,24393,188449,164056,Yes
MVJCE,Biotechnology,COMEDK,2024,191956,85915,15520,25280,318671,293391,Yes
ACU,Mechanical Engineering,KCET,2024,70807,67122,11188,17929,167046,149117,Yes
MSRUAS,Biotechnology,COMEDK,2023,163051,66823,14319,26001,270194,244193,Yes
JNNCE,Electrical and Electronics Engineering,KCET,2023,69587,74793,14785,12629,171794,159165,Yes
MSRUAS,Biotechnology,COMEDK,2023,184680,67983,18778,14604,286045,271441,Yes
BNMIT,Mechanical Engineering,KCET,2023,78872,74587,19439,11558,184456,172898,Yes
HKBK,Aerospace Engineering,KCET,2024,81940,78724,10400,12045,183109,171064,No
GMIT,Aerospace Engineering,KCET,2023,66054,88682,15244,22937,192917,169980,Yes
PESU,Mechanical Engineering,COMEDK,2023,213570,86041,16290,19590,335491,315901,Yes
CITGubbi,Artificial Intelligence and Data Science,KCET,2023,50118,81918,14617,15783,162436,146653,Yes
PRES,Electrical and Electronics Engineering,COMEDK,2023,245927,64476,15612,24002,350017,326015,Yes
DSCE,Artificial Intelligence and Data Science,COMEDK,2023,214707,94719,18310,29477,357213,327736,Yes
RVUNIV,Aerospace Engineering,COMEDK,2023,183072,88687,17613,23941,313313,289372,No
BMSIT,Information Science and Engineering,COMEDK,2024,217695,83417,8722,14008,323842,309834,No
SDMCET,Information Science and Engineering,KCET,2024,51363,66699,9155,25583,152800,127217,Yes
KLEIT,Data Science,COMEDK,2024,208853,71093,10590,29486,320022,290536,Yes
KLSGIT,Data Science,KCET,2023,68065,73289,10281,12720,164355,151635,No
AIT,Computer Science and Engineering,KCET,2023,69342,92598,17334,18094,197368,179274,Yes
GMIT,Electronics and Communication Engineering,KCET,2023,54229,84709,13065,11523,163526,152003,No
SJBCE,Chemical Engineering,COMEDK,2023,197922,73694,10218,13269,295103,281834,Yes
SJBIT,Computer Science and Engineering,COMEDK,2024,170708,62286,8565,17592,259151,241559,Yes
BMIT,Data Science,KCET,2024,62819,92759,18066,16758,190402,173644,Yes
CMRIT,Electrical and Electronics Engineering,COMEDK,2024,208116,93252,13901,27012,342281,315269,No
MSRIT,Aerospace Engineering,KCET,2023,58970,61681,8240,10301,139192,128891,Yes
VIT,Electrical and Electronics Engineering,COMEDK,2023,238207,61278,17396,22853,339734,316881,No
JNNCE,Chemical Engineering,KCET,2024,77833,76506,19344,21383,195066,173683,No
AITM,Electrical and Electronics Engineering,KCET,2023,74965,77601,14588,23436,190590,167154,No
SITM,Information Science and Engineering,COMEDK,2023,203778,84214,18869,20822,327683,306861,No
NIE,Electronics and Communication Engineering,KCET,2024,61576,79384,12257,12666,165883,153217,Yes
PRES,Electrical and Electronics Engineering,KCET,2023,75415,88504,17414,25488,206821,181333,Yes
VVIT,Artificial Intelligence and Data Science,COMEDK,2023,221830,78451,19587,24913,344781,319868,Yes
HKBK,Mechanical Engineering,COMEDK,2024,164313,86171,12767,26637,289888,263251,No
RNSIT,Electrical and Electronics Engineering,COMEDK,2023,199751,65931,12948,16324,294954,278630,Yes
CMRIT,Chemical Engineering,COMEDK,2023,237681,67548,17150,25203,347582,322379,No
VVCE,Aerospace Engineering,KCET,2023,84798,78666,15573,13303,192340,179037,No
BITM,Robotics and Automation Engineering,COMEDK,2023,211296,77007,15359,14482,318144,303662,No
SIT,Computer Science and Engineering,KCET,2024,73001,71818,8496,23927,177242,153315,No
PESU,Biotechnology,KCET,2023,63584,61850,19479,27414,172327,144913,Yes
MVJCE,Computer Science and Engineering,COMEDK,2024,161789,77608,17232,18780,275409,256629,Yes
VIT,Civil Engineering,COMEDK,2023,216887,66310,9847,23210,316254,293044,No
BIT,Civil Engineering,COMEDK,2023,233533,66981,15521,21882,337917,316035,No
SDMIT,Computer Science and Engineering,KCET,2023,71794,82747,19815,13193,187549,174356,No
PRES,Civil Engineering,COMEDK,2023,217886,92988,14411,19445,344730,325285,Yes
JSSSTU,Mechanical Engineering,COMEDK,2024,212390,71845,12643,28027,324905,296878,No
RIT,Civil Engineering,KCET,2023,75955,76200,15743,27499,195397,167898,Yes
MSRIT,Chemical Engineering,COMEDK,2023,225785,90567,17368,16735,350455,333720,No
NHCE,Civil Engineering,COMEDK,2024,193841,77842,15423,11758,298864,287106,Yes
BMSIT,Artificial Intelligence and Data Science,COMEDK,2023,187119,82589,14105,20450,304263,283813,Yes
JSSSTU,Electronics and Communication Engineering,COMEDK,2024,168034,89865,14237,11169,283305,272136,Yes
HKBK,Robotics and Automation Engineering,KCET,2024,63380,85890,15974,10860,176104,165244,No
EastPoint,Robotics and Automation Engineering,KCET,2024,53045,71711,13143,18086,155985,137899,No
RNSIT,Chemical Engineering,KCET,2024,62511,81316,10780,12204,166811,154607,Yes
PRES,Chemical Engineering,COMEDK,2024,163681,87512,18740,18767,288700,269933,No
RVUNIV,Electronics and Communication Engineering,KCET,2024,78342,78364,19774,21940,198420,176480,Yes
KLEIT,Robotics and Automation Engineering,KCET,2023,74083,85434,11564,23133,194214,171081,Yes
JIT,Robotics and Automation Engineering,COMEDK,2023,190250,67509,14461,28600,300820,272220,Yes
NIE,Data Science,KCET,2023,77730,70045,10494,19895,178164,158269,Yes
YKCE,Artificial Intelligence and Data Science,KCET,2024,75435,81823,14951,18818,191027,172209,No
KLEIT,Civil Engineering,COMEDK,2023,186843,68898,19886,12476,288103,275627,Yes
REVA,Chemical Engineering,KCET,2024,83842,74155,15569,22024,195590,173566,No
AIT,Mechanical Engineering,COMEDK,2023,170589,66688,14965,28616,280858,252242,Yes
HKBK,Civil Engineering,KCET,2023,71315,63138,14527,24165,173145,148980,Yes
MSRUAS,Aerospace Engineering,COMEDK,2024,228761,92462,18751,19945,359919,339974,Yes
DBIT,Aerospace Engineering,KCET,2024,64687,65371,14559,10185,154802,144617,No
GMIT,Electrical and Electronics Engineering,KCET,2023,75377,76839,18815,21683,192714,171031,No
MVJCE,Computer Science and Engineering,COMEDK,2024,235616,76357,10835,22980,345788,322808,No
BMSIT,Artificial Intelligence and Data Science,KCET,2024,63201,74625,13123,10006,160955,150949,No
NHCE,Information Science and Engineering,KCET,2024,71566,72969,8116,13421,166072,152651,No
SDMIT,Civil Engineering,COMEDK,2023,223027,61597,19888,17226,321738,304512,No
RVUNIV,Electronics and Communication Engineering,KCET,2023,65983,78197,13607,18470,176257,157787,Yes
EastPoint,Biotechnology,COMEDK,2023,210930,82361,13684,13504,320479,306975,Yes
MSRIT,Biotechnology,COMEDK,2023,191951,83747,11262,19496,306456,286960,No
BIT,Aerospace Engineering,KCET,2023,66792,81344,8414,27926,184476,156550,Yes
PRES,Electrical and Electronics Engineering,KCET,2024,51927,77950,14976,14366,159219,144853,Yes
DSATM,Robotics and Automation Engineering,KCET,2023,83571,72082,19764,26563,201980,175417,No
PESU,Biotechnology,COMEDK,2024,226513,94153,18717,13700,353083,339383,No
AEC,Computer Science and Engineering,COMEDK,2023,247001,83545,11368,28070,369984,341914,No
YKCE,Biotechnology,KCET,2023,57014,68162,12829,21489,159494,138005,Yes
DSCE,Information Science and Engineering,COMEDK,2024,225594,91350,19778,23108,359830,336722,No
PESU,Biotechnology,KCET,2023,76588,78586,17422,18782,191378,172596,Yes
BITM,Electronics and Communication Engineering,KCET,2023,62413,90758,18233,17641,189045,171404,No
JNNCE,Aerospace Engineering,KCET,2024,71457,67100,13476,26156,178189,152033,No
PESU,Electrical and Electronics Engineering,KCET,2024,77689,79454,8786,27315,193244,165929,No
VVCE,Data Science,COMEDK,2024,202397,84882,9002,10145,306426,296281,Yes
NIE,Information Science and Engineering,COMEDK,2023,162093,87505,17615,27892,295105,267213,Yes
YKCE,Civil Engineering,COMEDK,2023,176121,91876,10801,13731,292529,278798,No
BMSIT,Aerospace Engineering,KCET,2024,80785,76056,12743,27036,196620,169584,Yes
JSSSTU,Electronics and Communication Engineering,KCET,2023,83522,67070,12870,25748,189210,163462,No
EastPoint,Mechanical Engineering,COMEDK,2024,240758,69896,14894,16688,342236,325548,No
AECMandya,Aerospace Engineering,COMEDK,2023,210774,81544,14630,23243,330191,306948,Yes
AEC,Aerospace Engineering,COMEDK,2023,225386,67452,19775,12771,325384,312613,Yes
SJBIT,Information Science and Engineering,KCET,2023,65450,90189,13284,28883,197806,168923,No
SCEM,Data Science,KCET,2023,83623,78123,10800,13825,186371,172546,Yes
DSATM,Mechanical Engineering,COMEDK,2023,190288,66234,9395,27590,293507,265917,Yes
JIT,Mechanical Engineering,COMEDK,2023,171822,67829,19688,10054,269393,259339,Yes
JNNCE,Artificial Intelligence and Data Science,COMEDK,2024,182099,94336,9685,13543,299663,286120,Yes
AECMandya,Mechanical Engineering,COMEDK,2023,189707,80116,18370,20167,308360,288193,No
MSRIT,Biotechnology,KCET,2023,63699,83207,18464,25521,190891,165370,Yes
NCET,Biotechnology,COMEDK,2024,199292,65790,8672,29161,302915,273754,Yes
JSSSTU,Electronics and Communication Engineering,KCET,2024,61108,64177,8117,14383,147785,133402,No
REVA,Aerospace Engineering,COMEDK,2023,242751,72275,12987,18392,346405,328013,Yes
JNNCE,Aerospace Engineering,COMEDK,2024,194257,85024,13080,27892,320253,292361,Yes
VSM,Artificial Intelligence and Data Science,COMEDK,2023,177666,77119,19051,25040,298876,273836,No
CITGubbi,Biotechnology,KCET,2023,62106,65711,13852,17678,159347,141669,No
GMIT,Chemical Engineering,COMEDK,2024,231213,65993,13276,23235,333717,310482,Yes
SITM,Computer Science and Engineering,COMEDK,2023,200387,84768,15125,13304,313584,300280,Yes
BMIT,Biotechnology,KCET,2023,75045,80791,15338,13872,185046,171174,No
BIT,Mechanical Engineering,KCET,2023,78157,81976,15823,21171,197127,175956,Yes
VSM,Electronics and Communication Engineering,COMEDK,2024,233922,88079,14971,13111,350083,336972,Yes
NCET,Civil Engineering,COMEDK,2023,164212,84427,14894,26758,290291,263533,No
GIT,Computer Science and Engineering,KCET,2024,70133,63868,18265,22134,174400,152266,No
VIT,Civil Engineering,COMEDK,2023,213636,93849,14756,27172,349413,322241,Yes
CMRIT,Mechanical Engineering,KCET,2024,77927,61876,14721,19272,173796,154524,No
JIT,Civil Engineering,COMEDK,2024,209708,63448,14730,28393,316279,287886,Yes
RIT,Civil Engineering,KCET,2024,84373,66033,16933,22038,189377,167339,No
MSRUAS,Electrical and Electronics Engineering,KCET,2024,81211,78078,9401,23383,192073,168690,No
MSRUAS,Robotics and Automation Engineering,KCET,2023,64683,61371,18854,14302,159210,144908,Yes
EastPoint,Electronics and Communication Engineering,COMEDK,2023,239181,60267,9067,25391,333906,308515,Yes
AEC,Computer Science and Engineering,KCET,2024,65423,64622,12104,25044,167193,142149,Yes
UVCE,Artificial Intelligence and Data Science,KCET,2024,75843,64441,15364,23844,179492,155648,No
BIT,Aerospace Engineering,KCET,2024,57322,84814,16351,27160,185647,158487,No
NHCE,Biotechnology,COMEDK,2023,227377,60501,16852,11370,316100,304730,Yes
SITM,Information Science and Engineering,KCET,2023,61928,74488,11845,27080,175341,148261,Yes
BITM,Electronics and Communication Engineering,KCET,2024,50072,74879,10909,15274,151134,135860,Yes
RVUNIV,Aerospace Engineering,KCET,2023,62596,89983,9168,11903,173650,161747,Yes
RVUNIV,Electrical and Electronics Engineering,KCET,2024,67491,75666,12487,23188,178832,155644,No
PRES,Civil Engineering,KCET,2023,79148,83303,16505,26460,205416,178956,Yes
VSM,Aerospace Engineering,COMEDK,2023,197934,85140,13401,12346,308821,296475,No
KSIT,Mechanical Engineering,KCET,2024,51046,75223,17479,11221,154969,143748,No
SJBIT,Computer Science and Engineering,KCET,2024,76030,93160,18742,24718,212650,187932,Yes
NHCE,Robotics and Automation Engineering,KCET,2024,53500,90865,10379,17528,172272,154744,No
NIE,Civil Engineering,KCET,2024,53893,64861,11694,13177,143625,130448,Yes
UVCE,Robotics and Automation Engineering,COMEDK,2024,229228,66210,13260,13171,321869,308698,No
PESU,Biotechnology,COMEDK,2023,189644,60682,14561,24529,289416,264887,Yes
CITGubbi,Mechanical Engineering,KCET,2024,75098,80145,15460,17490,188193,170703,No
JSSSTU,Data Science,COMEDK,2023,195360,86699,19767,23490,325316,301826,No
UVCE,Computer Science and Engineering,COMEDK,2024,239959,89070,11676,15950,356655,340705,No
NMIT,Artificial Intelligence and Data Science,COMEDK,2024,174273,62249,11293,20080,267895,247815,No
NIE,Data Science,COMEDK,2023,234360,73694,19172,11377,338603,327226,Yes
NCET,Electronics and Communication Engineering,COMEDK,2024,237934,63889,16972,28892,347687,318795,No
EastPoint,Information Science and Engineering,COMEDK,2024,196036,71180,18161,16924,302301,285377,Yes
AECMandya,Aerospace Engineering,KCET,2024,76665,88153,9966,23178,197962,174784,No
NCET,Electronics and Communication Engineering,COMEDK,2023,184264,63818,8181,15120,271383,256263,No
VVIT,Civil Engineering,KCET,2023,64268,61296,19343,10141,155048,144907,Yes
NIE,Chemical Engineering,KCET,2024,72813,73251,12201,28828,187093,158265,No
DrAIT,Biotechnology,COMEDK,2023,234829,70129,13849,19526,338333,318807,Yes
AITM,Mechanical Engineering,KCET,2023,59979,60576,11774,28117,160446,132329,Yes
SDMIT,Artificial Intelligence and Data Science,COMEDK,2023,208394,61154,18853,24528,312929,288401,Yes
UVCE,Artificial Intelligence and Data Science,COMEDK,2023,197881,93352,13050,10757,315040,304283,Yes
YKCE,Civil Engineering,COMEDK,2023,183543,87362,13836,12386,297127,284741,No
DBIT,Computer Science and Engineering,COMEDK,2024,249552,90183,18614,23210,381559,358349,Yes
GIT,Computer Science and Engineering,KCET,2024,81711,81259,16164,21919,201053,179134,Yes
AEC,Electronics and Communication Engineering,COMEDK,2023,239069,82133,14770,23707,359679,335972,Yes
NHCE,Computer Science and Engineering,COMEDK,2023,213430,87158,9007,23939,333534,309595,No
SJBCE,Artificial Intelligence and Data Science,COMEDK,2024,207915,92178,19655,16708,336456,319748,No
DBIT,Biotechnology,KCET,2023,65404,62645,18873,12135,159057,146922,Yes
VSM,Robotics and Automation Engineering,KCET,2024,70494,73576,15222,29322,188614,159292,No
GIT,Civil Engineering,COMEDK,2024,192763,81971,17943,25389,318066,292677,No
GIT,Civil Engineering,COMEDK,2023,189904,65221,10407,24488,290020,265532,No
DBIT,Artificial Intelligence and Data Science,COMEDK,2023,248232,88751,13020,24782,374785,350003,No
PESCE,Aerospace Engineering,COMEDK,2024,220695,93414,9753,20906,344768,323862,Yes
SDMIT,Data Science,KCET,2023,60542,76915,11267,23270,171994,148724,Yes
DrAIT,Electronics and Communication Engineering,KCET,2024,83170,85345,16859,20385,205759,185374,No
DrAIT,Electrical and Electronics Engineering,COMEDK,2024,203069,80946,12876,20313,317204,296891,No
AECMandya,Artificial Intelligence and Data Science,COMEDK,2024,215416,75064,9333,24067,323880,299813,Yes
RNSIT,Chemical Engineering,COMEDK,2024,193047,82439,16509,21590,313585,291995,No
CMRIT,Civil Engineering,KCET,2024,59751,85668,9458,17599,172476,154877,Yes
VemanaIT,Computer Science and Engineering,KCET,2024,66511,65442,17876,19006,168835,149829,Yes
KSIT,Robotics and Automation Engineering,KCET,2023,62469,66328,11331,22853,162981,140128,No
AEC,Information Science and Engineering,COMEDK,2023,208993,69498,9871,29835,318197,288362,No
NHCE,Mechanical Engineering,COMEDK,2023,231011,62262,16155,24127,333555,309428,No
CMRIT,Aerospace Engineering,KCET,2023,81564,92716,17046,28063,219389,191326,Yes
DrAIT,Aerospace Engineering,COMEDK,2024,211063,94715,16706,18167,340651,322484,No
VVCE,Chemical Engineering,KCET,2024,69815,86618,9493,13412,179338,165926,No
RVCE,Information Science and Engineering,COMEDK,2023,191451,60600,11118,21037,284206,263169,No
JIT,Mechanical Engineering,KCET,2023,71705,79536,15370,17448,184059,166611,Yes
RAIT,Information Science and Engineering,COMEDK,2023,161992,84998,18999,16170,282159,265989,No
REVA,Robotics and Automation Engineering,KCET,2024,84187,69133,17097,24903,195320,170417,No
BMSCE,Electrical and Electronics Engineering,KCET,2024,73962,90400,19722,21107,205191,184084,No
BITM,Information Science and Engineering,COMEDK,2023,208209,61765,17885,26520,314379,287859,No
HKBK,Computer Science and Engineering,COMEDK,2024,179823,91109,9849,11531,292312,280781,Yes
KLEIT,Robotics and Automation Engineering,COMEDK,2023,203186,70485,14849,26979,315499,288520,No
GMIT,Aerospace Engineering,KCET,2023,60851,93127,14929,17394,186301,168907,No
SDMCET,Electrical and Electronics Engineering,COMEDK,2023,233547,68596,17874,12017,332034,320017,No
NIE,Aerospace Engineering,COMEDK,2023,212919,92131,17615,19321,341986,322665,Yes
ACU,Artificial Intelligence and Data Science,KCET,2024,80423,83182,12257,29850,205712,175862,Yes
MSRUAS,Civil Engineering,KCET,2023,84498,67595,13201,24739,190033,165294,Yes
RAIT,Information Science and Engineering,KCET,2024,80470,70640,18742,18502,188354,169852,No
SDMIT,Computer Science and Engineering,COMEDK,2023,188584,71238,11700,10100,281622,271522,No
DBIT,Computer Science and Engineering,KCET,2024,71132,87488,11092,10655,180367,169712,Yes
VVCE,Robotics and Automation Engineering,COMEDK,2024,177397,62930,15127,16827,272281,255454,Yes
KLSGIT,Computer Science and Engineering,KCET,2024,79357,75256,16688,29885,201186,171301,No
DSATM,Mechanical Engineering,COMEDK,2024,182259,91684,13654,23285,310882,287597,Yes
GIT,Chemical Engineering,COMEDK,2023,235466,74840,8131,18146,336583,318437,No
EastPoint,Mechanical Engineering,COMEDK,2023,192775,93584,18365,23419,328143,304724,No
JSSSTU,Artificial Intelligence and Data Science,KCET,2023,63489,94417,16633,15247,189786,174539,Yes
NCET,Robotics and Automation Engineering,COMEDK,2023,176453,67535,11632,14443,270063,255620,Yes
RNSIT,Robotics and Automation Engineering,KCET,2023,55376,70791,16763,19208,162138,142930,No
SIT,Mechanical Engineering,KCET,2024,78200,68235,9996,23718,180149,156431,Yes
SIT,Data Science,KCET,2024,68787,79212,10372,28327,186698,158371,No
AECMandya,Computer Science and Engineering,COMEDK,2023,236629,72246,12299,19900,341074,321174,No
JSSSTU,Artificial Intelligence and Data Science,KCET,2024,65811,80065,8039,29626,183541,153915,No
RIT,Aerospace Engineering,KCET,2023,61381,81950,10391,26859,180581,153722,No
AIT,Chemical Engineering,COMEDK,2024,202839,71935,17285,12169,304228,292059,Yes
GMIT,Electronics and Communication Engineering,COMEDK,2023,161961,74390,17001,22458,275810,253352,No
RIT,Biotechnology,COMEDK,2024,165382,72117,14339,13838,265676,251838,Yes
SITM,Mechanical Engineering,COMEDK,2023,228629,74211,11800,10290,324930,314640,No
JIT,Electronics and Communication Engineering,KCET,2023,76222,71731,19026,18514,185493,166979,Yes
BNMIT,Robotics and Automation Engineering,COMEDK,2023,217048,72828,19593,13021,322490,309469,No
UVCE,Electronics and Communication Engineering,KCET,2024,71023,77785,10551,26693,186052,159359,No
DBIT,Civil Engineering,COMEDK,2024,219092,88390,14465,24561,346508,321947,No
AECMandya,Chemical Engineering,COMEDK,2023,244476,84991,9734,12204,351405,339201,No
RVCE,Data Science,KCET,2023,53631,63595,14876,17072,149174,132102,Yes
SCEM,Artificial Intelligence and Data Science,COMEDK,2023,220333,94259,16015,19959,350566,330607,Yes
NHCE,Aerospace Engineering,COMEDK,2024,243143,64220,14520,14875,336758,321883,Yes
BNMIT,Biotechnology,KCET,2024,51103,70373,14381,11748,147605,135857,No
JNNCE,Mechanical Engineering,KCET,2023,72098,89009,12694,24817,198618,173801,No
RNSIT,Electrical and Electronics Engineering,KCET,2024,62402,75755,8405,25767,172329,146562,Yes
BMSCE,Biotechnology,KCET,2023,59824,65045,10825,21755,157449,135694,No
RVCE,Information Science and Engineering,COMEDK,2024,224925,71959,18235,23444,338563,315119,Yes
SITM,Biotechnology,KCET,2024,75999,89271,11075,24597,200942,176345,Yes
AIT,Electronics and Communication Engineering,COMEDK,2024,174959,67296,18345,20412,281012,260600,No
DrAIT,Computer Science and Engineering,KCET,2023,64266,62592,11143,24223,162224,138001,Yes
VVIT,Electronics and Communication Engineering,KCET,2024,61007,60258,17411,28969,167645,138676,No
CITGubbi,Electrical and Electronics Engineering,COMEDK,2023,234084,87797,13001,18585,353467,334882,No
VemanaIT,Artificial Intelligence and Data Science,KCET,2023,57163,84835,15253,29911,187162,157251,No
JSSSTU,Civil Engineering,KCET,2023,53515,77511,18343,26336,175705,149369,No
AECMandya,Civil Engineering,KCET,2024,79933,92950,9725,20575,203183,182608,Yes
NIE,Mechanical Engineering,KCET,2023,51708,92068,15539,13820,173135,159315,Yes
PESCE,Information Science and Engineering,COMEDK,2024,171366,71361,10767,24240,277734,253494,Yes
BIT,Chemical Engineering,KCET,2024,76696,80467,17573,10612,185348,174736,No
KLEIT,Mechanical Engineering,COMEDK,2024,174808,90797,10262,18383,294250,275867,Yes
SDMIT,Electrical and Electronics Engineering,KCET,2023,66769,84581,9246,15929,176525,160596,Yes
SIT,Data Science,COMEDK,2023,177560,79146,13928,25848,296482,270634,No
MSRUAS,Aerospace Engineering,KCET,2023,56372,68729,13624,12109,150834,138725,No
AITM,Civil Engineering,KCET,2023,71429,89316,8861,24908,194514,169606,Yes
REVA,Computer Science and Engineering,KCET,2024,80547,90348,9330,23798,204023,180225,No
DrAIT,Robotics and Automation Engineering,COMEDK,2024,165426,72994,10834,21885,271139,249254,Yes
KLSGIT,Chemical Engineering,COMEDK,2023,203438,83867,18904,24791,331000,306209,Yes
JSSSTU,Computer Science and Engineering,KCET,2023,58388,86624,19941,22407,187360,164953,Yes
KLEIT,Artificial Intelligence and Data Science,KCET,2024,56759,88110,17126,20232,182227,161995,Yes
BNMIT,Data Science,COMEDK,2023,177555,82238,13407,24593,297793,273200,Yes
SJBCE,Mechanical Engineering,COMEDK,2024,171765,84931,9806,25450,291952,266502,Yes
RNSIT,Computer Science and Engineering,KCET,2024,71598,79196,14940,12509,178243,165734,No
BMIT,Robotics and Automation Engineering,KCET,2023,54046,65669,12978,11485,144178,132693,Yes
CITGubbi,Artificial Intelligence and Data Science,KCET,2023,74693,60771,15572,24182,175218,151036,No
BMSCE,Artificial Intelligence and Data Science,COMEDK,2024,189161,78968,12562,10367,291058,280691,Yes
ACU,Data Science,COMEDK,2024,227913,92824,9376,25285,355398,330113,No
BITM,Artificial Intelligence and Data Science,KCET,2024,63032,83326,9646,25854,181858,156004,Yes
VVIT,Information Science and Engineering,KCET,2023,69131,65672,10538,16247,161588,145341,Yes
DSCE,Electronics and Communication Engineering,KCET,2024,61394,68922,18635,21248,170199,148951,Yes
GMIT,Chemical Engineering,KCET,2023,84421,92949,13830,16326,207526,191200,Yes
RVCE,Aerospace Engineering,COMEDK,2024,205990,73643,15188,24175,318996,294821,No
BMIT,Data Science,COMEDK,2024,222542,71136,14268,13942,321888,307946,No
JSSSTU,Civil Engineering,COMEDK,2024,189506,61530,16515,11835,279386,267551,No
DSATM,Electrical and Electronics Engineering,COMEDK,2023,177337,89241,9824,11896,288298,276402,No
PESU,Aerospace Engineering,COMEDK,2023,188982,84812,16752,16397,306943,290546,No
YKCE,Civil Engineering,KCET,2023,76457,69160,9524,15767,170908,155141,Yes
PRES,Civil Engineering,KCET,2024,68654,86706,15528,12490,183378,170888,No
PESCE,Artificial Intelligence and Data Science,COMEDK,2024,242574,91041,16422,29809,379846,350037,Yes
UVCE,Artificial Intelligence and Data Science,COMEDK,2023,201116,86618,16362,12655,316751,304096,No
PESCE,Chemical Engineering,KCET,2023,59286,91109,9783,17576,177754,160178,No
BMIT,Computer Science and Engineering,COMEDK,2023,183140,82553,9712,26748,302153,275405,No
SITM,Chemical Engineering,KCET,2023,82278,69071,17426,24036,192811,168775,Yes
SDMCET,Electrical and Electronics Engineering,KCET,2023,65434,64152,13006,17570,160162,142592,No
EastPoint,Biotechnology,KCET,2024,65955,78709,9996,20119,174779,154660,Yes
SITM,Information Science and Engineering,KCET,2023,73660,88466,8007,18580,188713,170133,No
PESCE,Information Science and Engineering,KCET,2023,63549,65617,12155,22247,163568,141321,No
DBIT,Robotics and Automation Engineering,COMEDK,2024,161250,65731,19731,14608,261320,246712,Yes
VVIT,Robotics and Automation Engineering,KCET,2024,63630,84884,11145,14318,173977,159659,No
MSRIT,Biotechnology,COMEDK,2023,239669,68039,18679,15861,342248,326387,Yes
AIT,Artificial Intelligence and Data Science,KCET,2023,50761,70888,17470,15928,155047,139119,Yes
GIT,Biotechnology,KCET,2023,65192,88116,14953,20849,189110,168261,Yes
SITM,Data Science,KCET,2023,82814,78848,16486,22576,200724,178148,Yes
VemanaIT,Computer Science and Engineering,KCET,2023,72494,83691,15589,27416,199190,171774,No
VVIT,Data Science,COMEDK,2023,183649,75679,16979,24980,301287,276307,No
ACU,Artificial Intelligence and Data Science,COMEDK,2023,222349,74406,9803,10105,316663,306558,No
SJBIT,Electrical and Electronics Engineering,COMEDK,2023,242212,63050,15133,21509,341904,320395,Yes
JNNCE,Information Science and Engineering,KCET,2024,64717,90011,14523,25354,194605,169251,No
AECMandya,Civil Engineering,COMEDK,2024,178530,69127,8186,25588,281431,255843,No
JSSSTU,Information Science and Engineering,KCET,2024,60130,67631,11810,12088,151659,139571,No
DSCE,Electronics and Communication Engineering,COMEDK,2024,202398,84485,18713,12645,318241,305596,Yes
BNMIT,Information Science and Engineering,KCET,2024,77199,75712,18334,29226,200471,171245,No
JNNCE,Civil Engineering,COMEDK,2024,162208,72728,11249,23056,269241,246185,No
RVUNIV,Computer Science and Engineering,COMEDK,2024,217462,70944,14629,12256,315291,303035,Yes
SDMIT,Mechanical Engineering,COMEDK,2024,209957,85656,15549,20771,331933,311162,Yes
REVA,Information Science and Engineering,KCET,2024,80229,94018,11234,27973,213454,185481,No
VVIT,Civil Engineering,COMEDK,2023,202088,77398,8401,28789,316676,287887,No
DBIT,Data Science,KCET,2024,63423,88587,12874,20680,185564,164884,No
VVIT,Chemical Engineering,COMEDK,2023,174472,75842,13697,16223,280234,264011,No
AECMandya,Electrical and Electronics Engineering,KCET,2024,59934,67799,13744,21568,163045,141477,Yes
KSIT,Civil Engineering,COMEDK,2023,237212,82181,9911,14063,343367,329304,Yes
MSRUAS,Artificial Intelligence and Data Science,KCET,2023,61202,75772,16033,18535,171542,153007,No
SDMCET,Mechanical Engineering,COMEDK,2023,173133,79612,12030,13873,278648,264775,No
NHCE,Data Science,COMEDK,2024,209196,76950,9317,16661,312124,295463,No
VSM,Chemical Engineering,KCET,2024,84084,87299,16645,24935,212963,188028,No
JNNCE,Mechanical Engineering,COMEDK,2024,217082,86845,12466,29659,346052,316393,No
JNNCE,Electronics and Communication Engineering,KCET,2024,54504,84820,8300,29951,177575,147624,No
YKCE,Civil Engineering,KCET,2024,65998,90534,17150,27086,200768,173682,Yes
CMRIT,Civil Engineering,COMEDK,2023,193245,88851,9376,16428,307900,291472,No
UVCE,Aerospace Engineering,COMEDK,2023,191141,68159,19618,15484,294402,278918,No
AECMandya,Computer Science and Engineering,KCET,2024,65206,77212,14160,15942,172520,156578,No
BMIT,Electrical and Electronics Engineering,COMEDK,2023,226544,81612,10888,21069,340113,319044,Yes
JIT,Robotics and Automation Engineering,KCET,2023,78273,90490,18779,16621,204163,187542,No
SJBIT,Electronics and Communication Engineering,COMEDK,2024,202037,69310,17488,13113,301948,288835,No
KSIT,Information Science and Engineering,KCET,2024,71018,80793,13341,21606,186758,165152,No
BITM,Biotechnology,COMEDK,2023,162258,70953,10946,17517,261674,244157,Yes
NMIT,Mechanical Engineering,COMEDK,2023,199825,62818,14969,22064,299676,277612,Yes
AIT,Information Science and Engineering,KCET,2023,54467,80243,19141,26004,179855,153851,No
SJBIT,Computer Science and Engineering,COMEDK,2024,209720,90890,16622,14817,332049,317232,Yes
CMRIT,Robotics and Automation Engineering,COMEDK,2023,162500,91113,18883,21424,293920,272496,Yes
PESCE,Data Science,COMEDK,2024,201782,84876,11400,29079,327137,298058,No
DSCE,Aerospace Engineering,KCET,2024,77479,62407,15470,18133,173489,155356,No
BITM,Computer Science and Engineering,COMEDK,2023,219690,84620,19478,10650,334438,323788,Yes
VVIT,Biotechnology,COMEDK,2023,181225,63135,16460,24881,285701,260820,Yes
PRES,Mechanical Engineering,COMEDK,2024,170314,87929,15256,13464,286963,273499,Yes
MVJCE,Civil Engineering,COMEDK,2024,194719,77239,13761,25749,311468,285719,No
CITGubbi,Data Science,COMEDK,2023,178000,91149,12677,24335,306161,281826,No
VVIT,Mechanical Engineering,COMEDK,2023,200664,66103,17713,26155,310635,284480,Yes
UVCE,Electrical and Electronics Engineering,KCET,2023,73796,72392,10475,12935,169598,156663,Yes
RVUNIV,Artificial Intelligence and Data Science,KCET,2023,63694,94347,18734,23756,200531,176775,Yes
NIE,Computer Science and Engineering,KCET,2024,70610,84703,14510,16798,186621,169823,Yes
NMIT,Electronics and Communication Engineering,KCET,2024,74588,93619,8097,29507,205811,176304,No
VVIT,Computer Science and Engineering,KCET,2024,71921,85753,13899,16000,187573,171573,No
RAIT,Computer Science and Engineering,KCET,2024,61794,67555,8597,24667,162613,137946,No
EastPoint,Chemical Engineering,KCET,2023,65582,60206,12492,28252,166532,138280,No
SIT,Information Science and Engineering,COMEDK,2023,246846,85008,16736,13361,361951,348590,Yes
DSATM,Mechanical Engineering,KCET,2023,64520,86514,15811,25277,192122,166845,No
RNSIT,Robotics and Automation Engineering,COMEDK,2023,179554,84414,17058,15283,296309,281026,No
AIT,Information Science and Engineering,KCET,2024,76292,87764,16763,18075,198894,180819,No
KLEIT,Mechanical Engineering,KCET,2023,56754,74347,17443,25536,174080,148544,Yes
VVIT,Artificial Intelligence and Data Science,COMEDK,2023,215021,78856,17028,20175,331080,310905,No
VVCE,Electronics and Communication Engineering,COMEDK,2024,206524,68292,8364,27376,310556,283180,Yes
SDMCET,Mechanical Engineering,KCET,2023,60902,72484,16740,24677,174803,150126,No
AECMandya,Chemical Engineering,COMEDK,2024,217599,72957,16668,12440,319664,307224,Yes
REVA,Mechanical Engineering,KCET,2023,52134,79837,8274,16301,156546,140245,Yes
RVCE,Chemical Engineering,KCET,2024,65530,60600,9502,11913,147545,135632,Yes
DSATM,Mechanical Engineering,KCET,2024,59650,72827,11408,18420,162305,143885,No
VVIT,Electrical and Electronics Engineering,KCET,2023,82339,75396,13375,22699,193809,171110,No
DrAIT,Chemical Engineering,KCET,2023,63809,62066,8737,26977,161589,134612,Yes
REVA,Aerospace Engineering,COMEDK,2024,179239,62144,15035,20966,277384,256418,Yes
SITM,Data Science,KCET,2023,51048,87183,10803,13401,162435,149034,No
NIE,Aerospace Engineering,KCET,2024,74653,82079,12272,13841,182845,169004,Yes
RIT,Chemical Engineering,COMEDK,2024,200600,67517,16297,14494,298908,284414,Yes
JIT,Data Science,KCET,2024,52678,91668,11288,22541,178175,155634,Yes
DSCE,Biotechnology,COMEDK,2024,185068,82747,12086,24254,304155,279901,No
GIT,Artificial Intelligence and Data Science,KCET,2023,75079,81938,15131,27988,200136,172148,No
DrAIT,Computer Science and Engineering,COMEDK,2024,210929,88601,14472,19496,333498,314002,No
NHCE,Civil Engineering,COMEDK,2023,239727,92735,8052,27796,368310,340514,No
GIT,Mechanical Engineering,KCET,2024,79453,77049,8400,14170,179072,164902,Yes
RVCE,Aerospace Engineering,KCET,2024,77785,74114,14859,29233,195991,166758,Yes
AECMandya,Chemical Engineering,COMEDK,2023,177470,62188,17678,17262,274598,257336,Yes
YKCE,Artificial Intelligence and Data Science,COMEDK,2023,233846,60881,10735,13541,319003,305462,Yes
GMIT,Information Science and Engineering,KCET,2024,57770,79989,19457,23395,180611,157216,No
MSRIT,Robotics and Automation Engineering,COMEDK,2023,244243,84322,9146,15255,352966,337711,Yes
UVCE,Aerospace Engineering,KCET,2024,50205,72565,17570,15080,155420,140340,No
NHCE,Artificial Intelligence and Data Science,COMEDK,2024,240862,94662,9147,27045,371716,344671,Yes
VIT,Aerospace Engineering,COMEDK,2024,240203,79695,10243,17162,347303,330141,No
REVA,Civil Engineering,COMEDK,2024,169114,82348,15962,14744,282168,267424,Yes
VSM,Information Science and Engineering,KCET,2023,78520,64220,14301,19922,176963,157041,Yes
SCEM,Aerospace Engineering,KCET,2023,75132,63867,17177,11970,168146,156176,Yes
RVUNIV,Information Science and Engineering,COMEDK,2024,166023,76317,19480,15827,277647,261820,No
SCEM,Mechanical Engineering,COMEDK,2023,242879,83480,11310,21815,359484,337669,No
SIT,Electrical and Electronics Engineering,KCET,2023,61256,94975,12577,26752,195560,168808,No
REVA,Robotics and Automation Engineering,COMEDK,2023,194988,82739,15630,15597,308954,293357,Yes
KLEIT,Robotics and Automation Engineering,COMEDK,2023,160159,65716,11086,29271,266232,236961,No
RNSIT,Civil Engineering,KCET,2023,65347,75244,11112,15740,167443,151703,No
BMSIT,Aerospace Engineering,KCET,2023,72168,93721,13344,29559,208792,179233,Yes
VemanaIT,Information Science and Engineering,KCET,2023,53850,68373,12184,25019,159426,134407,Yes
RVUNIV,Data Science,KCET,2024,56192,70330,11187,20795,158504,137709,No
AIT,Electrical and Electronics Engineering,COMEDK,2024,199400,83673,18900,16152,318125,301973,No
MSRUAS,Information Science and Engineering,KCET,2024,64043,84344,14878,29779,193044,163265,Yes
DSATM,Civil Engineering,KCET,2024,76859,79790,9573,23199,189421,166222,Yes
RVUNIV,Aerospace Engineering,COMEDK,2024,187020,90252,13376,26696,317344,290648,Yes
SIT,Artificial Intelligence and Data Science,COMEDK,2024,224546,94462,15921,15826,350755,334929,No
BMIT,Mechanical Engineering,COMEDK,2024,210887,74453,18615,12635,316590,303955,No
MVJCE,Artificial Intelligence and Data Science,COMEDK,2024,219903,73935,19169,16143,329150,313007,Yes
JSSSTU,Chemical Engineering,COMEDK,2023,218405,81626,13197,22936,336164,313228,Yes
DBIT,Computer Science and Engineering,COMEDK,2024,215521,78698,15852,21436,331507,310071,Yes
JIT,Robotics and Automation Engineering,COMEDK,2024,207636,86439,13939,11455,319469,308014,No
RAIT,Robotics and Automation Engineering,KCET,2024,66167,77627,19907,26827,190528,163701,No
JIT,Data Science,COMEDK,2023,204297,63578,11619,25026,304520,279494,No
DrAIT,Artificial Intelligence and Data Science,COMEDK,2023,235244,94773,12358,17514,359889,342375,Yes
SITM,Biotechnology,KCET,2024,65665,78571,16371,29717,190324,160607,No
SDMIT,Information Science and Engineering,KCET,2023,58428,66695,8010,11565,144698,133133,Yes
AECMandya,Aerospace Engineering,KCET,2024,74740,82016,8870,22470,188096,165626,Yes
AECMandya,Artificial Intelligence and Data Science,KCET,2024,67535,89663,15986,13483,186667,173184,No
SCEM,Mechanical Engineering,COMEDK,2024,236309,61594,13858,28992,340753,311761,Yes
HKBK,Data Science,COMEDK,2023,207062,60722,15978,17588,301350,283762,Yes
VIT,Biotechnology,COMEDK,2024,247437,72078,10983,24474,354972,330498,Yes
SIT,Mechanical Engineering,COMEDK,2023,212644,76412,10968,21777,321801,300024,No
ACU,Mechanical Engineering,COMEDK,2023,237900,82056,9728,28718,358402,329684,Yes
EastPoint,Aerospace Engineering,COMEDK,2023,229801,82481,12822,12060,337164,325104,Yes
MVJCE,Civil Engineering,COMEDK,2024,207441,80126,11363,16274,315204,298930,Yes
RNSIT,Electronics and Communication Engineering,KCET,2023,71884,64791,15143,14114,165932,151818,No
YKCE,Data Science,KCET,2023,57331,80156,14877,10034,162398,152364,Yes
BNMIT,Data Science,KCET,2024,82295,74076,8344,11395,176110,164715,No
VVCE,Robotics and Automation Engineering,KCET,2024,73037,89215,13633,25122,201007,175885,Yes
MSRUAS,Mechanical Engineering,COMEDK,2024,204687,61870,13729,26774,307060,280286,No
AEC,Aerospace Engineering,KCET,2023,72493,68638,16935,18711,176777,158066,No
DBIT,Mechanical Engineering,COMEDK,2023,193235,65027,12563,22036,292861,270825,Yes
BMSIT,Artificial Intelligence and Data Science,COMEDK,2024,222947,89554,17456,12759,342716,329957,No
AIT,Artificial Intelligence and Data Science,COMEDK,2024,205588,64837,13875,15864,300164,284300,Yes
KSIT,Chemical Engineering,COMEDK,2023,248334,72859,12312,20025,353530,333505,No
KLEIT,Chemical Engineering,KCET,2024,61859,67635,18573,10842,158909,148067,Yes
MSRUAS,Aerospace Engineering,KCET,2024,71403,77474,12822,14651,176350,161699,Yes
NHCE,Computer Science and Engineering,KCET,2024,51757,90541,12388,22773,177459,154686,No
ACU,Biotechnology,KCET,2023,77689,90836,17761,18907,205193,186286,No
RVUNIV,Mechanical Engineering,COMEDK,2024,222560,87903,19603,14415,344481,330066,No
AEC,Mechanical Engineering,COMEDK,2024,178882,63585,18591,27647,288705,261058,Yes
MSRUAS,Computer Science and Engineering,COMEDK,2024,169190,61160,15175,16564,262089,245525,No
UVCE,Chemical Engineering,COMEDK,2023,206571,84230,16539,20917,328257,307340,Yes
BMSCE,Chemical Engineering,COMEDK,2023,243004,89130,8216,20189,360539,340350,No
DrAIT,Mechanical Engineering,COMEDK,2023,237762,74333,17250,24305,353650,329345,Yes
DrAIT,Aerospace Engineering,COMEDK,2023,245476,60344,11174,15305,332299,316994,Yes
BNMIT,Electronics and Communication Engineering,KCET,2024,68168,89324,13981,26265,197738,171473,No
BMSIT,Biotechnology,KCET,2024,75086,90200,15480,27701,208467,180766,Yes
DSATM,Electrical and Electronics Engineering,KCET,2024,76471,94629,9663,11771,192534,180763,Yes
GMIT,Civil Engineering,KCET,2024,52573,85511,10506,27783,176373,148590,Yes
DrAIT,Biotechnology,KCET,2023,51461,81922,11451,20947,165781,144834,No
RVCE,Biotechnology,KCET,2023,72395,72896,11442,12374,169107,156733,Yes
MSRIT,Robotics and Automation Engineering,KCET,2024,72364,80883,19523,11827,184597,172770,No
VIT,Chemical Engineering,COMEDK,2023,176482,60778,19078,26886,283224,256338,No
RNSIT,Mechanical Engineering,COMEDK,2023,184745,86041,10198,18994,299978,280984,No
RIT,Artificial Intelligence and Data Science,COMEDK,2023,207701,66183,11364,18245,303493,285248,Yes
BIT,Computer Science and Engineering,COMEDK,2024,181768,92614,17489,26123,317994,291871,No
MSRIT,Information Science and Engineering,KCET,2023,77495,62418,19296,11722,170931,159209,Yes
VVIT,Robotics and Automation Engineering,COMEDK,2023,169571,94219,15147,19061,297998,278937,Yes
VVCE,Computer Science and Engineering,KCET,2023,74586,67761,13516,16520,172383,155863,Yes
NCET,Robotics and Automation Engineering,COMEDK,2023,246156,72549,10982,26823,356510,329687,Yes
DrAIT,Robotics and Automation Engineering,COMEDK,2024,187112,72472,10677,16692,286953,270261,Yes
SJBIT,Biotechnology,KCET,2023,62688,90722,16705,22291,192406,170115,No
SDMCET,Electrical and Electronics Engineering,KCET,2024,66290,72667,16007,19871,174835,154964,No
KLSGIT,Mechanical Engineering,COMEDK,2023,235712,67532,14348,28035,345627,317592,Yes
BNMIT,Robotics and Automation Engineering,KCET,2024,69475,80076,8166,20365,178082,157717,Yes
AIT,Artificial Intelligence and Data Science,COMEDK,2023,173691,74473,17683,26207,292054,265847,Yes
JIT,Biotechnology,COMEDK,2023,234383,65053,12830,28979,341245,312266,No
GIT,Information Science and Engineering,COMEDK,2023,242385,68093,8739,20175,339392,319217,Yes
VVIT,Electrical and Electronics Engineering,COMEDK,2024,187213,70415,13410,13497,284535,271038,No
RVCE,Robotics and Automation Engineering,COMEDK,2023,200852,92717,11727,21181,326477,305296,No
GMIT,Biotechnology,KCET,2023,68464,78766,10738,26094,184062,157968,Yes
JSSSTU,Electrical and Electronics Engineering,KCET,2023,52256,72984,15119,22450,162809,140359,Yes
BMSCE,Electrical and Electronics Engineering,KCET,2023,73231,72681,13008,26726,185646,158920,Yes
SCEM,Electrical and Electronics Engineering,KCET,2023,79511,91205,9779,15966,196461,180495,No
PRES,Data Science,KCET,2024,62302,76047,12550,24294,175193,150899,No
HKBK,Data Science,COMEDK,2024,244510,80300,10341,27352,362503,335151,No
JNNCE,Information Science and Engineering,KCET,2024,72999,73620,9854,20559,177032,156473,Yes
BMSCE,Information Science and Engineering,COMEDK,2024,224171,94280,8681,16867,343999,327132,No
CITGubbi,Biotechnology,KCET,2023,76826,64374,13110,16354,170664,154310,Yes
BMSIT,Computer Science and Engineering,KCET,2023,51800,79127,17148,23634,171709,148075,Yes
BIT,Information Science and Engineering,COMEDK,2023,211105,75731,9896,11276,308008,296732,No
RIT,Artificial Intelligence and Data Science,KCET,2023,73717,74377,12996,17946,179036,161090,No
SCEM,Chemical Engineering,COMEDK,2024,176188,64715,14269,29613,284785,255172,No
KLEIT,Computer Science and Engineering,KCET,2024,65602,90733,17155,24608,198098,173490,Yes
VVCE,Robotics and Automation Engineering,COMEDK,2023,170989,62379,8227,28469,270064,241595,Yes
SJBIT,Robotics and Automation Engineering,KCET,2024,81402,92344,12177,15731,201654,185923,Yes
SIT,Civil Engineering,COMEDK,2023,246593,82745,8395,18859,356592,337733,Yes
DrAIT,Robotics and Automation Engineering,COMEDK,2023,180208,66685,8577,26064,281534,255470,No
NMIT,Biotechnology,COMEDK,2023,230998,70096,12794,11222,325110,313888,Yes
KLSGIT,Biotechnology,COMEDK,2024,186615,88423,18149,11340,304527,293187,Yes
RAIT,Chemical Engineering,COMEDK,2023,191490,81408,13808,16247,302953,286706,Yes
KLEIT,Artificial Intelligence and Data Science,COMEDK,2023,161166,61101,12938,29708,264913,235205,No
NCET,Mechanical Engineering,COMEDK,2024,192668,71465,16791,15607,296531,280924,No
NIE,Artificial Intelligence and Data Science,COMEDK,2023,172077,61898,12189,24360,270524,246164,Yes
DBIT,Data Science,KCET,2023,79598,61344,8798,20843,170583,149740,Yes
RAIT,Electronics and Communication Engineering,COMEDK,2024,189354,66337,12610,10811,279112,268301,Yes
DBIT,Data Science,KCET,2023,82161,75157,16824,12249,186391,174142,Yes
CMRIT,Biotechnology,COMEDK,2024,193918,87015,19117,19308,319358,300050,Yes
CMRIT,Artificial Intelligence and Data Science,KCET,2024,74924,84096,13567,19880,192467,172587,Yes
UVCE,Information Science and Engineering,COMEDK,2024,215188,85242,14449,29919,344798,314879,Yes
GIT,Information Science and Engineering,KCET,2024,65043,83349,14181,11440,174013,162573,Yes
NCET,Computer Science and Engineering,COMEDK,2023,197515,60447,14587,25930,298479,272549,Yes
BMIT,Robotics and Automation Engineering,COMEDK,2024,192215,78160,12128,18883,301386,282503,No
SIT,Computer Science and Engineering,COMEDK,2024,177404,81913,9635,19499,288451,268952,Yes
DrAIT,Information Science and Engineering,COMEDK,2024,241508,84637,18787,16268,361200,344932,Yes
VemanaIT,Civil Engineering,KCET,2023,76177,66055,13102,18515,173849,155334,Yes
KSIT,Electronics and Communication Engineering,KCET,2023,61841,83224,16744,17187,178996,161809,No
JSSSTU,Information Science and Engineering,COMEDK,2024,180285,81321,16203,27369,305178,277809,Yes
BMIT,Mechanical Engineering,KCET,2023,74184,74338,11002,11914,171438,159524,Yes
NMIT,Mechanical Engineering,COMEDK,2023,168130,81950,18489,25845,294414,268569,No
BITM,Electrical and Electronics Engineering,COMEDK,2024,229384,83876,17053,29379,359692,330313,Yes
GIT,Mechanical Engineering,COMEDK,2024,242600,90584,13298,28648,375130,346482,Yes
AITM,Data Science,KCET,2024,52011,70199,9432,20047,151689,131642,Yes
VVIT,Mechanical Engineering,KCET,2023,59516,81440,19060,15696,175712,160016,Yes
RAIT,Aerospace Engineering,KCET,2024,60650,63490,16008,18559,158707,140148,No
REVA,Civil Engineering,COMEDK,2023,225447,74408,11468,17168,328491,311323,No
KLSGIT,Artificial Intelligence and Data Science,COMEDK,2023,221310,72466,8643,18031,320450,302419,Yes
NCET,Electrical and Electronics Engineering,COMEDK,2023,177121,85667,19905,27914,310607,282693,No
RVUNIV,Mechanical Engineering,KCET,2024,72585,76559,8700,14477,172321,157844,No
DBIT,Computer Science and Engineering,KCET,2024,63068,60759,14231,21776,159834,138058,Yes
BITM,Mechanical Engineering,KCET,2024,56334,73989,16738,11823,158884,147061,No
BMIT,Electronics and Communication Engineering,KCET,2023,71318,84374,14819,27314,197825,170511,No
CITGubbi,Aerospace Engineering,KCET,2023,73577,91759,19619,14884,199839,184955,Yes
VVIT,Chemical Engineering,COMEDK,2023,171508,71076,17752,21030,281366,260336,No
VemanaIT,Aerospace Engineering,COMEDK,2023,191587,79921,10665,29297,311470,282173,Yes
MSRUAS,Electronics and Communication Engineering,COMEDK,2024,185302,80453,15926,12990,294671,281681,No
BITM,Civil Engineering,KCET,2024,69323,84453,9390,19302,182468,163166,No
VemanaIT,Electrical and Electronics Engineering,KCET,2023,84269,75378,15938,17629,193214,175585,Yes
NHCE,Information Science and Engineering,COMEDK,2023,213838,78099,12223,27864,332024,304160,Yes
RAIT,Mechanical Engineering,COMEDK,2023,221389,88261,12523,27541,349714,322173,Yes
YKCE,Chemical Engineering,KCET,2024,59068,75062,17172,19028,170330,151302,No
NIE,Civil Engineering,COMEDK,2023,175670,69452,13382,18242,276746,258504,Yes
CITGubbi,Aerospace Engineering,KCET,2024,69027,64156,15715,16632,165530,148898,No
VIT,Biotechnology,KCET,2023,57477,62685,11031,23755,154948,131193,Yes
VVCE,Electronics and Communication Engineering,KCET,2023,69619,78183,19828,10363,177993,167630,Yes
VSM,Computer Science and Engineering,KCET,2023,53846,61690,8444,19712,143692,123980,Yes
RVCE,Information Science and Engineering,KCET,2024,78944,71637,15301,12697,178579,165882,No
SCEM,Biotechnology,KCET,2024,74337,81027,11063,18030,184457,166427,No
RVUNIV,Biotechnology,KCET,2023,54403,78843,10001,21685,164932,143247,Yes
VemanaIT,Aerospace Engineering,COMEDK,2023,165674,84267,13956,10211,274108,263897,No
BMSIT,Mechanical Engineering,KCET,2024,67047,80642,17657,10553,175899,165346,Yes
DrAIT,Chemical Engineering,COMEDK,2023,195298,73731,16060,21171,306260,285089,Yes
YKCE,Mechanical Engineering,COMEDK,2024,242596,70089,19313,21881,353879,331998,No
NMIT,Information Science and Engineering,KCET,2023,56941,73794,18170,11556,160461,148905,No
BMIT,Data Science,COMEDK,2024,248367,90437,16171,26591,381566,354975,Yes
VemanaIT,Robotics and Automation Engineering,COMEDK,2024,249902,66487,12387,29802,358578,328776,No
AITM,Data Science,KCET,2023,52218,89071,18978,23215,183482,160267,Yes
DSATM,Artificial Intelligence and Data Science,KCET,2023,84195,94180,10723,29410,218508,189098,No
GIT,Electronics and Communication Engineering,COMEDK,2024,226963,82988,16665,11395,338011,326616,Yes
SITM,Information Science and Engineering,COMEDK,2024,245994,93858,17770,27950,385572,357622,No
HKBK,Robotics and Automation Engineering,KCET,2024,67127,83787,12203,21095,184212,163117,No
RNSIT,Electrical and Electronics Engineering,COMEDK,2024,192447,83898,11087,15274,302706,287432,No
SJBCE,Chemical Engineering,COMEDK,2024,191026,81734,18631,12876,304267,291391,No
MVJCE,Computer Science and Engineering,KCET,2023,57817,81801,17424,17099,174141,157042,Yes
GMIT,Mechanical Engineering,COMEDK,2023,188647,77882,10276,13994,290799,276805,No
SDMCET,Computer Science and Engineering,KCET,2023,63518,64911,8620,10065,147114,137049,No
BITM,Information Science and Engineering,KCET,2024,80155,92228,9969,28802,211154,182352,Yes
JNNCE,Civil Engineering,COMEDK,2024,229396,67683,13108,27754,337941,310187,Yes
KLEIT,Computer Science and Engineering,KCET,2024,61531,77247,19184,13676,171638,157962,No
CMRIT,Information Science and Engineering,COMEDK,2023,179182,75846,17423,17434,289885,272451,No
CMRIT,Data Science,COMEDK,2024,194160,68277,19741,12793,294971,282178,No
RAIT,Biotechnology,COMEDK,2024,249763,89970,14748,20800,375281,354481,Yes
VemanaIT,Electrical and Electronics Engineering,KCET,2023,57131,87578,8005,19733,172447,152714,Yes
REVA,Electronics and Communication Engineering,COMEDK,2024,241373,83321,17822,10846,353362,342516,Yes
AIT,Robotics and Automation Engineering,KCET,2024,71676,83763,13702,23011,192152,169141,No
BNMIT,Mechanical Engineering,KCET,2023,72582,64146,13084,13264,163076,149812,No
HKBK,Data Science,COMEDK,2024,184756,86680,11687,27458,310581,283123,No
MVJCE,Electrical and Electronics Engineering,KCET,2023,52854,81084,10747,20133,164818,144685,Yes
BMIT,Robotics and Automation Engineering,COMEDK,2023,226689,69737,12207,27139,335772,308633,Yes
CITGubbi,Electrical and Electronics Engineering,KCET,2024,66906,79374,12596,14874,173750,158876,Yes
BMIT,Aerospace Engineering,KCET,2024,58533,84404,10789,23833,177559,153726,No
RIT,Biotechnology,KCET,2024,52853,90662,16700,19910,180125,160215,Yes
VIT,Robotics and Automation Engineering,COMEDK,2024,248337,83308,17648,21264,370557,349293,No
PESU,Mechanical Engineering,COMEDK,2023,178407,70238,15103,17532,281280,263748,Yes
RVCE,Computer Science and Engineering,COMEDK,2023,200579,70226,10630,13588,295023,281435,No
MSRUAS,Electronics and Communication Engineering,COMEDK,2024,244784,62481,18730,18130,344125,325995,Yes
BITM,Computer Science and Engineering,COMEDK,2024,232774,61651,15156,25924,335505,309581,Yes
NHCE,Information Science and Engineering,KCET,2023,56676,80616,16271,22463,176026,153563,No
GIT,Aerospace Engineering,KCET,2024,66900,83164,17732,26547,194343,167796,Yes
RNSIT,Robotics and Automation Engineering,COMEDK,2024,191822,75155,14803,27638,309418,281780,Yes
RAIT,Biotechnology,KCET,2023,82254,78060,16337,22423,199074,176651,Yes
VSM,Information Science and Engineering,COMEDK,2024,209669,65009,9070,25186,308934,283748,Yes
DSATM,Aerospace Engineering,KCET,2023,80439,71658,10370,11147,173614,162467,Yes
BMSCE,Information Science and Engineering,KCET,2023,71105,69219,13742,24058,178124,154066,No
DBIT,Information Science and Engineering,KCET,2024,84666,75650,17979,24857,203152,178295,No
KSIT,Electrical and Electronics Engineering,KCET,2023,65955,91133,14254,12939,184281,171342,Yes
SJBCE,Information Science and Engineering,KCET,2024,80490,77982,11915,19742,190129,170387,No
PESCE,Chemical Engineering,KCET,2023,65766,82391,16271,19007,183435,164428,No
RVUNIV,Electronics and Communication Engineering,KCET,2023,65151,60420,14122,20572,160265,139693,Yes
AITM,Biotechnology,COMEDK,2024,200073,78237,10448,21824,310582,288758,No
NIE,Aerospace Engineering,COMEDK,2023,227383,91635,17778,12333,349129,336796,Yes
RNSIT,Robotics and Automation Engineering,COMEDK,2023,165227,68361,15617,22695,271900,249205,No
BITM,Civil Engineering,KCET,2024,65207,70916,8604,17774,162501,144727,Yes
BMSIT,Biotechnology,KCET,2024,63044,72110,10666,14342,160162,145820,No
NMIT,Chemical Engineering,COMEDK,2024,200255,91585,12336,16402,320578,304176,Yes
NIE,Electrical and Electronics Engineering,KCET,2023,67302,87847,8607,21629,185385,163756,No
VVIT,Information Science and Engineering,KCET,2024,73695,92007,14020,25743,205465,179722,Yes
DSATM,Data Science,KCET,2023,79314,93710,12538,26529,212091,185562,Yes
DSATM,Biotechnology,KCET,2023,53292,76807,16816,14427,161342,146915,Yes
SITM,Computer Science and Engineering,KCET,2023,58013,68135,13090,29144,168382,139238,Yes
PRES,Data Science,KCET,2024,57417,76100,13335,23323,170175,146852,No
RIT,Aerospace Engineering,COMEDK,2024,205481,76065,15153,21037,317736,296699,Yes
JNNCE,Civil Engineering,COMEDK,2023,167524,60540,18035,13561,259660,246099,Yes
PESCE,Aerospace Engineering,KCET,2024,65904,64732,11145,19085,160866,141781,Yes
RIT,Aerospace Engineering,COMEDK,2023,183150,91797,10044,20526,305517,284991,No
SCEM,Mechanical Engineering,KCET,2024,65238,87025,8001,21034,181298,160264,No
VVIT,Computer Science and Engineering,KCET,2024,74919,89307,14592,16435,195253,178818,Yes
EastPoint,Electrical and Electronics Engineering,COMEDK,2024,192931,89092,15940,14490,312453,297963,Yes
SDMCET,Electronics and Communication Engineering,KCET,2024,80005,92841,16838,25843,215527,189684,No
ACU,Artificial Intelligence and Data Science,KCET,2023,81938,78750,17415,10610,188713,178103,Yes
SDMIT,Electronics and Communication Engineering,COMEDK,2023,228500,94745,12151,19348,354744,335396,Yes
NMIT,Information Science and Engineering,KCET,2023,56755,86503,15331,21227,179816,158589,No
VSM,Data Science,KCET,2023,57909,70666,12862,29016,170453,141437,Yes
ACU,Mechanical Engineering,COMEDK,2023,198311,71180,15891,27755,313137,285382,Yes
DrAIT,Electronics and Communication Engineering,COMEDK,2024,232384,71371,16172,19059,338986,319927,No
NIE,Data Science,KCET,2024,78358,92085,14378,24357,209178,184821,Yes
JIT,Chemical Engineering,KCET,2023,56172,83297,11763,15829,167061,151232,No
GIT,Robotics and Automation Engineering,KCET,2023,61177,87127,9967,16848,175119,158271,No
AITM,Information Science and Engineering,KCET,2023,76949,76150,12645,18027,183771,165744,Yes
SIT,Mechanical Engineering,COMEDK,2024,198972,77685,13504,24281,314442,290161,Yes
BMSCE,Mechanical Engineering,KCET,2024,76617,85224,12150,29712,203703,173991,Yes
SITM,Robotics and Automation Engineering,COMEDK,2024,239553,71155,12272,16595,339575,322980,No
CITGubbi,Mechanical Engineering,KCET,2023,53494,65697,11654,20701,151546,130845,No
AIT,Mechanical Engineering,KCET,2023,56214,85568,19154,16308,177244,160936,No
KLSGIT,Data Science,COMEDK,2023,170177,62181,9779,22908,265045,242137,Yes
MVJCE,Artificial Intelligence and Data Science,COMEDK,2023,220666,67548,13869,26720,328803,302083,Yes
CITGubbi,Information Science and Engineering,COMEDK,2023,232775,90105,13047,14215,350142,335927,Yes
BMSCE,Computer Science and Engineering,COMEDK,2024,242925,70550,16567,11545,341587,330042,Yes
JIT,Civil Engineering,KCET,2023,74833,93571,10317,22872,201593,178721,Yes
RVUNIV,Artificial Intelligence and Data Science,COMEDK,2024,176402,62843,13529,27352,280126,252774,No
KLEIT,Computer Science and Engineering,COMEDK,2024,169693,75774,8466,10761,264694,253933,Yes
VVCE,Data Science,COMEDK,2023,191010,86153,19433,26684,323280,296596,Yes
DSCE,Chemical Engineering,COMEDK,2024,210547,90170,12691,17318,330726,313408,No
MSRUAS,Robotics and Automation Engineering,KCET,2024,66459,90738,12873,27681,197751,170070,Yes
DBIT,Information Science and Engineering,KCET,2023,78480,62468,16966,12537,170451,157914,Yes
SITM,Mechanical Engineering,COMEDK,2024,195773,94290,8978,22257,321298,299041,Yes
PESCE,Robotics and Automation Engineering,COMEDK,2023,182659,69207,12319,19286,283471,264185,Yes
RAIT,Biotechnology,KCET,2024,59160,79768,19865,17233,176026,158793,Yes
ACU,Data Science,KCET,2024,54077,81930,14566,13412,163985,150573,No
DSATM,Computer Science and Engineering,COMEDK,2024,247661,94362,11047,12510,365580,353070,Yes
CMRIT,Civil Engineering,COMEDK,2023,189545,86414,9739,26603,312301,285698,Yes
REVA,Electronics and Communication Engineering,KCET,2023,79950,72211,10361,25059,187581,162522,Yes
RAIT,Robotics and Automation Engineering,COMEDK,2024,195965,61030,14790,28053,299838,271785,No
GMIT,Aerospace Engineering,KCET,2023,55773,64243,13280,23102,156398,133296,Yes
RAIT,Robotics and Automation Engineering,COMEDK,2024,173018,83088,12728,29190,298024,268834,Yes
EastPoint,Information Science and Engineering,KCET,2023,60560,67590,17737,25075,170962,145887,Yes
CMRIT,Robotics and Automation Engineering,KCET,2024,52906,66544,8046,25602,153098,127496,No
VVIT,Electronics and Communication Engineering,COMEDK,2024,206328,70267,19890,13455,309940,296485,Yes
BNMIT,Data Science,COMEDK,2024,246934,79273,13382,26387,365976,339589,No
SJBIT,Mechanical Engineering,KCET,2024,71501,85276,17467,27469,201713,174244,No
JIT,Chemical Engineering,KCET,2024,67509,81738,11497,27731,188475,160744,No
PRES,Data Science,COMEDK,2024,238364,73272,16503,21032,349171,328139,No
YKCE,Robotics and Automation Engineering,KCET,2024,52527,75234,10872,13295,151928,138633,No
KSIT,Electronics and Communication Engineering,KCET,2024,71345,72708,14593,13040,171686,158646,Yes
UVCE,Data Science,COMEDK,2024,176361,82791,19898,23163,302213,279050,Yes
VVIT,Computer Science and Engineering,KCET,2023,62166,75440,12915,18490,169011,150521,No
BMIT,Aerospace Engineering,COMEDK,2023,226790,76023,19845,18534,341192,322658,No
NHCE,Electrical and Electronics Engineering,COMEDK,2023,230420,71582,14044,13922,329968,316046,Yes
YKCE,Aerospace Engineering,KCET,2024,84426,93890,10582,15683,204581,188898,No
RNSIT,Civil Engineering,KCET,2023,76854,93670,10200,12447,193171,180724,Yes
VVIT,Biotechnology,COMEDK,2023,183194,84220,12544,28919,308877,279958,Yes
VIT,Robotics and Automation Engineering,COMEDK,2024,194208,87160,15909,17721,314998,297277,Yes
JIT,Electronics and Communication Engineering,KCET,2023,77390,63782,11674,25258,178104,152846,Yes
MSRUAS,Electrical and Electronics Engineering,COMEDK,2024,241295,93116,19731,14638,368780,354142,No
YKCE,Robotics and Automation Engineering,COMEDK,2024,186983,69979,19333,23733,300028,276295,No
VemanaIT,Biotechnology,COMEDK,2023,180812,86270,15402,16037,298521,282484,No
SDMIT,Artificial Intelligence and Data Science,KCET,2024,55266,71305,18103,10106,154780,144674,Yes
KLSGIT,Civil Engineering,KCET,2023,71196,79191,10290,10818,171495,160677,No
AECMandya,Data Science,COMEDK,2023,173269,63373,17596,10479,264717,254238,No
NCET,Data Science,COMEDK,2023,194450,74491,16261,12323,297525,285202,Yes
NIE,Chemical Engineering,KCET,2024,68168,79313,11330,22852,181663,158811,No
SDMCET,Mechanical Engineering,KCET,2024,78069,73367,19379,21759,192574,170815,No
YKCE,Chemical Engineering,COMEDK,2023,180726,77310,10623,28465,297124,268659,Yes
CITGubbi,Civil Engineering,COMEDK,2023,181417,64058,18160,16817,280452,263635,Yes
BMSCE,Chemical Engineering,KCET,2023,68892,73620,19069,13317,174898,161581,Yes
DrAIT,Mechanical Engineering,COMEDK,2023,169036,74946,10957,27398,282337,254939,Yes
CMRIT,Electrical and Electronics Engineering,COMEDK,2024,202626,68124,8025,27989,306764,278775,No
RVCE,Information Science and Engineering,COMEDK,2024,167602,87230,17703,12024,284559,272535,No
JNNCE,Data Science,COMEDK,2023,200586,75369,12276,25102,313333,288231,No
RVCE,Civil Engineering,KCET,2024,58961,90682,17157,24600,191400,166800,Yes
UVCE,Biotechnology,COMEDK,2024,176595,85518,15303,11735,289151,277416,Yes
PRES,Information Science and Engineering,KCET,2023,54555,68890,17323,27647,168415,140768,Yes
PRES,Civil Engineering,COMEDK,2023,215098,61988,17242,16103,310431,294328,Yes
REVA,Information Science and Engineering,COMEDK,2024,226656,78466,9617,22853,337592,314739,No
NMIT,Mechanical Engineering,KCET,2023,79467,70084,12259,26754,188564,161810,Yes
PESCE,Civil Engineering,KCET,2023,81862,89055,13202,19242,203361,184119,No
MSRIT,Artificial Intelligence and Data Science,KCET,2023,77714,66479,16038,27080,187311,160231,Yes
SJBCE,Chemical Engineering,KCET,2024,56980,89921,10719,22582,180202,157620,Yes
RNSIT,Biotechnology,COMEDK,2024,234221,73062,12858,11359,331500,320141,Yes
RVCE,Electrical and Electronics Engineering,COMEDK,2024,221192,61291,16799,18776,318058,299282,Yes
GMIT,Robotics and Automation Engineering,KCET,2023,74007,82493,12674,12197,181371,169174,Yes
BMSCE,Civil Engineering,COMEDK,2023,212939,81893,17180,11076,323088,312012,Yes
AEC,Civil Engineering,COMEDK,2023,215490,67006,17725,11069,311290,300221,Yes
CMRIT,Electronics and Communication Engineering,COMEDK,2024,160956,60032,12917,26082,259987,233905,No
DSCE,Robotics and Automation Engineering,KCET,2023,59956,88592,19260,29216,197024,167808,No
BITM,Biotechnology,KCET,2024,64697,61408,14828,29469,170402,140933,Yes
RIT,Information Science and Engineering,COMEDK,2023,235949,79272,9154,23942,348317,324375,No
VVCE,Robotics and Automation Engineering,COMEDK,2024,221894,73604,18652,26691,340841,314150,No
RIT,Civil Engineering,KCET,2024,74818,86209,19343,15655,196025,180370,No
CMRIT,Chemical Engineering,COMEDK,2024,239791,73697,16596,18746,348830,330084,Yes
SDMIT,Mechanical Engineering,KCET,2024,72330,61917,8087,22796,165130,142334,No
AITM,Civil Engineering,KCET,2024,62388,82450,15858,18728,179424,160696,No
KLEIT,Electronics and Communication Engineering,KCET,2024,66042,79089,14058,20222,179411,159189,Yes
VemanaIT,Aerospace Engineering,COMEDK,2023,228593,65797,19236,10496,324122,313626,Yes
RVCE,Artificial Intelligence and Data Science,KCET,2024,62747,70281,17632,11240,161900,150660,No
EastPoint,Robotics and Automation Engineering,KCET,2024,66242,78972,8214,13106,166534,153428,No
AEC,Artificial Intelligence and Data Science,KCET,2024,60704,72513,11493,15302,160012,144710,No
CMRIT,Civil Engineering,COMEDK,2023,207233,92301,17302,26275,343111,316836,Yes
SJBCE,Biotechnology,KCET,2024,65214,70563,18013,26165,179955,153790,Yes
NHCE,Computer Science and Engineering,KCET,2023,50664,67951,9477,21083,149175,128092,Yes
RVUNIV,Chemical Engineering,KCET,2024,79026,79185,15339,23443,196993,173550,Yes
VemanaIT,Biotechnology,COMEDK,2023,244866,88565,14867,20663,368961,348298,No
KLSGIT,Civil Engineering,COMEDK,2023,198221,62109,10987,27651,298968,271317,No
AITM,Aerospace Engineering,KCET,2023,71976,73153,13987,11395,170511,159116,Yes
NHCE,Civil Engineering,KCET,2024,65935,66530,8497,21027,161989,140962,No
GMIT,Aerospace Engineering,COMEDK,2024,175834,93490,18868,12848,301040,288192,No
VVIT,Artificial Intelligence and Data Science,KCET,2023,69744,84992,12047,20859,187642,166783,Yes
DBIT,Chemical Engineering,KCET,2023,63252,72102,9914,19869,165137,145268,Yes
VSM,Electronics and Communication Engineering,KCET,2024,50462,71230,12742,25638,160072,134434,Yes
RVUNIV,Civil Engineering,KCET,2023,83605,84336,11617,12120,191678,179558,No
NIE,Civil Engineering,KCET,2023,54854,91930,19119,17436,183339,165903,Yes
GIT,Chemical Engineering,COMEDK,2024,197804,91147,12558,12640,314149,301509,No
SDMIT,Chemical Engineering,COMEDK,2024,208565,78774,8421,26314,322074,295760,No
BNMIT,Computer Science and Engineering,COMEDK,2024,230676,60580,8070,25767,325093,299326,Yes
KLEIT,Artificial Intelligence and Data Science,COMEDK,2023,206965,66791,15514,18527,307797,289270,No
YKCE,Electronics and Communication Engineering,COMEDK,2024,179130,87498,8929,14619,290176,275557,Yes
VemanaIT,Biotechnology,COMEDK,2023,200254,69778,15248,13818,299098,285280,Yes
DSATM,Electronics and Communication Engineering,KCET,2024,77292,74300,11170,17155,179917,162762,Yes
BNMIT,Biotechnology,KCET,2023,62753,74136,8394,22079,167362,145283,Yes
SJBIT,Robotics and Automation Engineering,KCET,2023,55296,87325,15081,28230,185932,157702,Yes
REVA,Civil Engineering,COMEDK,2024,166927,62041,10490,10719,250177,239458,Yes
UVCE,Robotics and Automation Engineering,COMEDK,2023,180252,67406,11241,26590,285489,258899,Yes
BMSCE,Artificial Intelligence and Data Science,COMEDK,2024,243180,66243,16048,16830,342301,325471,No
JNNCE,Biotechnology,COMEDK,2023,186941,80940,8033,25872,301786,275914,No
JIT,Robotics and Automation Engineering,KCET,2023,60258,84639,13498,23350,181745,158395,Yes
MVJCE,Computer Science and Engineering,COMEDK,2024,209357,85856,8037,15003,318253,303250,No
RNSIT,Mechanical Engineering,KCET,2023,57787,82385,8802,22773,171747,148974,No
AITM,Artificial Intelligence and Data Science,KCET,2024,75816,75935,18217,18548,188516,169968,No
KLEIT,Biotechnology,KCET,2024,52074,86866,19125,12005,170070,158065,Yes
SITM,Electronics and Communication Engineering,COMEDK,2024,206537,67787,15562,24671,314557,289886,No
SIT,Mechanical Engineering,KCET,2023,69194,68477,16142,22404,176217,153813,Yes
JIT,Electronics and Communication Engineering,COMEDK,2024,184186,84618,13209,16499,298512,282013,No
ACU,Aerospace Engineering,KCET,2024,62094,78722,8713,18396,167925,149529,No
SIT,Robotics and Automation Engineering,KCET,2023,60899,85232,10407,29508,186046,156538,No
PRES,Aerospace Engineering,KCET,2024,54749,83132,19812,25605,183298,157693,No
JSSSTU,Computer Science and Engineering,COMEDK,2023,203790,74723,9053,28026,315592,287566,Yes
VVCE,Mechanical Engineering,KCET,2024,62563,62166,13917,23158,161804,138646,No
PESCE,Biotechnology,KCET,2023,82120,80119,16271,28523,207033,178510,Yes
NCET,Aerospace Engineering,COMEDK,2024,208247,89909,18910,21966,339032,317066,Yes
RVCE,Biotechnology,KCET,2024,67562,66700,18970,12082,165314,153232,Yes
VVIT,Electrical and Electronics Engineering,COMEDK,2023,170984,71203,13471,24964,280622,255658,Yes
KLSGIT,Mechanical Engineering,KCET,2023,53458,91115,14441,13186,172200,159014,Yes
REVA,Computer Science and Engineering,COMEDK,2023,164301,60613,16961,15928,257803,241875,Yes
NCET,Information Science and Engineering,KCET,2023,56447,80939,14758,28304,180448,152144,No
SDMIT,Information Science and Engineering,COMEDK,2024,212951,70092,8714,14951,306708,291757,No
BNMIT,Information Science and Engineering,KCET,2024,71128,71575,19856,14119,176678,162559,No
JNNCE,Electronics and Communication Engineering,KCET,2023,51824,89527,17735,29310,188396,159086,No
BMSCE,Mechanical Engineering,COMEDK,2024,170611,71330,19020,27824,288785,260961,No
YKCE,Chemical Engineering,COMEDK,2023,196270,81444,19798,19383,316895,297512,No
MSRUAS,Electronics and Communication Engineering,KCET,2023,50919,82116,16202,15364,164601,149237,Yes
MSRIT,Biotechnology,KCET,2024,64606,92600,11469,20358,189033,168675,Yes
CMRIT,Mechanical Engineering,COMEDK,2023,174986,82686,15901,11633,285206,273573,No
CMRIT,Artificial Intelligence and Data Science,KCET,2024,68560,62112,8662,22453,161787,139334,Yes
GMIT,Information Science and Engineering,KCET,2023,67376,71644,18839,23027,180886,157859,Yes
GMIT,Civil Engineering,COMEDK,2024,173649,87046,19159,19624,299478,279854,Yes
GMIT,Data Science,COMEDK,2024,190665,61556,14874,21810,288905,267095,No
NIE,Mechanical Engineering,COMEDK,2024,188713,80335,14822,14943,298813,283870,No
BNMIT,Aerospace Engineering,COMEDK,2023,232397,65528,18151,26088,342164,316076,No
KLEIT,Aerospace Engineering,COMEDK,2023,168721,94671,17034,15363,295789,280426,No
RNSIT,Biotechnology,KCET,2024,71756,61690,11235,10844,155525,144681,Yes
MSRUAS,Data Science,KCET,2023,71148,68532,9257,13603,162540,148937,Yes
BNMIT,Chemical Engineering,COMEDK,2024,168797,91154,19470,24808,304229,279421,No
GMIT,Electronics and Communication Engineering,KCET,2024,70465,77926,15345,20656,184392,163736,Yes
SITM,Mechanical Engineering,KCET,2024,53764,81986,10298,24495,170543,146048,Yes
ACU,Mechanical Engineering,KCET,2023,78505,90144,14589,28952,212190,183238,Yes
REVA,Information Science and Engineering,KCET,2024,58596,61626,10177,19957,150356,130399,No
SDMCET,Aerospace Engineering,COMEDK,2024,188397,82909,11524,27584,310414,282830,No
CITGubbi,Computer Science and Engineering,KCET,2023,68048,86061,12272,23856,190237,166381,Yes
BIT,Electronics and Communication Engineering,COMEDK,2024,180944,92173,19837,19269,312223,292954,No
NMIT,Biotechnology,COMEDK,2024,223680,90940,8118,19949,342687,322738,No
DBIT,Biotechnology,KCET,2024,68460,84804,11044,24491,188799,164308,Yes
RVCE,Data Science,COMEDK,2023,249897,87551,17171,26449,381068,354619,No
AEC,Chemical Engineering,KCET,2024,55268,71268,12990,12373,151899,139526,No
AEC,Robotics and Automation Engineering,COMEDK,2023,192764,86957,8016,19572,307309,287737,No
SITM,Artificial Intelligence and Data Science,COMEDK,2023,240788,65735,14121,28189,348833,320644,Yes
UVCE,Civil Engineering,COMEDK,2023,201326,86818,17575,13136,318855,305719,Yes
SDMCET,Biotechnology,COMEDK,2023,231812,69606,10089,14500,326007,311507,No
SITM,Data Science,COMEDK,2024,160719,68842,13095,25490,268146,242656,No
KSIT,Biotechnology,COMEDK,2024,209831,82104,17039,29455,338429,308974,Yes
RAIT,Information Science and Engineering,KCET,2024,58126,69658,15030,22376,165190,142814,Yes
DrAIT,Information Science and Engineering,KCET,2024,57412,65797,19900,25492,168601,143109,No
BNMIT,Biotechnology,COMEDK,2024,226600,68239,13335,25485,333659,308174,Yes
DrAIT,Artificial Intelligence and Data Science,COMEDK,2024,171747,90263,8391,19671,290072,270401,Yes
RIT,Data Science,COMEDK,2023,246256,92989,13100,29095,381440,352345,No
PRES,Chemical Engineering,COMEDK,2024,219521,86640,8774,11848,326783,314935,No
AIT,Data Science,KCET,2024,52105,89457,16902,14399,172863,158464,Yes
MSRUAS,Robotics and Automation Engineering,COMEDK,2023,220987,72707,10899,23108,327701,304593,Yes
DBIT,Chemical Engineering,KCET,2023,74609,87561,9946,23981,196097,172116,No
CMRIT,Artificial Intelligence and Data Science,COMEDK,2024,212201,72384,9177,24943,318705,293762,Yes
BIT,Civil Engineering,KCET,2024,72629,94984,14178,16016,197807,181791,Yes
RIT,Robotics and Automation Engineering,KCET,2024,53730,78797,11808,26492,170827,144335,Yes
NCET,Artificial Intelligence and Data Science,KCET,2023,62092,72827,8656,12557,156132,143575,No
REVA,Civil Engineering,COMEDK,2023,233547,70910,15948,10989,331394,320405,No
RVCE,Computer Science and Engineering,KCET,2023,62388,75907,19511,22484,180290,157806,Yes
AIT,Data Science,COMEDK,2024,188103,70143,15403,28808,302457,273649,Yes
DrAIT,Robotics and Automation Engineering,KCET,2023,55401,65960,8286,26838,156485,129647,Yes
VVIT,Aerospace Engineering,KCET,2023,59765,74916,8610,17030,160321,143291,Yes
RIT,Computer Science and Engineering,COMEDK,2023,170918,85243,19996,12115,288272,276157,No
KLSGIT,Electronics and Communication Engineering,KCET,2023,84923,91118,16264,27385,219690,192305,No
VSM,Civil Engineering,KCET,2023,53918,74807,16985,23638,169348,145710,Yes
PESU,Aerospace Engineering,KCET,2023,69345,70843,18949,25432,184569,159137,No
SDMIT,Electrical and Electronics Engineering,COMEDK,2023,164792,73111,15683,13349,266935,253586,No
DBIT,Information Science and Engineering,COMEDK,2023,212897,79026,9871,17659,319453,301794,Yes
BMSIT,Aerospace Engineering,KCET,2023,60629,76686,11271,22550,171136,148586,No
JIT,Mechanical Engineering,COMEDK,2024,202208,86152,8319,23230,319909,296679,Yes
BMIT,Biotechnology,COMEDK,2023,213981,73450,9498,29748,326677,296929,Yes
ACU,Aerospace Engineering,COMEDK,2024,227343,67606,10381,18811,324141,305330,No
SJBCE,Chemical Engineering,KCET,2024,51208,94125,8891,25289,179513,154224,Yes
RIT,Aerospace Engineering,COMEDK,2023,192827,88434,14306,24796,320363,295567,No
HKBK,Robotics and Automation Engineering,COMEDK,2024,166724,94235,19494,23717,304170,280453,Yes
VemanaIT,Civil Engineering,COMEDK,2023,205652,74431,14069,10258,304410,294152,Yes
PRES,Biotechnology,KCET,2024,55694,92472,17485,18070,183721,165651,No
JSSSTU,Mechanical Engineering,KCET,2023,58165,76709,11765,18844,165483,146639,No
BMSCE,Information Science and Engineering,COMEDK,2023,170099,68107,13590,27095,278891,251796,Yes
GMIT,Chemical Engineering,KCET,2024,84967,61004,17164,24162,187297,163135,Yes
JNNCE,Mechanical Engineering,KCET,2023,68183,74519,10539,20205,173446,153241,Yes
HKBK,Mechanical Engineering,KCET,2024,65930,70233,9478,24092,169733,145641,Yes
VVCE,Civil Engineering,KCET,2024,56589,76981,15618,27891,177079,149188,No
VSM,Electronics and Communication Engineering,COMEDK,2024,218323,70645,9828,23995,322791,298796,Yes
BNMIT,Electrical and Electronics Engineering,KCET,2024,55284,93916,8527,26760,184487,157727,No
AIT,Mechanical Engineering,COMEDK,2023,183441,76697,17662,11065,288865,277800,Yes
SITM,Data Science,KCET,2024,82154,62146,13053,19935,177288,157353,Yes
GMIT,Chemical Engineering,KCET,2023,81368,83551,9691,20134,194744,174610,Yes
PRES,Data Science,COMEDK,2024,227922,75592,11448,19209,334171,314962,Yes
SDMCET,Computer Science and Engineering,KCET,2024,62150,82677,11612,22787,179226,156439,No
AITM,Data Science,COMEDK,2024,181999,88324,11070,25563,306956,281393,No
MSRIT,Aerospace Engineering,KCET,2024,78169,85038,14963,18597,196767,178170,No
SIT,Electrical and Electronics Engineering,KCET,2023,58243,71555,11598,14473,155869,141396,No
HKBK,Robotics and Automation Engineering,COMEDK,2024,191620,70080,11316,11602,284618,273016,Yes
SITM,Aerospace Engineering,COMEDK,2023,169950,60064,14228,15340,259582,244242,No
RIT,Electronics and Communication Engineering,KCET,2024,66442,89252,12438,29356,197488,168132,No
SDMCET,Biotechnology,KCET,2023,72075,74738,12838,29055,188706,159651,Yes
AECMandya,Mechanical Engineering,COMEDK,2023,212129,86248,19803,27495,345675,318180,No
AITM,Biotechnology,COMEDK,2024,248231,89671,17761,21473,377136,355663,No
NMIT,Robotics and Automation Engineering,KCET,2023,65092,88025,15087,12625,180829,168204,No
AEC,Computer Science and Engineering,COMEDK,2024,216218,68545,12249,19243,316255,297012,No
RNSIT,Data Science,KCET,2024,54423,86405,10306,27246,178380,151134,No
AECMandya,Electrical and Electronics Engineering,KCET,2024,63195,65654,9877,28362,167088,138726,Yes
PRES,Computer Science and Engineering,KCET,2023,58877,68115,9619,14227,150838,136611,No
JIT,Chemical Engineering,COMEDK,2024,229167,62853,8100,15337,315457,300120,No
BMSIT,Data Science,KCET,2024,75131,88106,10063,14738,188038,173300,Yes
RVCE,Biotechnology,KCET,2024,63935,79292,8022,22689,173938,151249,Yes
MSRIT,Aerospace Engineering,COMEDK,2024,212954,66452,8654,25163,313223,288060,Yes
PESU,Biotechnology,KCET,2024,60907,68152,11775,28436,169270,140834,No
VVCE,Information Science and Engineering,KCET,2023,50324,92548,16439,25112,184423,159311,Yes
ACU,Biotechnology,KCET,2024,80925,78435,9830,12790,181980,169190,Yes
BMSIT,Data Science,KCET,2023,72014,63281,16398,25924,177617,151693,No
KSIT,Electrical and Electronics Engineering,COMEDK,2023,202177,86658,16616,19531,324982,305451,No
SITM,Chemical Engineering,KCET,2024,72731,60831,8049,12421,154032,141611,Yes
MSRUAS,Electrical and Electronics Engineering,KCET,2024,65847,77144,13747,26512,183250,156738,Yes
MVJCE,Aerospace Engineering,COMEDK,2023,237857,75519,14331,23081,350788,327707,Yes
VemanaIT,Chemical Engineering,KCET,2024,56980,91985,15810,21329,186104,164775,No
RNSIT,Information Science and Engineering,COMEDK,2024,185146,70797,11272,28289,295504,267215,Yes
KSIT,Information Science and Engineering,KCET,2024,65841,62254,11816,23034,162945,139911,No
SITM,Electronics and Communication Engineering,COMEDK,2023,177150,91937,17363,29904,316354,286450,No
RNSIT,Robotics and Automation Engineering,KCET,2023,66584,63315,12449,12900,155248,142348,Yes
RNSIT,Electrical and Electronics Engineering,COMEDK,2024,188966,69773,15744,29460,303943,274483,Yes
DBIT,Biotechnology,KCET,2023,61425,86331,14130,25011,186897,161886,No
VVIT,Computer Science and Engineering,KCET,2023,81395,89300,8914,10134,189743,179609,Yes
VemanaIT,Electrical and Electronics Engineering,KCET,2024,52967,63588,11270,21857,149682,127825,No
MVJCE,Biotechnology,KCET,2023,79397,66616,18472,13437,177922,164485,No
UVCE,Artificial Intelligence and Data Science,COMEDK,2023,189858,90845,12254,27656,320613,292957,Yes
HKBK,Information Science and Engineering,COMEDK,2023,180532,78593,12373,16330,287828,271498,No
RAIT,Data Science,COMEDK,2024,190696,77525,14774,25240,308235,282995,No
BIT,Electrical and Electronics Engineering,COMEDK,2024,204565,67194,11937,24273,307969,283696,Yes
AECMandya,Computer Science and Engineering,KCET,2023,50608,88015,10368,24629,173620,148991,Yes
JNNCE,Artificial Intelligence and Data Science,COMEDK,2024,188892,72655,19767,21817,303131,281314,Yes
RNSIT,Information Science and Engineering,KCET,2023,67812,63860,8096,26523,166291,139768,Yes
JNNCE,Information Science and Engineering,COMEDK,2023,242804,60651,18654,14416,336525,322109,No
MVJCE,Mechanical Engineering,KCET,2024,84270,74584,12214,22249,193317,171068,No
MVJCE,Artificial Intelligence and Data Science,KCET,2024,61887,71062,11008,15907,159864,143957,No
BMSIT,Information Science and Engineering,COMEDK,2024,202326,72160,11791,11366,297643,286277,No
MSRUAS,Information Science and Engineering,KCET,2023,76814,73619,10827,26994,188254,161260,Yes
BIT,Computer Science and Engineering,KCET,2023,66556,79644,10432,21991,178623,156632,Yes
SDMCET,Biotechnology,KCET,2023,78524,87082,12191,16190,193987,177797,No
MSRIT,Data Science,KCET,2023,76058,75554,11562,13349,176523,163174,Yes
CITGubbi,Mechanical Engineering,COMEDK,2023,221764,65335,10776,28051,325926,297875,Yes
BITM,Aerospace Engineering,COMEDK,2023,206448,79880,15233,20393,321954,301561,Yes
BMSIT,Information Science and Engineering,COMEDK,2024,217959,78930,10479,23163,330531,307368,No
SITM,Computer Science and Engineering,KCET,2024,65608,82279,12020,15591,175498,159907,Yes
BMSCE,Mechanical Engineering,COMEDK,2023,227936,89933,14589,26159,358617,332458,No
HKBK,Information Science and Engineering,KCET,2023,72552,85517,15348,16598,190015,173417,No
VemanaIT,Electronics and Communication Engineering,COMEDK,2024,214384,72625,11876,24454,323339,298885,Yes
VIT,Aerospace Engineering,COMEDK,2023,231200,82776,8856,27872,350704,322832,Yes
SDMCET,Chemical Engineering,KCET,2024,70289,63142,9433,24474,167338,142864,Yes
AEC,Electronics and Communication Engineering,COMEDK,2024,232490,78678,9855,23921,344944,321023,Yes
GMIT,Electronics and Communication Engineering,KCET,2024,64216,74456,10543,14701,163916,149215,No
NIE,Electronics and Communication Engineering,KCET,2024,81847,63619,17733,14439,177638,163199,No
RAIT,Artificial Intelligence and Data Science,COMEDK,2023,205545,92999,19464,19147,337155,318008,No
ACU,Aerospace Engineering,COMEDK,2024,188259,91018,8537,24369,312183,287814,No
VVCE,Electronics and Communication Engineering,KCET,2023,56528,90856,16268,26785,190437,163652,Yes
MVJCE,Artificial Intelligence and Data Science,COMEDK,2024,204022,88539,19624,10157,322342,312185,Yes
JSSSTU,Civil Engineering,COMEDK,2023,230376,69565,16566,18884,335391,316507,Yes
VVCE,Electronics and Communication Engineering,KCET,2023,50462,90131,10503,19828,170924,151096,Yes
RVUNIV,Computer Science and Engineering,COMEDK,2024,196265,93060,14928,22243,326496,304253,Yes
KLEIT,Information Science and Engineering,KCET,2024,69764,78976,17244,15985,181969,165984,Yes
KLSGIT,Electronics and Communication Engineering,COMEDK,2023,205072,85999,8294,10219,309584,299365,Yes
BMIT,Electrical and Electronics Engineering,KCET,2023,72604,91204,9799,15801,189408,173607,No
BMIT,Robotics and Automation Engineering,COMEDK,2024,177491,60169,11872,21538,271070,249532,No
BNMIT,Electronics and Communication Engineering,KCET,2023,84874,78079,17781,14275,195009,180734,No
DBIT,Aerospace Engineering,KCET,2024,55150,85156,15051,19096,174453,155357,No
CITGubbi,Computer Science and Engineering,COMEDK,2024,188510,84128,13669,15861,302168,286307,Yes
KSIT,Electrical and Electronics Engineering,COMEDK,2024,175882,91725,9316,10152,287075,276923,No
AECMandya,Electronics and Communication Engineering,COMEDK,2023,174233,66747,17238,26108,284326,258218,No
GMIT,Computer Science and Engineering,KCET,2023,73916,78002,9907,28181,190006,161825,No
ACU,Aerospace Engineering,KCET,2024,57173,81201,12940,15998,167312,151314,Yes
AEC,Data Science,COMEDK,2023,194170,87622,8270,13906,303968,290062,Yes
PESU,Chemical Engineering,KCET,2024,73224,75397,9549,25606,183776,158170,No
CITGubbi,Civil Engineering,COMEDK,2023,234698,78027,19023,11219,342967,331748,Yes
KSIT,Electrical and Electronics Engineering,KCET,2023,54428,91099,11879,14657,172063,157406,No
AIT,Data Science,COMEDK,2024,245700,84782,16941,29830,377253,347423,No
VVIT,Information Science and Engineering,COMEDK,2023,249697,70147,15490,13936,349270,335334,No
RNSIT,Electrical and Electronics Engineering,COMEDK,2024,244374,61319,8503,21899,336095,314196,No
KLEIT,Chemical Engineering,KCET,2023,61184,68368,16390,18103,164045,145942,Yes
BNMIT,Electrical and Electronics Engineering,COMEDK,2023,184288,92716,10349,25223,312576,287353,Yes
VVCE,Aerospace Engineering,COMEDK,2024,172059,91503,8884,21525,293971,272446,No
SDMCET,Biotechnology,COMEDK,2023,201596,71387,16606,20425,310014,289589,Yes
NMIT,Mechanical Engineering,KCET,2024,52731,76861,12659,13918,156169,142251,No
DSATM,Electronics and Communication Engineering,COMEDK,2023,187831,89647,18336,12013,307827,295814,Yes
DSCE,Artificial Intelligence and Data Science,COMEDK,2023,247907,93650,18918,10693,371168,360475,No
GIT,Aerospace Engineering,KCET,2023,81289,87578,10305,24101,203273,179172,Yes
PESCE,Information Science and Engineering,KCET,2024,70918,71823,19324,20622,182687,162065,No
RVCE,Chemical Engineering,COMEDK,2024,171763,70913,17351,20341,280368,260027,No
DSATM,Electrical and Electronics Engineering,KCET,2023,76427,92777,12537,17326,199067,181741,Yes
SDMCET,Computer Science and Engineering,COMEDK,2024,243309,79142,15448,11838,349737,337899,Yes
KSIT,Data Science,COMEDK,2024,187949,91912,17481,16957,314299,297342,No
MSRUAS,Computer Science and Engineering,COMEDK,2023,226806,79056,17463,23192,346517,323325,No
NMIT,Aerospace Engineering,COMEDK,2024,166545,75805,16996,29895,289241,259346,Yes
HKBK,Aerospace Engineering,COMEDK,2024,185839,87182,14534,10403,297958,287555,Yes
PESU,Chemical Engineering,COMEDK,2024,226767,86272,17048,20011,350098,330087,Yes
BMIT,Information Science and Engineering,COMEDK,2023,167327,85639,10222,18438,281626,263188,No
JNNCE,Information Science and Engineering,KCET,2024,50651,69722,17343,13309,151025,137716,No
SJBIT,Civil Engineering,KCET,2023,51755,87817,18158,28171,185901,157730,Yes
NHCE,Electronics and Communication Engineering,KCET,2024,79600,90222,14107,21443,205372,183929,Yes
JNNCE,Robotics and Automation Engineering,COMEDK,2023,174434,84821,8227,23227,290709,267482,Yes
PRES,Civil Engineering,KCET,2024,74866,70860,12370,23114,181210,158096,Yes
SJBCE,Aerospace Engineering,COMEDK,2023,162038,86306,14853,13696,276893,263197,No
VVIT,Civil Engineering,KCET,2023,72385,64642,8712,26778,172517,145739,Yes
BNMIT,Aerospace Engineering,KCET,2023,59726,79199,10862,13965,163752,149787,Yes
SJBIT,Mechanical Engineering,KCET,2024,81086,64432,18841,22172,186531,164359,Yes
GMIT,Civil Engineering,COMEDK,2023,182205,88193,13711,20625,304734,284109,No
DrAIT,Artificial Intelligence and Data Science,COMEDK,2024,241365,81395,11851,20627,355238,334611,Yes
SCEM,Mechanical Engineering,COMEDK,2023,210535,85623,17716,18209,332083,313874,Yes
RAIT,Aerospace Engineering,KCET,2023,77002,64106,18107,13152,172367,159215,No
KLSGIT,Mechanical Engineering,KCET,2023,68165,72030,14495,18707,173397,154690,No
AIT,Computer Science and Engineering,KCET,2024,55626,93014,14123,21030,183793,162763,No
GMIT,Chemical Engineering,KCET,2023,65813,66631,15489,10911,158844,147933,Yes
SJBIT,Electrical and Electronics Engineering,KCET,2023,70720,63361,13085,17558,164724,147166,Yes
SITM,Electrical and Electronics Engineering,COMEDK,2024,180601,80976,12920,25851,300348,274497,No
MVJCE,Information Science and Engineering,COMEDK,2023,200637,70001,13708,26169,310515,284346,No
RVUNIV,Mechanical Engineering,KCET,2024,53154,79339,11112,24074,167679,143605,Yes
CITGubbi,Robotics and Automation Engineering,KCET,2023,76182,92754,17624,19698,206258,186560,No
GMIT,Artificial Intelligence and Data Science,COMEDK,2024,223446,76503,16472,13371,329792,316421,Yes
CMRIT,Aerospace Engineering,COMEDK,2023,197409,94516,10012,17710,319647,301937,No
REVA,Computer Science and Engineering,KCET,2024,57251,64970,18042,11355,151618,140263,No
RNSIT,Information Science and Engineering,COMEDK,2023,186695,62377,12812,24619,286503,261884,No
SJBCE,Electronics and Communication Engineering,COMEDK,2023,160193,93425,12722,18991,285331,266340,Yes
RIT,Artificial Intelligence and Data Science,KCET,2023,62458,73118,10506,15681,161763,146082,Yes
NCET,Computer Science and Engineering,COMEDK,2024,246691,72361,10299,11053,340404,329351,Yes
REVA,Civil Engineering,KCET,2024,64329,77995,14718,24994,182036,157042,No
MSRUAS,Electrical and Electronics Engineering,KCET,2023,69701,93869,19013,25205,207788,182583,Yes
SITM,Aerospace Engineering,KCET,2023,72755,93942,19353,16608,202658,186050,No
BIT,Biotechnology,COMEDK,2024,240476,94803,17245,16600,369124,352524,Yes
AITM,Electrical and Electronics Engineering,COMEDK,2023,242253,71402,9007,22028,344690,322662,No
PESU,Electronics and Communication Engineering,KCET,2024,71864,60904,14876,18227,165871,147644,Yes
RIT,Biotechnology,COMEDK,2023,243259,79783,19079,19990,362111,342121,No
BMIT,Biotechnology,COMEDK,2024,232073,66201,15469,16146,329889,313743,No
JSSSTU,Biotechnology,COMEDK,2024,244562,80754,11233,19004,355553,336549,Yes
NMIT,Electrical and Electronics Engineering,COMEDK,2024,160750,88458,19937,23745,292890,269145,No
MSRUAS,Data Science,COMEDK,2023,244773,79284,17385,18894,360336,341442,No
CMRIT,Artificial Intelligence and Data Science,COMEDK,2023,221841,82298,10780,22599,337518,314919,No
KSIT,Biotechnology,KCET,2024,84256,67806,8639,28918,189619,160701,Yes
AEC,Electrical and Electronics Engineering,COMEDK,2024,175509,85004,19622,29052,309187,280135,No
SDMIT,Aerospace Engineering,KCET,2023,67946,66304,19030,24364,177644,153280,Yes
SITM,Aerospace Engineering,COMEDK,2023,170783,89597,13864,23215,297459,274244,No
BIT,Computer Science and Engineering,KCET,2023,73283,65523,15423,21435,175664,154229,Yes
BIT,Robotics and Automation Engineering,KCET,2024,58479,86987,11304,27280,184050,156770,No
JNNCE,Electrical and Electronics Engineering,COMEDK,2024,241284,62876,17158,27218,348536,321318,Yes
BMSCE,Biotechnology,KCET,2024,54648,87383,8340,15048,165419,150371,Yes
JSSSTU,Computer Science and Engineering,KCET,2023,76526,91400,19598,19619,207143,187524,Yes
DBIT,Chemical Engineering,COMEDK,2024,206794,85981,15082,11908,319765,307857,Yes
VIT,Electronics and Communication Engineering,KCET,2023,69728,77814,17702,29590,194834,165244,No
VVCE,Aerospace Engineering,COMEDK,2023,198397,61560,8061,19842,287860,268018,Yes
RVUNIV,Electronics and Communication Engineering,COMEDK,2024,238020,75453,19649,23313,356435,333122,No
RVCE,Electronics and Communication Engineering,COMEDK,2024,245168,69735,19445,26994,361342,334348,Yes
BMSIT,Computer Science and Engineering,COMEDK,2024,248103,66922,18884,14685,348594,333909,Yes
SCEM,Biotechnology,KCET,2023,69749,94356,14162,25143,203410,178267,Yes
AEC,Information Science and Engineering,COMEDK,2024,230705,78598,14608,21636,345547,323911,Yes
RNSIT,Biotechnology,COMEDK,2023,226395,60642,13956,27096,328089,300993,Yes
GIT,Information Science and Engineering,KCET,2024,82287,69843,13701,19553,185384,165831,Yes
EastPoint,Biotechnology,KCET,2023,60852,80368,17145,16088,174453,158365,Yes
GMIT,Electrical and Electronics Engineering,KCET,2024,81084,90614,12536,21739,205973,184234,Yes
KLEIT,Computer Science and Engineering,KCET,2023,72729,76338,17874,27686,194627,166941,No
JSSSTU,Artificial Intelligence and Data Science,COMEDK,2024,205117,72893,16642,28306,322958,294652,Yes
AECMandya,Electrical and Electronics Engineering,KCET,2023,56567,72737,19548,11548,160400,148852,Yes
RIT,Information Science and Engineering,KCET,2024,59528,85863,11412,22234,179037,156803,No
UVCE,Computer Science and Engineering,COMEDK,2023,170877,70837,15498,21841,279053,257212,No
RNSIT,Biotechnology,KCET,2024,80583,62812,18931,20748,183074,162326,No
KSIT,Electrical and Electronics Engineering,COMEDK,2023,197089,65252,10172,14262,286775,272513,Yes
PESCE,Computer Science and Engineering,KCET,2024,67274,69766,11963,12714,161717,149003,No
AEC,Biotechnology,COMEDK,2023,234256,66421,13667,28100,342444,314344,Yes
JSSSTU,Civil Engineering,COMEDK,2024,190472,64242,16970,24280,295964,271684,No
RVCE,Electronics and Communication Engineering,KCET,2024,79777,64180,8625,18484,171066,152582,Yes
NCET,Artificial Intelligence and Data Science,COMEDK,2023,210272,92001,8610,11923,322806,310883,No
SDMIT,Biotechnology,COMEDK,2024,197386,73520,10614,21933,303453,281520,No
NCET,Information Science and Engineering,COMEDK,2024,206617,82234,19122,25687,333660,307973,No
VemanaIT,Chemical Engineering,COMEDK,2023,210544,78646,10029,10854,310073,299219,Yes
RVUNIV,Robotics and Automation Engineering,COMEDK,2024,192509,62441,19924,21835,296709,274874,No
RNSIT,Electronics and Communication Engineering,COMEDK,2023,173792,75830,15372,23724,288718,264994,Yes
BNMIT,Robotics and Automation Engineering,KCET,2024,75201,60005,19920,21328,176454,155126,Yes
SJBCE,Computer Science and Engineering,KCET,2023,79458,90269,12449,11014,193190,182176,No
REVA,Electrical and Electronics Engineering,KCET,2024,63207,87368,15039,24609,190223,165614,No
YKCE,Mechanical Engineering,KCET,2023,80591,75713,19131,27986,203421,175435,Yes
MSRIT,Electronics and Communication Engineering,KCET,2024,52854,84643,16162,28837,182496,153659,No
BIT,Data Science,COMEDK,2024,187470,73394,10718,21779,293361,271582,No
DBIT,Computer Science and Engineering,KCET,2023,57128,85183,11581,25890,179782,153892,No
CMRIT,Aerospace Engineering,KCET,2024,61645,87130,16432,24660,189867,165207,Yes
BMSIT,Civil Engineering,COMEDK,2024,205126,78491,15731,28394,327742,299348,Yes
NCET,Chemical Engineering,COMEDK,2023,232952,80997,8376,20727,343052,322325,No
VSM,Aerospace Engineering,KCET,2023,78687,78835,16363,20908,194793,173885,Yes
PRES,Robotics and Automation Engineering,COMEDK,2024,224774,83942,19816,11028,339560,328532,No
VIT,Civil Engineering,COMEDK,2024,171280,70190,10284,22284,274038,251754,No
MVJCE,Civil Engineering,KCET,2024,70718,94708,17815,12459,195700,183241,No
SJBCE,Electronics and Communication Engineering,KCET,2024,76925,77315,8570,19896,182706,162810,Yes
VVCE,Biotechnology,COMEDK,2023,216954,71199,17556,16156,321865,305709,Yes
REVA,Civil Engineering,COMEDK,2023,208685,65376,12266,24046,310373,286327,No
GIT,Electrical and Electronics Engineering,KCET,2024,52928,67956,11581,26431,158896,132465,Yes
EastPoint,Civil Engineering,KCET,2023,51988,79093,9787,14462,155330,140868,No
BMSIT,Robotics and Automation Engineering,KCET,2023,57312,62853,9870,22439,152474,130035,No
NMIT,Civil Engineering,KCET,2024,59584,79354,15046,23985,177969,153984,Yes
BMSCE,Mechanical Engineering,COMEDK,2024,235121,85584,17309,27858,365872,338014,No
AEC,Civil Engineering,KCET,2023,76513,85047,15840,26573,203973,177400,Yes
DSATM,Electrical and Electronics Engineering,KCET,2024,81434,81327,14394,18607,195762,177155,Yes
VIT,Robotics and Automation Engineering,COMEDK,2024,160497,81069,9713,21411,272690,251279,Yes
UVCE,Biotechnology,COMEDK,2024,202008,82206,19838,18089,322141,304052,No
NMIT,Data Science,KCET,2023,58309,67274,13732,29363,168678,139315,No
BMIT,Electronics and Communication Engineering,KCET,2024,69263,74706,12247,15519,171735,156216,No
SITM,Electrical and Electronics Engineering,KCET,2024,62535,75308,19497,28623,185963,157340,No
RVCE,Biotechnology,COMEDK,2023,232275,62275,11328,17473,323351,305878,Yes
NCET,Information Science and Engineering,KCET,2024,78338,66613,17718,20147,182816,162669,Yes
VVIT,Computer Science and Engineering,KCET,2023,78198,83131,8484,15167,184980,169813,No
PESCE,Biotechnology,COMEDK,2024,242137,65273,18433,24343,350186,325843,No
YKCE,Chemical Engineering,KCET,2023,56083,71177,8806,29971,166037,136066,Yes
AIT,Civil Engineering,KCET,2024,77182,71717,17851,20631,187381,166750,No
NCET,Artificial Intelligence and Data Science,KCET,2024,61824,79781,8124,23241,172970,149729,No
EastPoint,Biotechnology,KCET,2023,84442,87128,10354,23791,205715,181924,No
PESU,Robotics and Automation Engineering,KCET,2024,57166,94304,14152,26816,192438,165622,No
KSIT,Electronics and Communication Engineering,COMEDK,2024,218946,89259,9660,11135,329000,317865,Yes
KSIT,Computer Science and Engineering,KCET,2024,65434,91593,10286,18099,185412,167313,No
MSRIT,Mechanical Engineering,COMEDK,2024,223893,76477,18325,15210,333905,318695,Yes
ACU,Information Science and Engineering,COMEDK,2023,245645,60956,10068,16759,333428,316669,No
NMIT,Robotics and Automation Engineering,COMEDK,2024,225954,65662,18434,22689,332739,310050,No
YKCE,Electronics and Communication Engineering,COMEDK,2023,172564,84638,11635,11934,280771,268837,Yes
SDMIT,Electrical and Electronics Engineering,COMEDK,2023,196011,75764,16060,21361,309196,287835,Yes
RNSIT,Information Science and Engineering,KCET,2024,74827,89079,16674,22761,203341,180580,Yes
RIT,Aerospace Engineering,KCET,2023,62482,62721,8695,20369,154267,133898,Yes
DSATM,Robotics and Automation Engineering,KCET,2024,66725,60946,10127,17051,154849,137798,Yes
SDMIT,Electrical and Electronics Engineering,KCET,2023,53959,94853,9613,23166,181591,158425,No
VemanaIT,Electrical and Electronics Engineering,KCET,2023,51554,85863,17342,24417,179176,154759,Yes
MSRIT,Robotics and Automation Engineering,KCET,2023,77774,86985,9181,22327,196267,173940,Yes
ACU,Computer Science and Engineering,KCET,2024,64524,73693,11788,28501,178506,150005,No
MSRIT,Biotechnology,COMEDK,2024,202339,62492,19550,28886,313267,284381,No
AEC,Biotechnology,COMEDK,2023,225157,69592,16205,10395,321349,310954,No
BNMIT,Robotics and Automation Engineering,KCET,2024,66539,73060,18681,19297,177577,158280,No
KLEIT,Biotechnology,COMEDK,2023,199683,78481,13890,20740,312794,292054,No
VIT,Computer Science and Engineering,KCET,2023,57647,71881,14531,15575,159634,144059,Yes
MSRIT,Computer Science and Engineering,COMEDK,2023,228936,89514,12343,23427,354220,330793,No
BMSCE,Information Science and Engineering,KCET,2024,55534,66326,17344,12324,151528,139204,Yes
JSSSTU,Aerospace Engineering,COMEDK,2024,171136,80070,8186,12750,272142,259392,No
VVIT,Aerospace Engineering,KCET,2023,62348,91889,15904,28625,198766,170141,No
UVCE,Electronics and Communication Engineering,COMEDK,2024,183150,62102,14010,11802,271064,259262,Yes
REVA,Mechanical Engineering,KCET,2024,83289,75940,18674,18630,196533,177903,Yes
BMIT,Computer Science and Engineering,COMEDK,2024,219170,81143,16617,26540,343470,316930,Yes
YKCE,Aerospace Engineering,KCET,2023,51702,79580,14679,16426,162387,145961,Yes
SITM,Electronics and Communication Engineering,KCET,2023,72645,66970,12394,28660,180669,152009,Yes
AIT,Civil Engineering,COMEDK,2024,201305,89736,9316,18823,319180,300357,No
DSCE,Mechanical Engineering,COMEDK,2023,208748,72413,9190,26177,316528,290351,Yes
AIT,Aerospace Engineering,KCET,2023,84035,69025,11602,11330,175992,164662,No
AITM,Chemical Engineering,COMEDK,2024,179238,71025,18705,16018,284986,268968,Yes
BNMIT,Electrical and Electronics Engineering,COMEDK,2024,214822,74783,18964,12807,321376,308569,No
GIT,Information Science and Engineering,COMEDK,2024,196647,77638,14194,18389,306868,288479,No
SJBIT,Aerospace Engineering,COMEDK,2024,240210,60315,9048,10785,320358,309573,Yes
VemanaIT,Civil Engineering,COMEDK,2024,187876,61127,11601,18228,278832,260604,No
AECMandya,Electrical and Electronics Engineering,KCET,2023,66265,75556,11631,27626,181078,153452,Yes
KLSGIT,Computer Science and Engineering,COMEDK,2024,205504,87855,17098,14526,324983,310457,Yes
CITGubbi,Biotechnology,COMEDK,2024,170502,66094,16244,17046,269886,252840,No
EastPoint,Electrical and Electronics Engineering,KCET,2024,68256,61336,13396,26792,169780,142988,Yes
PESCE,Robotics and Automation Engineering,KCET,2023,58531,72768,13275,28437,173011,144574,Yes
RNSIT,Artificial Intelligence and Data Science,KCET,2024,61114,83349,14257,20151,178871,158720,Yes
DBIT,Chemical Engineering,KCET,2023,78950,86908,14737,19138,199733,180595,No
MVJCE,Information Science and Engineering,COMEDK,2024,221668,76267,16058,25179,339172,313993,Yes
DSATM,Data Science,KCET,2023,76653,88400,12205,19280,196538,177258,Yes
BMSIT,Biotechnology,COMEDK,2023,237107,79992,15991,22312,355402,333090,No
ACU,Information Science and Engineering,KCET,2023,69951,62945,10636,16605,160137,143532,Yes
SDMCET,Data Science,COMEDK,2024,163434,91735,13369,16091,284629,268538,No
MVJCE,Chemical Engineering,KCET,2023,62628,90217,18000,12634,183479,170845,Yes
MSRIT,Computer Science and Engineering,COMEDK,2023,176625,92209,16578,25423,310835,285412,Yes
RAIT,Artificial Intelligence and Data Science,KCET,2023,57328,80266,19286,29829,186709,156880,No
DrAIT,Chemical Engineering,COMEDK,2023,161264,85012,8767,15866,270909,255043,No
RVUNIV,Civil Engineering,KCET,2024,77830,76067,17341,25095,196333,171238,No
JNNCE,Biotechnology,KCET,2023,60680,61348,13153,17992,153173,135181,Yes
MSRUAS,Chemical Engineering,COMEDK,2023,166447,78725,11144,20417,276733,256316,Yes
RVUNIV,Chemical Engineering,KCET,2024,53487,70190,10284,28784,162745,133961,No
EastPoint,Information Science and Engineering,COMEDK,2024,188298,74624,11678,15639,290239,274600,No
JNNCE,Computer Science and Engineering,COMEDK,2023,202811,78987,10887,11830,304515,292685,Yes
KLSGIT,Data Science,KCET,2024,75385,80711,18987,11548,186631,175083,Yes
SDMIT,Robotics and Automation Engineering,KCET,2023,82542,86451,14657,13334,196984,183650,Yes
VVIT,Robotics and Automation Engineering,COMEDK,2024,213078,61063,18615,11986,304742,292756,No
VemanaIT,Computer Science and Engineering,KCET,2024,84180,84835,12677,25526,207218,181692,No
RVUNIV,Mechanical Engineering,KCET,2024,62681,69848,18468,26938,177935,150997,No
SCEM,Information Science and Engineering,KCET,2024,73192,89277,17156,22268,201893,179625,Yes
AECMandya,Artificial Intelligence and Data Science,COMEDK,2023,242537,80684,11085,12846,347152,334306,Yes
SDMCET,Information Science and Engineering,KCET,2024,51848,67076,19512,18489,156925,138436,Yes
VIT,Artificial Intelligence and Data Science,COMEDK,2023,248299,86761,13887,21374,370321,348947,Yes
JSSSTU,Artificial Intelligence and Data Science,COMEDK,2024,229167,85714,19794,24971,359646,334675,No
BNMIT,Electronics and Communication Engineering,KCET,2024,66443,88790,9121,15771,180125,164354,No
CMRIT,Robotics and Automation Engineering,KCET,2023,83022,71802,14684,13071,182579,169508,No
PESCE,Robotics and Automation Engineering,KCET,2024,80896,74196,13214,10722,179028,168306,No
RVUNIV,Artificial Intelligence and Data Science,KCET,2024,58464,60904,14510,19250,153128,133878,Yes
SJBIT,Civil Engineering,KCET,2024,56665,69668,10499,21812,158644,136832,No
MVJCE,Data Science,KCET,2023,53400,83912,8499,17810,163621,145811,No
DSCE,Civil Engineering,KCET,2024,56109,74720,16159,13438,160426,146988,No
JSSSTU,Biotechnology,COMEDK,2024,196026,87315,19331,16941,319613,302672,No
JSSSTU,Electrical and Electronics Engineering,COMEDK,2023,199735,64803,18582,26256,309376,283120,No
EastPoint,Mechanical Engineering,KCET,2023,61343,83287,15066,16032,175728,159696,No
BIT,Computer Science and Engineering,KCET,2023,68894,93730,15382,25541,203547,178006,Yes
SDMIT,Aerospace Engineering,COMEDK,2024,181743,84428,14489,21020,301680,280660,No
DBIT,Aerospace Engineering,KCET,2024,80161,89256,10193,29669,209279,179610,No
KSIT,Electrical and Electronics Engineering,COMEDK,2023,238100,64165,11464,24416,338145,313729,Yes
MSRIT,Robotics and Automation Engineering,COMEDK,2024,201787,62631,13056,15754,293228,277474,No
SIT,Chemical Engineering,KCET,2023,72460,74482,12159,25510,184611,159101,Yes
BITM,Computer Science and Engineering,KCET,2024,76055,91321,13977,11533,192886,181353,Yes
NMIT,Chemical Engineering,KCET,2023,71111,93238,11380,20866,196595,175729,No
BITM,Aerospace Engineering,COMEDK,2024,234459,77425,18593,13403,343880,330477,Yes
VSM,Electronics and Communication Engineering,KCET,2023,50079,90872,8595,29177,178723,149546,No
HKBK,Electrical and Electronics Engineering,COMEDK,2023,240080,93445,17715,26149,377389,351240,No
NMIT,Aerospace Engineering,COMEDK,2024,202794,70955,19759,14254,307762,293508,No
RIT,Electrical and Electronics Engineering,KCET,2024,69991,60466,18092,10260,158809,148549,Yes
BNMIT,Computer Science and Engineering,COMEDK,2023,173557,67518,19112,23746,283933,260187,No
YKCE,Chemical Engineering,KCET,2024,75203,80900,13758,15072,184933,169861,No
BNMIT,Artificial Intelligence and Data Science,COMEDK,2024,165351,70339,9057,13507,258254,244747,Yes
AECMandya,Data Science,KCET,2023,70986,63270,18699,11048,164003,152955,Yes
AIT,Aerospace Engineering,KCET,2023,57636,87069,18877,16755,180337,163582,Yes
BMIT,Electronics and Communication Engineering,KCET,2024,64263,67405,13809,28209,173686,145477,Yes
JNNCE,Mechanical Engineering,COMEDK,2023,170984,81030,13955,23655,289624,265969,Yes
NIE,Computer Science and Engineering,KCET,2023,65998,69415,17665,15810,168888,153078,No
PRES,Electrical and Electronics Engineering,KCET,2024,79667,85789,14336,18791,198583,179792,Yes
GIT,Aerospace Engineering,COMEDK,2024,203404,85127,8688,24692,321911,297219,No
RVUNIV,Mechanical Engineering,KCET,2024,79612,83108,10360,24098,197178,173080,No
VSM,Information Science and Engineering,COMEDK,2024,178717,74757,10794,15920,280188,264268,Yes
YKCE,Electrical and Electronics Engineering,KCET,2023,57059,84395,17645,14560,173659,159099,No
AECMandya,Electrical and Electronics Engineering,COMEDK,2024,211452,90703,9221,14028,325404,311376,Yes
NHCE,Chemical Engineering,COMEDK,2024,212364,63610,8647,10993,295614,284621,No
MVJCE,Aerospace Engineering,COMEDK,2023,182448,75344,14645,25117,297554,272437,No
AEC,Chemical Engineering,KCET,2023,64276,80877,8479,26261,179893,153632,Yes
VSM,Mechanical Engineering,COMEDK,2024,208975,91751,8098,21262,330086,308824,Yes
BIT,Mechanical Engineering,KCET,2023,60449,79572,11606,12793,164420,151627,No
HKBK,Mechanical Engineering,COMEDK,2023,198028,70702,15500,20177,304407,284230,No
CMRIT,Information Science and Engineering,KCET,2023,81014,80695,10553,18482,190744,172262,Yes
ACU,Computer Science and Engineering,KCET,2023,61019,73896,9387,11099,155401,144302,No
RIT,Aerospace Engineering,COMEDK,2024,177121,75346,15734,29294,297495,268201,No
PESCE,Electronics and Communication Engineering,KCET,2023,72538,84205,14671,18035,189449,171414,No
DrAIT,Electrical and Electronics Engineering,COMEDK,2024,193293,78570,9967,15491,297321,281830,Yes
VemanaIT,Aerospace Engineering,KCET,2023,60611,67684,9671,10292,148258,137966,No
DBIT,Information Science and Engineering,COMEDK,2023,248243,69697,13461,10125,341526,331401,Yes
RIT,Civil Engineering,COMEDK,2023,248316,90213,16356,11416,366301,354885,Yes
RVUNIV,Robotics and Automation Engineering,COMEDK,2023,240427,74687,18754,16918,350786,333868,No
NIE,Information Science and Engineering,KCET,2024,64858,68693,16756,28968,179275,150307,No
GIT,Civil Engineering,COMEDK,2024,172413,68159,16902,16361,273835,257474,No
BMSCE,Electrical and Electronics Engineering,KCET,2024,80424,92587,13032,23722,209765,186043,No
MSRUAS,Electronics and Communication Engineering,KCET,2023,66692,89864,16883,18642,192081,173439,No
MVJCE,Computer Science and Engineering,KCET,2023,61401,60186,12783,27820,162190,134370,No
BMIT,Civil Engineering,KCET,2024,60394,87458,18466,10016,176334,166318,Yes
SIT,Data Science,COMEDK,2024,170400,83279,11402,27304,292385,265081,No
BIT,Computer Science and Engineering,COMEDK,2024,177183,66099,10014,23145,276441,253296,Yes
AIT,Chemical Engineering,COMEDK,2023,224621,77640,14474,13690,330425,316735,Yes
AECMandya,Electronics and Communication Engineering,KCET,2023,64053,73275,19203,22966,179497,156531,No
JSSSTU,Robotics and Automation Engineering,COMEDK,2023,204001,68645,14419,21898,308963,287065,No
VVCE,Mechanical Engineering,KCET,2024,73963,60141,8868,28872,171844,142972,Yes
SITM,Civil Engineering,KCET,2023,66345,74057,10084,12516,163002,150486,Yes
VVCE,Electrical and Electronics Engineering,COMEDK,2023,172100,92116,10081,10717,285014,274297,Yes
YKCE,Information Science and Engineering,COMEDK,2023,216099,65809,14365,11992,308265,296273,No
HKBK,Computer Science and Engineering,KCET,2024,58915,74174,8473,25625,167187,141562,Yes
PESCE,Civil Engineering,COMEDK,2023,177143,60153,18177,21104,276577,255473,No
HKBK,Chemical Engineering,KCET,2023,66469,81920,17042,18551,183982,165431,Yes
DSATM,Computer Science and Engineering,COMEDK,2024,170941,72321,16593,28660,288515,259855,Yes
SJBIT,Mechanical Engineering,COMEDK,2023,217794,72064,13388,27930,331176,303246,No
GIT,Civil Engineering,COMEDK,2024,198834,81480,11235,10559,302108,291549,No
NIE,Civil Engineering,COMEDK,2024,222669,75749,9271,23796,331485,307689,No
DBIT,Mechanical Engineering,KCET,2024,53647,93411,11821,27191,186070,158879,Yes
PESU,Data Science,COMEDK,2024,224559,91366,17677,16967,350569,333602,Yes
GMIT,Civil Engineering,KCET,2023,68717,89037,10358,18073,186185,168112,Yes
DSCE,Mechanical Engineering,KCET,2023,81033,84876,8848,28035,202792,174757,Yes
SJBCE,Biotechnology,COMEDK,2024,164659,69808,11986,25283,271736,246453,No
KSIT,Electrical and Electronics Engineering,KCET,2023,76630,67843,13048,11997,169518,157521,No
KSIT,Biotechnology,KCET,2024,60276,63254,9129,24583,157242,132659,No
BITM,Artificial Intelligence and Data Science,KCET,2024,77360,60429,15608,28672,182069,153397,No
BNMIT,Robotics and Automation Engineering,KCET,2023,50171,83385,12738,20709,167003,146294,Yes
KLEIT,Electronics and Communication Engineering,COMEDK,2023,229938,67505,15885,24052,337380,313328,Yes
VVCE,Civil Engineering,KCET,2024,84381,71133,8683,22182,186379,164197,Yes
VemanaIT,Civil Engineering,KCET,2023,64534,77862,19245,15542,177183,161641,No
DrAIT,Aerospace Engineering,COMEDK,2024,167665,78851,18637,11854,277007,265153,No
NCET,Electrical and Electronics Engineering,COMEDK,2024,222906,68447,8517,29370,329240,299870,No
DSCE,Aerospace Engineering,COMEDK,2023,165494,83892,11753,29531,290670,261139,Yes
HKBK,Data Science,KCET,2024,61992,78242,12988,28564,181786,153222,No
CITGubbi,Data Science,COMEDK,2024,183507,60407,14751,15098,273763,258665,Yes
AECMandya,Robotics and Automation Engineering,COMEDK,2024,220888,60077,16027,27444,324436,296992,Yes
SCEM,Computer Science and Engineering,COMEDK,2024,161569,76909,11713,20069,270260,250191,Yes
NIE,Robotics and Automation Engineering,COMEDK,2023,226271,65223,10945,21016,323455,302439,Yes
NCET,Electronics and Communication Engineering,KCET,2023,73020,93264,8017,29820,204121,174301,No
KLEIT,Biotechnology,KCET,2024,56047,63954,12660,10656,143317,132661,Yes
RAIT,Robotics and Automation Engineering,COMEDK,2023,243846,76690,17819,19862,358217,338355,Yes
UVCE,Civil Engineering,COMEDK,2024,184382,80942,8198,24575,298097,273522,No
JIT,Robotics and Automation Engineering,COMEDK,2023,218634,65040,11951,14252,309877,295625,Yes
JSSSTU,Information Science and Engineering,COMEDK,2023,226335,84085,9229,17683,337332,319649,No
CITGubbi,Computer Science and Engineering,COMEDK,2023,185225,92175,16461,19261,313122,293861,No
RVUNIV,Aerospace Engineering,COMEDK,2024,246543,77120,14831,10020,348514,338494,No
VIT,Civil Engineering,KCET,2024,66169,85054,13811,14015,179049,165034,No
JNNCE,Data Science,KCET,2024,62476,67693,19899,28329,178397,150068,No
RVUNIV,Civil Engineering,COMEDK,2024,224676,89773,14888,18744,348081,329337,No
SJBCE,Aerospace Engineering,KCET,2023,80848,78581,12229,11366,183024,171658,No
NMIT,Chemical Engineering,COMEDK,2023,239341,63855,15683,19745,338624,318879,Yes
SITM,Computer Science and Engineering,KCET,2024,77561,65629,8022,26690,177902,151212,No
NIE,Biotechnology,KCET,2023,81531,64668,16749,12630,175578,162948,Yes
GIT,Robotics and Automation Engineering,KCET,2023,61414,83128,14849,10825,170216,159391,Yes
JIT,Information Science and Engineering,COMEDK,2024,246566,86363,17409,12840,363178,350338,No
KSIT,Mechanical Engineering,KCET,2023,77503,83016,12961,24537,198017,173480,No
SITM,Artificial Intelligence and Data Science,COMEDK,2024,225339,80196,18564,23072,347171,324099,Yes
EastPoint,Mechanical Engineering,KCET,2024,68022,75904,16444,28117,188487,160370,Yes
DSCE,Mechanical Engineering,COMEDK,2023,240251,86385,12356,18428,357420,338992,Yes
BMSIT,Computer Science and Engineering,KCET,2024,84574,77685,14799,18912,195970,177058,Yes
BMSCE,Mechanical Engineering,KCET,2023,68922,93917,18927,25871,207637,181766,No
BIT,Robotics and Automation Engineering,KCET,2024,70883,82317,8897,16545,178642,162097,Yes
AECMandya,Artificial Intelligence and Data Science,KCET,2023,50717,88648,11977,18765,170107,151342,Yes
AECMandya,Chemical Engineering,COMEDK,2023,232693,68256,13895,18777,333621,314844,No
ACU,Electronics and Communication Engineering,KCET,2023,77991,60350,13858,21285,173484,152199,No
HKBK,Civil Engineering,KCET,2023,51262,85993,18151,29131,184537,155406,No
BMSCE,Information Science and Engineering,COMEDK,2024,174243,89039,13254,14891,291427,276536,Yes
VVIT,Electronics and Communication Engineering,COMEDK,2024,237946,62353,16300,24069,340668,316599,No
GIT,Data Science,COMEDK,2023,211039,78869,18260,14336,322504,308168,No
BMSCE,Civil Engineering,KCET,2024,82559,70880,12511,18918,184868,165950,Yes
NMIT,Data Science,COMEDK,2023,203235,60711,8265,27839,300050,272211,No
RVUNIV,Artificial Intelligence and Data Science,COMEDK,2024,229517,80119,9316,12211,331163,318952,Yes
AITM,Biotechnology,COMEDK,2023,220013,66129,14588,28095,328825,300730,No
DSATM,Mechanical Engineering,KCET,2024,55737,79708,12857,20415,168717,148302,No
AECMandya,Electronics and Communication Engineering,KCET,2024,63733,88779,9930,24189,186631,162442,Yes
JNNCE,Robotics and Automation Engineering,COMEDK,2024,243688,64782,16047,27148,351665,324517,No
KLSGIT,Robotics and Automation Engineering,KCET,2024,57142,74058,16500,16585,164285,147700,Yes
MSRIT,Information Science and Engineering,KCET,2024,53410,86410,11861,25797,177478,151681,Yes
BMSIT,Biotechnology,KCET,2024,67386,81811,15898,15846,180941,165095,No
DBIT,Electrical and Electronics Engineering,KCET,2024,52208,86292,11392,26296,176188,149892,No
DSATM,Electronics and Communication Engineering,COMEDK,2023,175066,74522,16862,10725,277175,266450,Yes
CMRIT,Electrical and Electronics Engineering,COMEDK,2024,160828,75996,9976,26472,273272,246800,No
JNNCE,Artificial Intelligence and Data Science,KCET,2023,81002,67686,15985,10796,175469,164673,Yes
RVUNIV,Data Science,KCET,2023,83524,86674,19818,24449,214465,190016,Yes
PESCE,Electrical and Electronics Engineering,KCET,2024,63327,66997,19570,10047,159941,149894,Yes
NHCE,Aerospace Engineering,COMEDK,2024,196116,77339,9826,19707,302988,283281,Yes
BMSCE,Computer Science and Engineering,KCET,2024,64195,60965,8852,13177,147189,134012,No
PESU,Robotics and Automation Engineering,KCET,2023,62936,85798,9677,12192,170603,158411,Yes
JSSSTU,Electrical and Electronics Engineering,KCET,2024,53014,62853,18437,24590,158894,134304,No
PESU,Mechanical Engineering,KCET,2024,50371,85920,16001,15157,167449,152292,No
BMSIT,Computer Science and Engineering,KCET,2024,77689,61845,17382,23305,180221,156916,Yes
PRES,Civil Engineering,COMEDK,2024,177423,73724,8318,25272,284737,259465,No
CITGubbi,Information Science and Engineering,COMEDK,2024,181141,92325,9340,22095,304901,282806,Yes
AECMandya,Mechanical Engineering,KCET,2023,54128,94205,9812,19673,177818,158145,No
GIT,Information Science and Engineering,COMEDK,2023,214172,85354,10998,11528,322052,310524,Yes
MVJCE,Data Science,KCET,2024,66851,73235,13861,13534,167481,153947,Yes
SDMIT,Information Science and Engineering,KCET,2023,84463,87218,19778,16097,207556,191459,Yes
GIT,Data Science,KCET,2023,78480,85423,19578,21448,204929,183481,No
KLEIT,Mechanical Engineering,KCET,2023,55084,85029,16734,13616,170463,156847,No
BITM,Chemical Engineering,COMEDK,2024,169558,69008,8936,29132,276634,247502,Yes
JSSSTU,Aerospace Engineering,KCET,2023,65398,86826,9902,28134,190260,162126,No
RAIT,Artificial Intelligence and Data Science,COMEDK,2023,239698,93476,10182,24537,367893,343356,No
MVJCE,Biotechnology,KCET,2024,61658,69156,17159,16603,164576,147973,Yes
SDMCET,Artificial Intelligence and Data Science,COMEDK,2024,201036,72545,14901,24473,312955,288482,Yes
RNSIT,Mechanical Engineering,KCET,2024,50626,61880,9007,14436,135949,121513,Yes
DSCE,Aerospace Engineering,COMEDK,2024,222332,84122,18831,19793,345078,325285,Yes
RNSIT,Biotechnology,COMEDK,2024,213181,92835,19654,14181,339851,325670,Yes
RNSIT,Computer Science and Engineering,COMEDK,2023,210738,66818,17832,28668,324056,295388,No
MSRIT,Electronics and Communication Engineering,KCET,2024,83837,92686,16840,14070,207433,193363,No
RVCE,Aerospace Engineering,KCET,2023,58557,93240,14685,20940,187422,166482,No
MVJCE,Mechanical Engineering,COMEDK,2023,165606,79947,11453,20345,277351,257006,No
AIT,Information Science and Engineering,KCET,2023,50310,83102,14035,15338,162785,147447,Yes
SIT,Robotics and Automation Engineering,COMEDK,2023,180308,90129,19008,28422,317867,289445,Yes
CMRIT,Computer Science and Engineering,KCET,2023,75057,85722,9006,12609,182394,169785,Yes
MSRIT,Civil Engineering,KCET,2023,76457,67911,17151,13345,174864,161519,Yes
NIE,Chemical Engineering,COMEDK,2024,201687,73579,18471,27155,320892,293737,Yes
YKCE,Artificial Intelligence and Data Science,COMEDK,2023,233966,71818,8813,15782,330379,314597,No
AIT,Computer Science and Engineering,KCET,2023,62913,78167,18187,25024,184291,159267,No
DBIT,Civil Engineering,KCET,2023,57772,62423,15706,17603,153504,135901,No
GMIT,Robotics and Automation Engineering,KCET,2024,84057,88259,12690,22705,207711,185006,Yes
RIT,Robotics and Automation Engineering,KCET,2023,77831,88504,16475,20455,203265,182810,Yes
VVCE,Electronics and Communication Engineering,KCET,2024,64829,83771,14325,29802,192727,162925,Yes
BITM,Electrical and Electronics Engineering,KCET,2023,77081,89600,16093,24844,207618,182774,No
UVCE,Electrical and Electronics Engineering,KCET,2023,73737,73174,13100,16409,176420,160011,Yes
ACU,Electrical and Electronics Engineering,KCET,2023,71247,78016,8705,22297,180265,157968,No
BMIT,Computer Science and Engineering,KCET,2024,79975,88660,15487,29957,214079,184122,Yes
RVCE,Electronics and Communication Engineering,COMEDK,2023,204258,87813,9247,10604,311922,301318,No
VSM,Computer Science and Engineering,KCET,2023,61481,62109,16399,27977,167966,139989,Yes
AECMandya,Information Science and Engineering,KCET,2023,71317,89765,15610,21109,197801,176692,Yes
PESU,Information Science and Engineering,COMEDK,2023,182496,80252,19185,15860,297793,281933,Yes
AITM,Mechanical Engineering,KCET,2024,82581,92552,9062,15589,199784,184195,No
RNSIT,Robotics and Automation Engineering,KCET,2023,77893,88438,12842,18727,197900,179173,Yes
BITM,Chemical Engineering,KCET,2024,55585,61546,8493,24701,150325,125624,Yes
BIT,Artificial Intelligence and Data Science,COMEDK,2024,162113,84404,16011,12729,275257,262528,Yes
VIT,Information Science and Engineering,KCET,2024,66016,79024,16628,22060,183728,161668,Yes
BITM,Chemical Engineering,COMEDK,2023,235480,90009,14385,11223,351097,339874,No
RIT,Computer Science and Engineering,COMEDK,2023,202713,72321,19621,25964,320619,294655,Yes
RIT,Electrical and Electronics Engineering,KCET,2023,58172,82841,17367,11711,170091,158380,Yes
VIT,Civil Engineering,KCET,2023,51875,63471,17075,14140,146561,132421,Yes
NCET,Robotics and Automation Engineering,COMEDK,2024,244475,66410,10668,10947,332500,321553,Yes
AECMandya,Aerospace Engineering,COMEDK,2024,222648,85274,16692,21503,346117,324614,Yes
ACU,Electrical and Electronics Engineering,KCET,2023,72283,78435,14475,27786,192979,165193,Yes
DBIT,Mechanical Engineering,COMEDK,2024,224480,64746,14381,12486,316093,303607,No
KLEIT,Electrical and Electronics Engineering,KCET,2024,59980,80916,13571,27163,181630,154467,Yes
RVCE,Artificial Intelligence and Data Science,COMEDK,2024,203251,91632,18338,26576,339797,313221,No
GIT,Electronics and Communication Engineering,COMEDK,2023,239031,63110,15723,18438,336302,317864,No
GIT,Electronics and Communication Engineering,COMEDK,2024,226817,66030,19737,10760,323344,312584,No
AIT,Computer Science and Engineering,COMEDK,2024,217480,79217,17889,25880,340466,314586,Yes
KLSGIT,Aerospace Engineering,COMEDK,2023,164396,73963,15677,22653,276689,254036,No
JIT,Chemical Engineering,KCET,2024,81780,66095,18507,27732,194114,166382,No
DBIT,Biotechnology,KCET,2024,63104,61177,19375,11828,155484,143656,No
DSCE,Robotics and Automation Engineering,COMEDK,2024,208170,76026,18872,28101,331169,303068,No
ACU,Robotics and Automation Engineering,COMEDK,2024,225616,61024,9273,19529,315442,295913,No
AEC,Biotechnology,COMEDK,2024,194714,65179,13920,27116,300929,273813,No
REVA,Aerospace Engineering,KCET,2024,84455,90349,14239,12761,201804,189043,Yes
REVA,Artificial Intelligence and Data Science,KCET,2023,58065,74184,8057,20641,160947,140306,No
DrAIT,Mechanical Engineering,KCET,2024,57030,94991,14510,14810,181341,166531,Yes
NMIT,Computer Science and Engineering,KCET,2023,61613,76013,13314,21476,172416,150940,Yes
BMSIT,Data Science,COMEDK,2024,204250,93525,19845,18398,336018,317620,Yes
DBIT,Mechanical Engineering,KCET,2023,84928,87291,14196,16792,203207,186415,Yes
KSIT,Robotics and Automation Engineering,COMEDK,2023,171812,80347,8347,25616,286122,260506,No
VSM,Data Science,COMEDK,2024,247156,79452,9545,26082,362235,336153,No
BNMIT,Electrical and Electronics Engineering,COMEDK,2023,249032,80072,17428,27334,373866,346532,No
PESCE,Biotechnology,KCET,2024,79369,80235,15942,27549,203095,175546,Yes
SITM,Chemical Engineering,COMEDK,2023,216722,86266,10222,19991,333201,313210,Yes
MSRUAS,Biotechnology,COMEDK,2023,201740,62756,11733,16111,292340,276229,Yes
VVIT,Biotechnology,COMEDK,2024,183556,73042,10804,12890,280292,267402,No
BMSCE,Electrical and Electronics Engineering,COMEDK,2024,199659,61548,10795,26149,298151,272002,No
AECMandya,Data Science,KCET,2024,65372,87350,12757,29554,195033,165479,No
NMIT,Data Science,COMEDK,2023,191937,82916,14724,23855,313432,289577,Yes
GMIT,Biotechnology,COMEDK,2023,192598,88041,15194,15222,311055,295833,Yes
NIE,Electrical and Electronics Engineering,KCET,2024,50260,63522,12706,29711,156199,126488,Yes
PESU,Computer Science and Engineering,KCET,2023,54084,84687,8991,26266,174028,147762,Yes
NIE,Artificial Intelligence and Data Science,COMEDK,2024,241495,77816,14211,25413,358935,333522,Yes
JNNCE,Mechanical Engineering,COMEDK,2023,175369,94666,13298,25206,308539,283333,No
SDMIT,Robotics and Automation Engineering,COMEDK,2024,161282,85886,8654,14683,270505,255822,No
VVCE,Aerospace Engineering,KCET,2023,73771,79372,16249,13806,183198,169392,No
RVCE,Robotics and Automation Engineering,KCET,2024,76650,94718,11136,12669,195173,182504,No
BNMIT,Computer Science and Engineering,KCET,2023,80158,61287,18236,24117,183798,159681,Yes
BMSCE,Data Science,COMEDK,2024,172315,86096,10401,12230,281042,268812,No
VSM,Electrical and Electronics Engineering,COMEDK,2023,181491,70184,18310,15300,285285,269985,No
RIT,Biotechnology,COMEDK,2024,197792,94428,9628,19813,321661,301848,No
ACU,Computer Science and Engineering,COMEDK,2023,171911,68855,18220,16105,275091,258986,Yes
BIT,Chemical Engineering,KCET,2023,79623,93207,15033,13119,200982,187863,Yes
DrAIT,Information Science and Engineering,KCET,2023,73387,93571,13172,13533,193663,180130,No
BMIT,Electronics and Communication Engineering,COMEDK,2024,221485,74733,15845,27290,339353,312063,No
KLSGIT,Computer Science and Engineering,KCET,2023,82771,86641,18991,24900,213303,188403,Yes
GMIT,Biotechnology,COMEDK,2024,202459,91758,10452,23115,327784,304669,Yes
AEC,Information Science and Engineering,KCET,2024,66451,86965,17142,29350,199908,170558,Yes
KSIT,Computer Science and Engineering,COMEDK,2023,189923,82171,16134,20726,308954,288228,Yes
AECMandya,Chemical Engineering,KCET,2024,84758,78703,17152,14473,195086,180613,Yes
DSCE,Information Science and Engineering,KCET,2023,56054,93426,9731,11226,170437,159211,Yes
SDMIT,Robotics and Automation Engineering,COMEDK,2024,187379,62206,16013,25639,291237,265598,No
RVCE,Biotechnology,KCET,2023,76339,93946,17591,25105,212981,187876,Yes
ACU,Mechanical Engineering,KCET,2023,60138,79307,8417,14851,162713,147862,Yes
DSATM,Aerospace Engineering,KCET,2024,53220,90130,18584,29384,191318,161934,No
HKBK,Aerospace Engineering,COMEDK,2023,206923,89049,13858,29538,339368,309830,No
NHCE,Information Science and Engineering,KCET,2024,52289,60044,17400,26339,156072,129733,No
HKBK,Robotics and Automation Engineering,KCET,2023,83437,76081,18784,29690,207992,178302,Yes
KSIT,Robotics and Automation Engineering,KCET,2024,82304,60238,9889,17612,170043,152431,Yes
EastPoint,Aerospace Engineering,COMEDK,2024,245957,63000,12527,24204,345688,321484,Yes
PESCE,Electrical and Electronics Engineering,COMEDK,2023,237063,73263,12072,21656,344054,322398,No
HKBK,Chemical Engineering,KCET,2023,57679,74575,11883,24837,168974,144137,No
AECMandya,Biotechnology,COMEDK,2023,247534,84076,12991,26567,371168,344601,No
MSRIT,Computer Science and Engineering,KCET,2023,71283,85474,17266,15675,189698,174023,No
GMIT,Electrical and Electronics Engineering,KCET,2024,59419,66687,17010,15290,158406,143116,Yes
PRES,Information Science and Engineering,COMEDK,2024,232819,60099,15588,22979,331485,308506,No
GIT,Aerospace Engineering,KCET,2023,76745,71979,16616,16050,181390,165340,Yes
KLSGIT,Civil Engineering,COMEDK,2024,168009,85227,19415,15342,287993,272651,No
JIT,Biotechnology,KCET,2024,67406,65073,13963,22448,168890,146442,No
GIT,Chemical Engineering,KCET,2024,66054,60435,11650,10372,148511,138139,No
BMSIT,Robotics and Automation Engineering,KCET,2024,62389,79220,9054,14361,165024,150663,No
BMSCE,Aerospace Engineering,COMEDK,2023,178863,72491,18215,28014,297583,269569,Yes
JSSSTU,Data Science,COMEDK,2024,164148,88463,19144,27802,299557,271755,No
VemanaIT,Biotechnology,COMEDK,2023,217252,60673,15393,10537,303855,293318,No
GIT,Data Science,KCET,2024,66911,62032,11213,27534,167690,140156,No
AIT,Chemical Engineering,KCET,2023,61901,87445,15122,10534,175002,164468,Yes
RIT,Aerospace Engineering,COMEDK,2023,165407,87630,8974,17038,279049,262011,No
SDMCET,Electrical and Electronics Engineering,COMEDK,2024,238615,63737,15713,11563,329628,318065,Yes
AIT,Biotechnology,KCET,2024,50659,65707,19395,20134,155895,135761,Yes
CITGubbi,Robotics and Automation Engineering,COMEDK,2023,168076,78274,14586,13594,274530,260936,No
MSRUAS,Electronics and Communication Engineering,COMEDK,2023,165541,62205,13532,19441,260719,241278,Yes
AITM,Computer Science and Engineering,COMEDK,2023,224189,67831,18850,23720,334590,310870,Yes
CITGubbi,Electrical and Electronics Engineering,COMEDK,2023,171856,76077,16186,23474,287593,264119,Yes
NCET,Civil Engineering,KCET,2023,64586,73934,18255,14392,171167,156775,Yes
JIT,Electrical and Electronics Engineering,COMEDK,2024,232151,84865,18903,12776,348695,335919,No
VIT,Aerospace Engineering,COMEDK,2024,201331,66216,9290,12160,288997,276837,No
EastPoint,Aerospace Engineering,KCET,2023,82988,79875,14076,28846,205785,176939,Yes
NIE,Biotechnology,KCET,2024,51589,67080,17887,14322,150878,136556,No
MVJCE,Computer Science and Engineering,COMEDK,2023,192368,79232,13891,25952,311443,285491,Yes
BMSIT,Artificial Intelligence and Data Science,COMEDK,2024,217363,69022,10392,17575,314352,296777,Yes
JNNCE,Civil Engineering,KCET,2023,71583,68593,19917,15104,175197,160093,No
RVUNIV,Chemical Engineering,COMEDK,2023,184718,83744,13870,21759,304091,282332,No
NMIT,Data Science,COMEDK,2023,242154,75683,13993,11029,342859,331830,No
SCEM,Chemical Engineering,COMEDK,2023,212561,70458,10052,23838,316909,293071,Yes
RVUNIV,Robotics and Automation Engineering,COMEDK,2023,178206,85098,11718,23881,298903,275022,Yes
JNNCE,Data Science,KCET,2023,81835,82305,16723,22075,202938,180863,Yes
VVIT,Electrical and Electronics Engineering,KCET,2024,57014,74017,19398,19885,170314,150429,No
PRES,Aerospace Engineering,COMEDK,2023,201313,80936,18077,22786,323112,300326,Yes
VIT,Chemical Engineering,KCET,2023,76854,67167,13633,27517,185171,157654,Yes
AIT,Computer Science and Engineering,KCET,2023,77548,88468,12619,24086,202721,178635,Yes
BMSCE,Data Science,COMEDK,2024,237702,61156,11447,27710,338015,310305,No
DSCE,Mechanical Engineering,COMEDK,2024,187628,81422,12594,14283,295927,281644,No
KSIT,Electronics and Communication Engineering,KCET,2023,67400,60159,16442,26709,170710,144001,No
PESCE,Mechanical Engineering,COMEDK,2023,226969,75022,15804,10879,328674,317795,No
JNNCE,Mechanical Engineering,COMEDK,2023,212857,73361,18090,19629,323937,304308,Yes
HKBK,Artificial Intelligence and Data Science,KCET,2024,67532,75250,14639,11854,169275,157421,Yes
RAIT,Robotics and Automation Engineering,KCET,2023,62927,85186,16697,12996,177806,164810,Yes
GMIT,Electronics and Communication Engineering,COMEDK,2023,227762,94293,8936,29306,360297,330991,No
RNSIT,Robotics and Automation Engineering,KCET,2024,54714,60476,19844,17648,152682,135034,Yes
RAIT,Civil Engineering,COMEDK,2024,216975,86500,14767,20933,339175,318242,Yes
RNSIT,Information Science and Engineering,KCET,2024,60447,68498,11349,26148,166442,140294,Yes
BMSCE,Biotechnology,KCET,2024,76769,65579,18825,28920,190093,161173,No
KLSGIT,Electrical and Electronics Engineering,COMEDK,2023,219316,78841,8779,27995,334931,306936,Yes
JSSSTU,Biotechnology,COMEDK,2023,175601,70665,10258,20190,276714,256524,No
SITM,Data Science,KCET,2024,65095,93891,8748,22222,189956,167734,Yes
VVCE,Civil Engineering,KCET,2024,57236,75483,8491,23506,164716,141210,Yes
RVCE,Mechanical Engineering,KCET,2024,74300,63411,12078,19738,169527,149789,Yes
CMRIT,Mechanical Engineering,COMEDK,2023,198996,84163,18028,17641,318828,301187,No
SIT,Computer Science and Engineering,COMEDK,2024,219543,68906,13016,15031,316496,301465,No
NMIT,Artificial Intelligence and Data Science,COMEDK,2023,212237,91783,17237,29304,350561,321257,Yes
DSCE,Artificial Intelligence and Data Science,COMEDK,2024,236332,85305,17874,21921,361432,339511,No
JSSSTU,Chemical Engineering,KCET,2024,83348,77753,19384,22790,203275,180485,No
RVCE,Information Science and Engineering,COMEDK,2024,249109,74403,16386,14662,354560,339898,Yes
YKCE,Aerospace Engineering,COMEDK,2023,200460,73667,17090,23893,315110,291217,No
JIT,Robotics and Automation Engineering,COMEDK,2024,219371,72351,15611,15555,322888,307333,Yes
VemanaIT,Electronics and Communication Engineering,KCET,2024,61194,68653,8259,24203,162309,138106,Yes
CMRIT,Artificial Intelligence and Data Science,COMEDK,2023,218431,68388,12180,15095,314094,298999,Yes
MVJCE,Robotics and Automation Engineering,COMEDK,2024,208388,88446,11806,26868,335508,308640,No
RVUNIV,Chemical Engineering,KCET,2024,51261,77360,16282,17928,162831,144903,No
RVUNIV,Artificial Intelligence and Data Science,COMEDK,2024,176422,80864,12067,11777,281130,269353,Yes
KLEIT,Computer Science and Engineering,COMEDK,2024,166981,83119,14587,15784,280471,264687,Yes
VSM,Biotechnology,KCET,2023,70032,69786,12945,21313,174076,152763,No
SITM,Aerospace Engineering,COMEDK,2023,184827,83211,8322,17762,294122,276360,No
DSCE,Computer Science and Engineering,KCET,2023,82309,78215,17253,17082,194859,177777,Yes
SJBIT,Mechanical Engineering,KCET,2023,78332,93410,17052,21814,210608,188794,Yes
RVCE,Computer Science and Engineering,COMEDK,2024,215748,91165,14667,21198,342778,321580,No
YKCE,Computer Science and Engineering,COMEDK,2024,220055,69760,14903,17952,322670,304718,Yes
JIT,Electrical and Electronics Engineering,COMEDK,2023,191558,73985,11798,14341,291682,277341,Yes
SITM,Biotechnology,KCET,2023,78559,72077,14023,26631,191290,164659,No
AEC,Computer Science and Engineering,COMEDK,2023,216517,73726,17506,10587,318336,307749,Yes
NMIT,Data Science,COMEDK,2023,183284,62715,9701,12159,267859,255700,Yes
CITGubbi,Computer Science and Engineering,KCET,2024,81618,75226,8922,28285,194051,165766,No
DBIT,Electronics and Communication Engineering,KCET,2024,59314,86510,16688,14142,176654,162512,No
RIT,Electronics and Communication Engineering,KCET,2023,65211,64808,8945,27003,165967,138964,Yes
PESCE,Biotechnology,COMEDK,2024,246842,65037,8669,20678,341226,320548,Yes
DBIT,Information Science and Engineering,COMEDK,2023,201795,68004,9697,25684,305180,279496,Yes
GIT,Civil Engineering,KCET,2023,58746,70441,19670,19720,168577,148857,No
NMIT,Chemical Engineering,COMEDK,2024,198927,61479,12481,18472,291359,272887,Yes
BITM,Artificial Intelligence and Data Science,COMEDK,2023,184990,73752,18936,14832,292510,277678,Yes
SJBCE,Civil Engineering,COMEDK,2023,186781,83109,8432,23779,302101,278322,No
BNMIT,Electronics and Communication Engineering,KCET,2024,59883,62640,19619,12005,154147,142142,No
RNSIT,Biotechnology,KCET,2024,63832,75793,13223,23101,175949,152848,Yes
DSATM,Electronics and Communication Engineering,KCET,2023,84913,85016,14058,14268,198255,183987,Yes
CITGubbi,Data Science,COMEDK,2023,188459,89857,16200,16818,311334,294516,No
AEC,Electronics and Communication Engineering,KCET,2023,71815,74490,17174,12857,176336,163479,No
PESCE,Information Science and Engineering,KCET,2023,53973,75275,13495,15767,158510,142743,No
AITM,Mechanical Engineering,KCET,2023,62172,86534,15225,12236,176167,163931,No
JIT,Civil Engineering,KCET,2024,81933,79574,10555,25364,197426,172062,Yes
ACU,Data Science,COMEDK,2024,167073,75776,8479,27326,278654,251328,No
NHCE,Chemical Engineering,KCET,2024,56371,90760,12630,19880,179641,159761,No
MSRUAS,Civil Engineering,COMEDK,2023,191646,90090,19530,18926,320192,301266,No
MVJCE,Biotechnology,COMEDK,2023,204885,93195,17881,10800,326761,315961,Yes
RVUNIV,Computer Science and Engineering,KCET,2024,56971,84986,9640,19954,171551,151597,Yes
SDMCET,Data Science,KCET,2023,52561,62747,11185,29672,156165,126493,Yes
JNNCE,Information Science and Engineering,KCET,2024,82660,66352,9253,28632,186897,158265,Yes
BIT,Civil Engineering,COMEDK,2024,226649,80706,18376,24096,349827,325731,No
BNMIT,Electrical and Electronics Engineering,KCET,2024,65720,93913,18777,29644,208054,178410,No
BMIT,Electrical and Electronics Engineering,COMEDK,2024,169634,67246,15525,17074,269479,252405,Yes
AITM,Civil Engineering,COMEDK,2023,185559,67546,12882,23500,289487,265987,No
PESCE,Data Science,KCET,2023,50647,93355,8034,16659,168695,152036,No
MVJCE,Artificial Intelligence and Data Science,KCET,2023,68714,62325,12090,14288,157417,143129,Yes
DrAIT,Electronics and Communication Engineering,KCET,2023,81232,68145,13128,27776,190281,162505,Yes
SCEM,Civil Engineering,COMEDK,2024,160276,64767,12966,22741,260750,238009,Yes
VSM,Biotechnology,KCET,2023,55681,79958,11351,29509,176499,146990,No
PESCE,Computer Science and Engineering,COMEDK,2023,189181,74535,18712,15910,298338,282428,No
GIT,Electronics and Communication Engineering,COMEDK,2023,167146,73073,17786,14409,272414,258005,Yes
VVIT,Electrical and Electronics Engineering,COMEDK,2023,166553,62672,17063,11750,258038,246288,No
RVUNIV,Information Science and Engineering,KCET,2024,76501,67842,13222,18479,176044,157565,No
SITM,Chemical Engineering,COMEDK,2024,221667,81974,17729,12302,333672,321370,Yes
SJBCE,Artificial Intelligence and Data Science,KCET,2024,55590,72052,10082,22069,159793,137724,Yes
GMIT,Computer Science and Engineering,KCET,2024,51041,61064,10740,11193,134038,122845,No
DBIT,Aerospace Engineering,COMEDK,2023,249026,69055,14969,29465,362515,333050,No
VemanaIT,Civil Engineering,KCET,2023,69613,72832,11721,27365,181531,154166,Yes
NMIT,Information Science and Engineering,KCET,2023,58900,88767,12977,25251,185895,160644,Yes
DSATM,Robotics and Automation Engineering,KCET,2023,69393,93677,9733,24570,197373,172803,No
MVJCE,Data Science,COMEDK,2024,160106,75650,8437,23884,268077,244193,Yes
PESCE,Computer Science and Engineering,KCET,2023,61256,91374,18548,20627,191805,171178,Yes
NCET,Computer Science and Engineering,COMEDK,2023,245495,76363,8481,13574,343913,330339,No
AITM,Computer Science and Engineering,KCET,2024,73647,76693,12014,18128,180482,162354,Yes
RVCE,Electrical and Electronics Engineering,COMEDK,2024,184265,69069,16592,28169,298095,269926,Yes
YKCE,Chemical Engineering,COMEDK,2024,228915,67285,14657,15689,326546,310857,No
BMSCE,Civil Engineering,KCET,2023,64736,79673,10255,27472,182136,154664,Yes
PRES,Electrical and Electronics Engineering,COMEDK,2024,242899,73502,14109,18975,349485,330510,No
KSIT,Computer Science and Engineering,COMEDK,2024,206843,93058,16336,14209,330446,316237,No
SITM,Electronics and Communication Engineering,COMEDK,2023,167606,64229,16264,24357,272456,248099,No
KLEIT,Information Science and Engineering,COMEDK,2023,164534,64390,9305,17140,255369,238229,No
VemanaIT,Mechanical Engineering,KCET,2024,58526,63903,14425,15598,152452,136854,No
REVA,Mechanical Engineering,KCET,2023,82271,89141,14887,25000,211299,186299,No
DSCE,Civil Engineering,COMEDK,2023,193203,61328,19558,14854,288943,274089,Yes
NHCE,Computer Science and Engineering,KCET,2024,81957,76156,11635,15297,185045,169748,No
SIT,Biotechnology,KCET,2023,73717,81232,11917,10541,177407,166866,Yes
MSRUAS,Chemical Engineering,KCET,2023,71090,63882,15130,24197,174299,150102,No
JNNCE,Biotechnology,KCET,2024,68848,80091,12278,15139,176356,161217,Yes
DSATM,Mechanical Engineering,COMEDK,2023,173671,92342,18051,13300,297364,284064,No
GMIT,Robotics and Automation Engineering,KCET,2024,70425,62050,16914,23328,172717,149389,Yes
DrAIT,Information Science and Engineering,COMEDK,2024,163293,60917,17439,20186,261835,241649,No
REVA,Data Science,COMEDK,2023,193135,77172,17097,15610,303014,287404,No
YKCE,Chemical Engineering,KCET,2023,74717,89818,10077,17958,192570,174612,Yes
JNNCE,Aerospace Engineering,COMEDK,2023,227823,74861,17397,16588,336669,320081,Yes
KLEIT,Data Science,COMEDK,2024,233580,71366,17516,10214,332676,322462,Yes
AIT,Chemical Engineering,KCET,2023,63985,77579,12950,20526,175040,154514,Yes
NHCE,Aerospace Engineering,COMEDK,2023,225912,71382,12379,15894,325567,309673,Yes
AIT,Mechanical Engineering,KCET,2023,62054,86065,10550,10395,169064,158669,No
BMSCE,Aerospace Engineering,COMEDK,2024,223297,63031,13570,25070,324968,299898,No
AEC,Data Science,KCET,2024,73288,78071,17189,24559,193107,168548,No
UVCE,Information Science and Engineering,COMEDK,2023,229409,69376,19193,20176,338154,317978,No
CMRIT,Biotechnology,KCET,2024,60581,77611,16972,14503,169667,155164,Yes
GIT,Robotics and Automation Engineering,COMEDK,2024,225856,84054,9318,26441,345669,319228,No
AEC,Electronics and Communication Engineering,KCET,2024,82476,80826,10311,29861,203474,173613,Yes
CITGubbi,Mechanical Engineering,COMEDK,2024,218220,75930,8929,23884,326963,303079,Yes
MVJCE,Civil Engineering,KCET,2023,52088,81321,8769,29323,171501,142178,Yes
BIT,Robotics and Automation Engineering,KCET,2023,73053,86838,8665,10641,179197,168556,No
MVJCE,Robotics and Automation Engineering,KCET,2023,66493,64162,19405,27905,177965,150060,Yes
JSSSTU,Mechanical Engineering,KCET,2024,79865,64468,8191,19032,171556,152524,Yes
BNMIT,Data Science,KCET,2024,62930,72796,8638,28989,173353,144364,No
NMIT,Electrical and Electronics Engineering,KCET,2024,75261,62658,18652,11577,168148,156571,Yes
UVCE,Information Science and Engineering,COMEDK,2024,182753,88281,18776,11447,301257,289810,No
AIT,Civil Engineering,COMEDK,2023,190964,70752,8282,10293,280291,269998,Yes
PRES,Aerospace Engineering,COMEDK,2024,169330,82010,14221,29245,294806,265561,Yes
BMSIT,Electrical and Electronics Engineering,COMEDK,2023,195126,87632,14544,14400,311702,297302,Yes
SCEM,Information Science and Engineering,COMEDK,2023,207970,89778,9868,14277,321893,307616,No
PRES,Chemical Engineering,KCET,2023,58351,84185,9848,18316,170700,152384,No
REVA,Mechanical Engineering,KCET,2024,69716,89064,12825,10354,181959,171605,Yes
NIE,Mechanical Engineering,KCET,2023,75448,92835,8227,23205,199715,176510,Yes
BMIT,Information Science and Engineering,KCET,2024,82789,78006,15828,16741,193364,176623,Yes
JIT,Artificial Intelligence and Data Science,KCET,2023,68188,61186,14923,20544,164841,144297,No
DrAIT,Civil Engineering,KCET,2024,63420,65815,16122,12817,158174,145357,Yes
NIE,Data Science,COMEDK,2023,249756,82370,13839,22158,368123,345965,Yes
SDMIT,Artificial Intelligence and Data Science,KCET,2024,54023,60424,12823,12703,139973,127270,Yes
BITM,Robotics and Automation Engineering,KCET,2024,67003,87582,16727,26181,197493,171312,No
BIT,Civil Engineering,COMEDK,2023,201307,69095,18849,14838,304089,289251,Yes
MVJCE,Biotechnology,COMEDK,2024,181422,92747,18884,18883,311936,293053,Yes
JSSSTU,Mechanical Engineering,KCET,2023,79823,88793,16163,28426,213205,184779,Yes
RVCE,Aerospace Engineering,COMEDK,2024,220657,90258,11151,18243,340309,322066,Yes
VVIT,Electronics and Communication Engineering,COMEDK,2023,175064,86218,17837,28448,307567,279119,No
RIT,Biotechnology,COMEDK,2024,237526,86643,13156,13463,350788,337325,No
DSATM,Civil Engineering,COMEDK,2024,172235,78293,14955,12040,277523,265483,No
RIT,Robotics and Automation Engineering,KCET,2024,53772,83588,13104,24510,174974,150464,Yes
BITM,Chemical Engineering,COMEDK,2023,173928,69896,8268,23265,275357,252092,Yes
NCET,Artificial Intelligence and Data Science,KCET,2023,84238,67039,14260,14067,179604,165537,Yes
MVJCE,Aerospace Engineering,COMEDK,2024,219747,78570,8072,22190,328579,306389,Yes
HKBK,Biotechnology,COMEDK,2023,187267,90670,8172,18587,304696,286109,No
VemanaIT,Electrical and Electronics Engineering,COMEDK,2023,227044,60147,15776,23718,326685,302967,No
RAIT,Electrical and Electronics Engineering,KCET,2023,77670,63982,11482,18445,171579,153134,Yes
SJBCE,Computer Science and Engineering,COMEDK,2024,200695,94749,18964,15806,330214,314408,Yes
CITGubbi,Information Science and Engineering,KCET,2024,66172,64947,10951,10766,152836,142070,Yes
KLEIT,Artificial Intelligence and Data Science,COMEDK,2024,224286,73812,10058,23251,331407,308156,Yes
JNNCE,Electrical and Electronics Engineering,KCET,2023,56779,64302,18963,12833,152877,140044,Yes
KLSGIT,Robotics and Automation Engineering,KCET,2024,52135,85899,17904,12807,168745,155938,No
NMIT,Mechanical Engineering,KCET,2023,68840,62478,14021,20217,165556,145339,Yes
DrAIT,Civil Engineering,COMEDK,2023,205062,94451,14183,18236,331932,313696,No
DBIT,Information Science and Engineering,COMEDK,2024,217773,66264,19059,10886,313982,303096,No
RIT,Robotics and Automation Engineering,COMEDK,2023,221985,65004,17967,15770,320726,304956,Yes
CITGubbi,Electrical and Electronics Engineering,COMEDK,2024,208599,92194,9923,20192,330908,310716,Yes
DSCE,Computer Science and Engineering,KCET,2023,64491,64963,12227,22496,164177,141681,Yes
AIT,Electrical and Electronics Engineering,KCET,2023,83788,88202,18215,21143,211348,190205,No
UVCE,Biotechnology,KCET,2023,59851,73232,18962,12243,164288,152045,Yes
GMIT,Electrical and Electronics Engineering,COMEDK,2024,172069,88471,15480,20812,296832,276020,No
MVJCE,Aerospace Engineering,COMEDK,2023,212020,84133,9014,13830,318997,305167,No
PESCE,Mechanical Engineering,KCET,2024,78001,82156,19745,22137,202039,179902,Yes
RVCE,Civil Engineering,COMEDK,2024,184767,73499,11239,26791,296296,269505,Yes
VIT,Chemical Engineering,KCET,2024,76490,69416,12139,28703,186748,158045,Yes
EastPoint,Chemical Engineering,COMEDK,2024,182744,88849,18648,26857,317098,290241,Yes
SDMIT,Data Science,KCET,2024,50555,87012,18298,13352,169217,155865,No
BMSIT,Civil Engineering,KCET,2024,62798,70909,8533,16680,158920,142240,No
VSM,Artificial Intelligence and Data Science,KCET,2024,56439,77290,8075,26140,167944,141804,Yes
DSCE,Biotechnology,COMEDK,2024,228961,89785,18405,22121,359272,337151,No
SITM,Information Science and Engineering,KCET,2023,73049,90170,18343,26991,208553,181562,Yes
KLSGIT,Electronics and Communication Engineering,COMEDK,2024,236023,71970,9197,28456,345646,317190,Yes
GIT,Data Science,COMEDK,2024,241120,85784,19344,26060,372308,346248,Yes
DSCE,Robotics and Automation Engineering,KCET,2024,59239,81818,13911,15285,170253,154968,Yes
RVUNIV,Computer Science and Engineering,KCET,2024,75601,94896,12442,22420,205359,182939,No
GIT,Data Science,COMEDK,2024,185948,78843,13764,10781,289336,278555,Yes
BNMIT,Computer Science and Engineering,KCET,2023,64215,84914,18092,20934,188155,167221,No
GMIT,Chemical Engineering,COMEDK,2024,221459,67674,11165,27759,328057,300298,No
SDMIT,Chemical Engineering,KCET,2024,77350,79858,16139,15998,189345,173347,Yes
PRES,Biotechnology,COMEDK,2023,248239,73118,10768,22948,355073,332125,No
KLEIT,Mechanical Engineering,KCET,2023,56287,84419,8042,28847,177595,148748,Yes
PESU,Data Science,COMEDK,2024,166069,64832,13892,25369,270162,244793,Yes
SJBIT,Information Science and Engineering,KCET,2024,52206,91680,12582,28383,184851,156468,No
RAIT,Electronics and Communication Engineering,COMEDK,2023,243213,76140,9542,19531,348426,328895,Yes
BNMIT,Information Science and Engineering,KCET,2024,69779,90408,11573,17647,189407,171760,No
DSCE,Computer Science and Engineering,COMEDK,2023,222952,70649,15275,13985,322861,308876,Yes
BMIT,Artificial Intelligence and Data Science,KCET,2023,58977,75414,9156,16648,160195,143547,No
SCEM,Chemical Engineering,COMEDK,2024,192950,69131,17408,10817,290306,279489,No
RVCE,Chemical Engineering,COMEDK,2023,205855,67210,14628,12661,300354,287693,Yes
MVJCE,Artificial Intelligence and Data Science,KCET,2024,78387,64050,11169,21636,175242,153606,Yes
NIE,Artificial Intelligence and Data Science,COMEDK,2023,161859,86028,13562,27606,289055,261449,Yes
KSIT,Electronics and Communication Engineering,KCET,2023,69014,77162,16656,18439,181271,162832,Yes
BMIT,Information Science and Engineering,KCET,2024,52327,65433,15076,25572,158408,132836,No
DSCE,Chemical Engineering,COMEDK,2024,160456,64237,18142,21223,264058,242835,No
NHCE,Electrical and Electronics Engineering,COMEDK,2024,214120,82905,10711,20512,328248,307736,Yes
BMSIT,Civil Engineering,COMEDK,2023,227949,72430,9299,29765,339443,309678,No
NHCE,Biotechnology,COMEDK,2024,201557,70787,19972,13684,306000,292316,Yes
BMIT,Biotechnology,KCET,2024,73430,60657,15160,14149,163396,149247,No
AITM,Robotics and Automation Engineering,COMEDK,2023,218071,63708,9880,14380,306039,291659,Yes
NMIT,Electrical and Electronics Engineering,KCET,2024,76718,87924,19757,23125,207524,184399,Yes
SDMCET,Civil Engineering,COMEDK,2024,166896,87210,14973,12813,281892,269079,No
VVCE,Data Science,KCET,2023,55883,68202,12282,26597,162964,136367,Yes
BMSCE,Chemical Engineering,KCET,2024,63787,76813,12139,24869,177608,152739,No
SCEM,Artificial Intelligence and Data Science,COMEDK,2024,245460,87151,15206,13446,361263,347817,No
VVIT,Data Science,COMEDK,2024,215079,62748,10207,19975,308009,288034,Yes
PRES,Mechanical Engineering,KCET,2023,79332,92253,10483,28176,210244,182068,No
BIT,Biotechnology,KCET,2023,71502,62163,9207,22443,165315,142872,Yes
MSRIT,Aerospace Engineering,KCET,2024,59481,73499,19355,17160,169495,152335,No
SJBIT,Electrical and Electronics Engineering,COMEDK,2024,182432,89982,10235,15959,298608,282649,Yes
DrAIT,Computer Science and Engineering,COMEDK,2024,199037,66544,17470,26960,310011,283051,No
AITM,Artificial Intelligence and Data Science,KCET,2023,82630,66752,18013,29791,197186,167395,Yes
EastPoint,Data Science,COMEDK,2024,160409,86239,13907,19216,279771,260555,Yes
PRES,Computer Science and Engineering,COMEDK,2023,208489,93021,10192,15186,326888,311702,Yes
DSCE,Information Science and Engineering,COMEDK,2023,241167,60294,11663,16876,330000,313124,No
YKCE,Biotechnology,COMEDK,2024,234790,66712,14770,22867,339139,316272,No
PESU,Computer Science and Engineering,COMEDK,2024,197087,82924,19216,10867,310094,299227,Yes
REVA,Computer Science and Engineering,COMEDK,2023,216059,86606,12847,12874,328386,315512,No
YKCE,Data Science,KCET,2024,70503,90527,16617,21231,198878,177647,Yes
JNNCE,Information Science and Engineering,KCET,2023,51206,60478,17720,18651,148055,129404,No
NHCE,Data Science,KCET,2023,59373,71816,10205,21347,162741,141394,Yes
AECMandya,Computer Science and Engineering,KCET,2023,61459,68244,17993,24676,172372,147696,No
NCET,Artificial Intelligence and Data Science,COMEDK,2023,220375,62016,14246,25414,322051,296637,No
VVIT,Biotechnology,KCET,2023,69767,75432,15457,19025,179681,160656,No
ACU,Computer Science and Engineering,COMEDK,2024,206747,67556,17095,19830,311228,291398,Yes
PRES,Information Science and Engineering,KCET,2023,82785,75035,16269,22312,196401,174089,No
NHCE,Robotics and Automation Engineering,KCET,2023,66561,73487,8712,28993,177753,148760,Yes
VemanaIT,Robotics and Automation Engineering,KCET,2024,80711,89223,13800,14043,197777,183734,Yes
MSRUAS,Aerospace Engineering,KCET,2023,53472,92034,19311,24162,188979,164817,Yes
VemanaIT,Artificial Intelligence and Data Science,KCET,2024,58281,64022,13321,17381,153005,135624,Yes
AECMandya,Computer Science and Engineering,COMEDK,2024,243464,77967,13933,18487,353851,335364,No
MSRUAS,Chemical Engineering,KCET,2024,65889,68658,15199,15850,165596,149746,No
MVJCE,Artificial Intelligence and Data Science,COMEDK,2024,185509,74466,10436,13407,283818,270411,No
PESU,Information Science and Engineering,KCET,2024,76794,73021,10560,10866,171241,160375,No
SIT,Mechanical Engineering,KCET,2024,69170,90491,15279,21148,196088,174940,No
CMRIT,Civil Engineering,KCET,2024,75667,80959,16305,17381,190312,172931,Yes
BMSCE,Civil Engineering,KCET,2024,81721,77027,12263,19722,190733,171011,No
JSSSTU,Electrical and Electronics Engineering,COMEDK,2023,199215,90142,12240,11583,313180,301597,Yes
AECMandya,Mechanical Engineering,KCET,2023,65548,91709,17089,28483,202829,174346,Yes
VVCE,Electrical and Electronics Engineering,KCET,2024,69076,62970,18824,26347,177217,150870,No
BNMIT,Mechanical Engineering,KCET,2024,64697,63418,14532,28149,170796,142647,No
MSRUAS,Electrical and Electronics Engineering,COMEDK,2024,165278,84646,18179,10665,278768,268103,No
VIT,Mechanical Engineering,COMEDK,2024,173016,84169,18262,10600,286047,275447,Yes
NCET,Civil Engineering,KCET,2023,76185,64707,13143,10054,164089,154035,Yes
KSIT,Mechanical Engineering,KCET,2024,77239,72851,9780,25629,185499,159870,Yes
SITM,Chemical Engineering,COMEDK,2023,201087,80657,14228,26646,322618,295972,Yes
VVCE,Mechanical Engineering,KCET,2023,77318,84613,18889,17037,197857,180820,No
RAIT,Biotechnology,COMEDK,2023,226389,92424,13128,22080,354021,331941,No
JNNCE,Electrical and Electronics Engineering,COMEDK,2023,177541,63045,11405,20739,272730,251991,No
SITM,Biotechnology,COMEDK,2024,165145,63955,12629,15111,256840,241729,No
BIT,Robotics and Automation Engineering,KCET,2023,75150,92158,11410,25953,204671,178718,No
GIT,Information Science and Engineering,COMEDK,2024,204028,63556,9828,20173,297585,277412,No
SJBIT,Electronics and Communication Engineering,COMEDK,2024,182466,67153,18752,26703,295074,268371,No
BMSIT,Electrical and Electronics Engineering,KCET,2024,61894,75245,17943,29609,184691,155082,No
NMIT,Artificial Intelligence and Data Science,KCET,2024,64125,82046,14883,26522,187576,161054,No
PESCE,Civil Engineering,KCET,2023,57639,66465,13536,20416,158056,137640,Yes
CITGubbi,Artificial Intelligence and Data Science,KCET,2023,65475,78642,10108,21193,175418,154225,Yes
BMSIT,Robotics and Automation Engineering,KCET,2023,75278,71109,10868,29276,186531,157255,Yes
BMSCE,Computer Science and Engineering,COMEDK,2024,201635,63083,13444,27025,305187,278162,Yes
KLEIT,Electrical and Electronics Engineering,KCET,2024,54422,68043,14900,10876,148241,137365,No
BMIT,Information Science and Engineering,COMEDK,2023,230026,91976,13295,18055,353352,335297,Yes
SJBIT,Civil Engineering,KCET,2023,72144,88230,15287,27840,203501,175661,No
NIE,Artificial Intelligence and Data Science,KCET,2023,57696,92954,18418,24438,193506,169068,Yes
ACU,Mechanical Engineering,COMEDK,2024,202436,84348,8781,16936,312501,295565,Yes
BNMIT,Electrical and Electronics Engineering,KCET,2023,62684,69294,17862,10271,160111,149840,Yes
RAIT,Aerospace Engineering,COMEDK,2023,245151,67104,19152,18436,349843,331407,Yes
SIT,Electronics and Communication Engineering,COMEDK,2023,186179,73556,12993,16398,289126,272728,No
VIT,Computer Science and Engineering,COMEDK,2024,173970,78390,16787,19765,288912,269147,No
MVJCE,Biotechnology,KCET,2024,61254,72394,8198,21064,162910,141846,Yes
BNMIT,Chemical Engineering,KCET,2023,67316,79455,8138,24253,179162,154909,No
KLSGIT,Robotics and Automation Engineering,COMEDK,2023,205534,93205,15022,17628,331389,313761,Yes
DSATM,Artificial Intelligence and Data Science,COMEDK,2023,232155,70133,15744,20942,338974,318032,Yes
SCEM,Aerospace Engineering,COMEDK,2024,226362,88712,18174,14685,347933,333248,No
SIT,Information Science and Engineering,KCET,2023,73890,79467,19508,12176,185041,172865,No
VVCE,Information Science and Engineering,KCET,2023,76297,80161,19786,20193,196437,176244,Yes
AEC,Robotics and Automation Engineering,KCET,2024,78362,84385,13229,19104,195080,175976,Yes
BNMIT,Robotics and Automation Engineering,COMEDK,2023,186561,79373,8193,24072,298199,274127,No
SITM,Chemical Engineering,KCET,2024,83846,79915,12390,18865,195016,176151,No
HKBK,Electrical and Electronics Engineering,KCET,2023,73495,91399,14857,21239,200990,179751,No
SITM,Chemical Engineering,COMEDK,2023,161870,83004,13469,28525,286868,258343,Yes
KLSGIT,Civil Engineering,KCET,2023,54643,76066,11832,10354,152895,142541,Yes
PESU,Information Science and Engineering,COMEDK,2023,230349,81963,19850,23710,355872,332162,Yes
RVUNIV,Data Science,KCET,2024,63227,74655,15452,20293,173627,153334,No
JIT,Artificial Intelligence and Data Science,KCET,2024,84691,82693,11790,23142,202316,179174,Yes
BMIT,Aerospace Engineering,KCET,2024,74635,84927,11604,23080,194246,171166,No
RVCE,Mechanical Engineering,COMEDK,2024,225051,64294,17711,12886,319942,307056,No
VVIT,Mechanical Engineering,KCET,2023,62937,78656,13074,26640,181307,154667,No
MVJCE,Data Science,COMEDK,2024,202233,80823,9762,23861,316679,292818,No
NCET,Computer Science and Engineering,COMEDK,2024,238735,72936,13350,14566,339587,325021,Yes
JIT,Chemical Engineering,KCET,2023,53565,79019,12182,18833,163599,144766,No
DrAIT,Electronics and Communication Engineering,COMEDK,2024,185274,88511,13045,19008,305838,286830,Yes
JSSSTU,Aerospace Engineering,KCET,2023,50110,83941,12426,18743,165220,146477,Yes
UVCE,Chemical Engineering,COMEDK,2024,226660,87118,11772,10941,336491,325550,No
VVCE,Mechanical Engineering,COMEDK,2024,180993,88883,18923,29104,317903,288799,No
GIT,Artificial Intelligence and Data Science,COMEDK,2023,180687,87596,11204,26353,305840,279487,No
NIE,Information Science and Engineering,COMEDK,2024,174736,74581,11224,21667,282208,260541,Yes
AECMandya,Robotics and Automation Engineering,KCET,2024,81975,81358,8211,29126,200670,171544,Yes
ACU,Information Science and Engineering,KCET,2023,56973,78266,11854,11760,158853,147093,Yes
KSIT,Robotics and Automation Engineering,KCET,2024,77093,62921,10429,26020,176463,150443,Yes
YKCE,Electrical and Electronics Engineering,COMEDK,2023,238243,76157,18811,26060,359271,333211,No
VemanaIT,Electronics and Communication Engineering,COMEDK,2024,182837,68599,19196,13557,284189,270632,No
HKBK,Electronics and Communication Engineering,KCET,2024,83155,63862,14519,20729,182265,161536,Yes
BITM,Aerospace Engineering,COMEDK,2023,222321,62902,10832,18351,314406,296055,Yes
SITM,Electronics and Communication Engineering,KCET,2023,58455,92603,9652,21696,182406,160710,No
EastPoint,Electrical and Electronics Engineering,KCET,2023,61742,64048,12108,17802,155700,137898,No
EastPoint,Aerospace Engineering,COMEDK,2024,243168,66051,14101,21330,344650,323320,Yes
HKBK,Electronics and Communication Engineering,COMEDK,2023,212857,73574,13326,23612,323369,299757,No
PRES,Chemical Engineering,COMEDK,2023,180113,88495,14266,14226,297100,282874,Yes
VIT,Artificial Intelligence and Data Science,KCET,2024,52709,60007,12488,12399,137603,125204,No
BMSCE,Electrical and Electronics Engineering,KCET,2023,73497,84397,18045,21757,197696,175939,No
VVIT,Chemical Engineering,KCET,2023,67926,81735,12816,27465,189942,162477,No
VSM,Artificial Intelligence and Data Science,COMEDK,2023,215243,85947,18684,18800,338674,319874,Yes
MSRIT,Civil Engineering,KCET,2023,58013,85670,14612,27219,185514,158295,No
MVJCE,Mechanical Engineering,KCET,2024,79689,66675,13652,16454,176470,160016,No
SIT,Electronics and Communication Engineering,COMEDK,2024,200840,67244,17119,29217,314420,285203,Yes
AEC,Aerospace Engineering,COMEDK,2024,209218,64056,18299,17460,309033,291573,No
REVA,Electronics and Communication Engineering,KCET,2024,51387,67040,12704,24789,155920,131131,Yes
NHCE,Electrical and Electronics Engineering,KCET,2024,75582,65238,10739,18088,169647,151559,No
AIT,Civil Engineering,COMEDK,2024,171500,91376,18483,16232,297591,281359,Yes
PRES,Biotechnology,COMEDK,2024,179656,79862,8628,21697,289843,268146,No
SCEM,Electrical and Electronics Engineering,COMEDK,2024,185938,79015,17977,21716,304646,282930,No
REVA,Civil Engineering,KCET,2023,69909,74684,12932,24385,181910,157525,Yes
VemanaIT,Aerospace Engineering,COMEDK,2023,247453,91266,9569,16226,364514,348288,No
SCEM,Artificial Intelligence and Data Science,KCET,2023,72063,90966,9817,10747,183593,172846,Yes
SDMCET,Mechanical Engineering,COMEDK,2023,242459,88127,11063,29238,370887,341649,Yes
VVCE,Computer Science and Engineering,KCET,2024,83733,94352,16338,27223,221646,194423,Yes
UVCE,Computer Science and Engineering,COMEDK,2023,195222,74862,17392,11533,299009,287476,No
JNNCE,Robotics and Automation Engineering,KCET,2023,50482,82376,10600,29637,173095,143458,Yes
ACU,Biotechnology,COMEDK,2024,241990,83830,17250,22779,365849,343070,Yes
UVCE,Electronics and Communication Engineering,COMEDK,2023,180330,77007,15089,15110,287536,272426,Yes
RVCE,Data Science,KCET,2023,52048,81999,9909,11922,155878,143956,No
MVJCE,Information Science and Engineering,KCET,2024,79544,86676,15765,29252,211237,181985,Yes
DSATM,Information Science and Engineering,COMEDK,2023,244993,68711,8107,23024,344835,321811,No
KSIT,Chemical Engineering,KCET,2023,81193,73551,17443,12453,184640,172187,No
RNSIT,Data Science,KCET,2023,78748,79626,11998,25206,195578,170372,Yes
JNNCE,Artificial Intelligence and Data Science,COMEDK,2024,227789,75996,8177,15071,327033,311962,Yes
VIT,Aerospace Engineering,COMEDK,2024,191519,92244,19486,14763,318012,303249,No
JIT,Data Science,KCET,2023,70807,76934,8061,27879,183681,155802,Yes
SITM,Biotechnology,COMEDK,2024,212373,84430,15253,12782,324838,312056,Yes
VSM,Mechanical Engineering,COMEDK,2023,167280,79479,15838,24417,287014,262597,Yes
DSATM,Mechanical Engineering,COMEDK,2024,221522,94295,19982,19264,355063,335799,Yes
VSM,Chemical Engineering,KCET,2023,67262,88881,10474,20221,186838,166617,No
NCET,Artificial Intelligence and Data Science,KCET,2024,69775,88704,9319,21080,188878,167798,Yes
BMSIT,Computer Science and Engineering,COMEDK,2023,199970,68219,14385,18989,301563,282574,Yes
JSSSTU,Artificial Intelligence and Data Science,COMEDK,2024,177654,77107,14747,20528,290036,269508,No
SDMIT,Artificial Intelligence and Data Science,COMEDK,2023,221169,76233,8979,11114,317495,306381,No
BIT,Data Science,COMEDK,2023,172518,73018,8519,15820,269875,254055,No
KSIT,Data Science,KCET,2024,75413,82146,12840,29846,200245,170399,Yes
UVCE,Data Science,COMEDK,2023,185281,69701,13273,12024,280279,268255,No
DBIT,Biotechnology,COMEDK,2023,222181,83090,16822,29382,351475,322093,No
AITM,Robotics and Automation Engineering,COMEDK,2024,208782,69389,9071,28034,315276,287242,Yes
PESU,Chemical Engineering,COMEDK,2023,166689,79207,11401,25016,282313,257297,No
SDMCET,Electrical and Electronics Engineering,KCET,2024,78352,69535,17021,21543,186451,164908,No
RAIT,Electrical and Electronics Engineering,COMEDK,2023,239661,80356,9011,21752,350780,329028,No
KLSGIT,Aerospace Engineering,COMEDK,2024,249795,90281,15856,19891,375823,355932,Yes
RNSIT,Artificial Intelligence and Data Science,COMEDK,2023,195306,75477,14381,18975,304139,285164,No
AIT,Robotics and Automation Engineering,KCET,2023,80615,77645,18772,20544,197576,177032,No
RVUNIV,Information Science and Engineering,COMEDK,2023,205609,88761,19076,12274,325720,313446,Yes
AECMandya,Civil Engineering,KCET,2024,67798,72642,17882,17825,176147,158322,No
NHCE,Data Science,KCET,2023,60070,88909,15259,26905,191143,164238,No
MSRIT,Biotechnology,KCET,2024,75204,87107,8664,24319,195294,170975,No
KSIT,Civil Engineering,KCET,2024,53869,68534,17754,24110,164267,140157,No
GMIT,Electronics and Communication Engineering,COMEDK,2023,214668,93400,10039,10685,328792,318107,No
KLSGIT,Information Science and Engineering,KCET,2023,75156,67245,12251,17944,172596,154652,Yes
SJBCE,Information Science and Engineering,COMEDK,2024,165665,80841,19490,20171,286167,265996,No
RVCE,Information Science and Engineering,KCET,2024,73354,63548,17589,14471,168962,154491,Yes
DrAIT,Electrical and Electronics Engineering,COMEDK,2024,220971,94078,15502,15375,345926,330551,Yes
VIT,Artificial Intelligence and Data Science,COMEDK,2023,238997,83652,10729,15455,348833,333378,No
VemanaIT,Electrical and Electronics Engineering,KCET,2024,77257,61709,12009,15791,166766,150975,Yes
KLSGIT,Biotechnology,COMEDK,2024,238249,76881,11782,29175,356087,326912,Yes
VVIT,Civil Engineering,COMEDK,2024,178500,66492,11694,20418,277104,256686,Yes
SDMIT,Civil Engineering,COMEDK,2023,244959,78756,19106,27358,370179,342821,Yes
EastPoint,Aerospace Engineering,KCET,2023,70814,60805,19730,23268,174617,151349,No
SDMIT,Aerospace Engineering,COMEDK,2023,242263,62969,12474,10523,328229,317706,No
AITM,Civil Engineering,COMEDK,2024,205915,75803,11700,12996,306414,293418,Yes
RVUNIV,Mechanical Engineering,KCET,2023,77071,89248,18092,29297,213708,184411,Yes
PESU,Artificial Intelligence and Data Science,KCET,2024,50999,66122,8683,24036,149840,125804,No
DrAIT,Biotechnology,KCET,2023,57188,79481,9836,16279,162784,146505,No
DSATM,Chemical Engineering,KCET,2023,59981,85134,8878,23250,177243,153993,Yes
JSSSTU,Electrical and Electronics Engineering,KCET,2024,79028,74205,8158,28696,190087,161391,Yes
AIT,Civil Engineering,COMEDK,2023,179548,91619,12458,14017,297642,283625,No
DBIT,Mechanical Engineering,KCET,2023,69629,89719,15693,10380,185421,175041,No
DrAIT,Aerospace Engineering,KCET,2023,53083,68472,15363,12230,149148,136918,No
VVCE,Civil Engineering,COMEDK,2023,211793,81979,15840,27314,336926,309612,No
DSCE,Information Science and Engineering,KCET,2023,74957,80392,18560,12787,186696,173909,No
BMSIT,Information Science and Engineering,KCET,2023,80935,82090,10216,11658,184899,173241,Yes
VVIT,Artificial Intelligence and Data Science,KCET,2023,70652,82857,10570,12854,176933,164079,No
DBIT,Information Science and Engineering,KCET,2023,50012,86505,12207,15911,164635,148724,No
SDMIT,Electrical and Electronics Engineering,COMEDK,2024,236086,81007,10970,28622,356685,328063,Yes
SIT,Data Science,KCET,2023,79854,91670,8987,11079,191590,180511,Yes
SITM,Robotics and Automation Engineering,COMEDK,2023,171241,60169,9492,25318,266220,240902,No
VVCE,Civil Engineering,KCET,2023,54075,63770,11656,14973,144474,129501,No
DSATM,Computer Science and Engineering,KCET,2023,82361,72525,9904,14292,179082,164790,No
MVJCE,Chemical Engineering,COMEDK,2023,214444,93205,14403,18475,340527,322052,No
SJBIT,Electronics and Communication Engineering,COMEDK,2023,178835,86520,10340,23719,299414,275695,No
NMIT,Robotics and Automation Engineering,KCET,2023,68125,93688,10771,12870,185454,172584,Yes
NMIT,Mechanical Engineering,COMEDK,2024,216068,87546,12158,25863,341635,315772,No
RVUNIV,Information Science and Engineering,COMEDK,2023,161071,77861,16376,13598,268906,255308,No
PESU,Electronics and Communication Engineering,KCET,2024,74595,70009,11220,18548,174372,155824,Yes
RAIT,Chemical Engineering,COMEDK,2024,187433,94011,8637,29149,319230,290081,No
SDMCET,Computer Science and Engineering,KCET,2024,52147,75783,10059,26079,164068,137989,Yes
RVCE,Mechanical Engineering,COMEDK,2024,249266,87203,10485,26975,373929,346954,No
RAIT,Aerospace Engineering,COMEDK,2023,243536,86107,9829,25092,364564,339472,Yes
PESCE,Electrical and Electronics Engineering,KCET,2024,72477,88089,15026,13390,188982,175592,Yes
UVCE,Aerospace Engineering,KCET,2024,82098,60962,8362,13677,165099,151422,No
BIT,Electronics and Communication Engineering,COMEDK,2024,214714,66704,17961,25025,324404,299379,No
GMIT,Aerospace Engineering,KCET,2023,63881,66793,14444,15592,160710,145118,Yes
AEC,Computer Science and Engineering,COMEDK,2023,189293,65470,8718,21105,284586,263481,No
ACU,Robotics and Automation Engineering,COMEDK,2023,238663,79644,15706,17625,351638,334013,Yes
SJBCE,Computer Science and Engineering,COMEDK,2024,241124,79974,16742,13018,350858,337840,Yes
KSIT,Civil Engineering,COMEDK,2023,216907,83115,11883,29565,341470,311905,No
DSCE,Mechanical Engineering,COMEDK,2023,249709,72894,19097,14363,356063,341700,No
SDMIT,Electrical and Electronics Engineering,COMEDK,2024,191890,72077,15511,10404,289882,279478,No
PESCE,Data Science,KCET,2023,79918,81288,19939,15523,196668,181145,Yes
VemanaIT,Chemical Engineering,COMEDK,2024,191959,72808,11650,13401,289818,276417,Yes
BMSIT,Chemical Engineering,KCET,2023,57395,61242,15636,21926,156199,134273,No
ACU,Civil Engineering,COMEDK,2024,188512,70819,10815,14422,284568,270146,Yes
YKCE,Information Science and Engineering,KCET,2023,68020,79422,17501,24002,188945,164943,Yes
VemanaIT,Artificial Intelligence and Data Science,KCET,2023,53474,89619,10970,19101,173164,154063,No
DrAIT,Biotechnology,COMEDK,2024,166325,62244,9096,10883,248548,237665,No
AECMandya,Robotics and Automation Engineering,COMEDK,2023,242744,89171,12019,13437,357371,343934,Yes
GMIT,Computer Science and Engineering,KCET,2024,77776,76819,9328,14676,178599,163923,Yes
SJBIT,Electrical and Electronics Engineering,KCET,2023,77738,73896,18787,10527,180948,170421,Yes
SITM,Civil Engineering,COMEDK,2023,172870,72684,15197,25348,286099,260751,Yes
BNMIT,Aerospace Engineering,KCET,2023,69885,88499,17019,19940,195343,175403,Yes
GIT,Information Science and Engineering,COMEDK,2024,233501,80578,16376,12080,342535,330455,Yes
BMIT,Robotics and Automation Engineering,KCET,2023,82733,94209,19184,21579,217705,196126,Yes
PESU,Aerospace Engineering,KCET,2023,62406,75327,11917,10536,160186,149650,No
VemanaIT,Information Science and Engineering,COMEDK,2024,162368,71990,13990,28814,277162,248348,No
JIT,Computer Science and Engineering,KCET,2023,78660,71336,11527,24969,186492,161523,No
SDMCET,Artificial Intelligence and Data Science,KCET,2024,67791,90374,8272,29988,196425,166437,Yes
SDMIT,Electronics and Communication Engineering,KCET,2024,74051,86849,10577,16998,188475,171477,No
RIT,Robotics and Automation Engineering,KCET,2024,53174,81819,17719,29444,182156,152712,Yes
KLSGIT,Robotics and Automation Engineering,COMEDK,2024,214450,92237,14798,16885,338370,321485,Yes
NCET,Mechanical Engineering,COMEDK,2024,247576,81108,17994,26073,372751,346678,Yes
JSSSTU,Civil Engineering,KCET,2023,53920,62433,14867,29730,160950,131220,Yes
RIT,Electrical and Electronics Engineering,KCET,2023,79863,70859,12462,29647,192831,163184,Yes
GIT,Computer Science and Engineering,KCET,2024,60366,62213,15887,22011,160477,138466,Yes
MVJCE,Robotics and Automation Engineering,COMEDK,2024,198161,76247,10399,28312,313119,284807,Yes
VemanaIT,Biotechnology,COMEDK,2024,227803,71951,9671,16378,325803,309425,No
GMIT,Artificial Intelligence and Data Science,KCET,2024,69041,62051,19495,27865,178452,150587,No
SJBCE,Computer Science and Engineering,KCET,2023,69710,80011,11709,21651,183081,161430,Yes
SCEM,Mechanical Engineering,KCET,2024,81427,73679,8637,23304,187047,163743,Yes
KLSGIT,Electrical and Electronics Engineering,COMEDK,2024,169057,86846,14020,15314,285237,269923,Yes
VSM,Aerospace Engineering,KCET,2024,53459,77729,13423,26042,170653,144611,Yes
SDMIT,Biotechnology,KCET,2024,66037,60251,18715,24843,169846,145003,Yes
UVCE,Biotechnology,COMEDK,2023,208534,76459,11314,17072,313379,296307,Yes
VemanaIT,Biotechnology,COMEDK,2024,194647,85380,17628,25918,323573,297655,Yes
RAIT,Electrical and Electronics Engineering,KCET,2023,50210,86413,10766,17347,164736,147389,No
VIT,Data Science,KCET,2024,81744,70259,16268,23272,191543,168271,Yes
NIE,Electrical and Electronics Engineering,COMEDK,2024,228270,63712,17205,24002,333189,309187,Yes
BMSCE,Mechanical Engineering,KCET,2023,77506,74091,14722,23777,190096,166319,No
DSATM,Information Science and Engineering,COMEDK,2024,214761,73035,14572,26007,328375,302368,No
PRES,Biotechnology,KCET,2023,62825,79924,13813,14746,171308,156562,Yes
RVUNIV,Data Science,KCET,2024,74246,75716,14617,28873,193452,164579,No
NCET,Mechanical Engineering,KCET,2024,79396,87953,13796,21924,203069,181145,Yes
RIT,Civil Engineering,KCET,2024,68336,64484,13946,24625,171391,146766,No
YKCE,Chemical Engineering,KCET,2024,57378,92165,8228,22545,180316,157771,No
MVJCE,Electronics and Communication Engineering,COMEDK,2023,178611,93108,19439,23437,314595,291158,Yes
SDMCET,Information Science and Engineering,KCET,2024,74833,86724,11568,11723,184848,173125,No
SDMCET,Electrical and Electronics Engineering,KCET,2023,68282,69939,19026,25528,182775,157247,Yes
RVUNIV,Computer Science and Engineering,COMEDK,2023,174499,87578,18456,18831,299364,280533,Yes
VVIT,Computer Science and Engineering,COMEDK,2024,212263,79691,13728,18418,324100,305682,No
YKCE,Electronics and Communication Engineering,KCET,2024,62520,90053,11563,23269,187405,164136,No
UVCE,Artificial Intelligence and Data Science,COMEDK,2024,213534,93853,16365,28084,351836,323752,Yes
RVUNIV,Data Science,KCET,2023,55084,88653,19890,21508,185135,163627,Yes
REVA,Chemical Engineering,COMEDK,2023,185574,78491,19211,24195,307471,283276,Yes
AITM,Electronics and Communication Engineering,COMEDK,2024,239120,69999,18520,16658,344297,327639,No
MSRIT,Aerospace Engineering,KCET,2024,79541,72886,14418,25436,192281,166845,Yes
DrAIT,Civil Engineering,KCET,2023,60709,73797,12712,21062,168280,147218,No
NMIT,Computer Science and Engineering,COMEDK,2024,183414,75900,12895,13117,285326,272209,No
NHCE,Artificial Intelligence and Data Science,KCET,2024,67340,72596,16399,24712,181047,156335,No
DBIT,Biotechnology,KCET,2023,63964,78505,12336,25817,180622,154805,No
DSATM,Electronics and Communication Engineering,COMEDK,2023,202582,67833,9149,21441,301005,279564,No
YKCE,Mechanical Engineering,KCET,2024,67508,66370,15798,17534,167210,149676,Yes
BNMIT,Electronics and Communication Engineering,COMEDK,2023,186201,90572,19189,27950,323912,295962,No
RVCE,Robotics and Automation Engineering,KCET,2023,54709,78306,11392,25473,169880,144407,Yes
SITM,Robotics and Automation Engineering,KCET,2023,67075,67424,10265,11800,156564,144764,No
AIT,Data Science,KCET,2023,78026,64518,19171,25506,187221,161715,No
CMRIT,Aerospace Engineering,COMEDK,2024,235207,69513,17376,10870,332966,322096,Yes
VIT,Mechanical Engineering,COMEDK,2023,204894,88136,16204,26280,335514,309234,Yes
NHCE,Biotechnology,COMEDK,2024,195544,90312,10865,22432,319153,296721,Yes
BMSIT,Electronics and Communication Engineering,COMEDK,2024,175300,72270,11062,20167,278799,258632,Yes
MSRUAS,Mechanical Engineering,KCET,2024,76399,76047,13021,15069,180536,165467,No
SITM,Electrical and Electronics Engineering,KCET,2024,63388,72030,9064,13603,158085,144482,Yes
KLEIT,Chemical Engineering,COMEDK,2024,191180,65888,18523,28700,304291,275591,Yes
MSRIT,Information Science and Engineering,COMEDK,2024,236705,78957,18576,12180,346418,334238,Yes
PESCE,Biotechnology,KCET,2024,80451,86364,9370,29807,205992,176185,Yes
UVCE,Electrical and Electronics Engineering,KCET,2023,66154,74517,13298,15931,169900,153969,Yes
JNNCE,Civil Engineering,KCET,2024,63909,87339,16562,22360,190170,167810,Yes
CMRIT,Computer Science and Engineering,KCET,2023,50774,81927,15049,16144,163894,147750,Yes
SITM,Biotechnology,COMEDK,2023,212275,82220,13909,22652,331056,308404,No
GMIT,Civil Engineering,KCET,2023,58133,81363,8193,20664,168353,147689,No
KSIT,Civil Engineering,COMEDK,2023,168209,68790,14901,16721,268621,251900,No
RIT,Civil Engineering,COMEDK,2023,236233,72889,9368,23787,342277,318490,No
GIT,Chemical Engineering,COMEDK,2024,183521,80073,13692,24607,301893,277286,No
SITM,Artificial Intelligence and Data Science,KCET,2024,64735,79331,8223,15765,168054,152289,Yes
EastPoint,Mechanical Engineering,KCET,2024,81291,71423,15136,23820,191670,167850,Yes
NIE,Information Science and Engineering,KCET,2023,57165,72710,17168,29478,176521,147043,No
SDMIT,Mechanical Engineering,COMEDK,2023,215033,94610,14691,17868,342202,324334,Yes
NHCE,Computer Science and Engineering,KCET,2024,55813,93525,8915,19367,177620,158253,No
GMIT,Biotechnology,COMEDK,2023,205365,84055,14321,24711,328452,303741,Yes
PESCE,Biotechnology,KCET,2024,71324,72067,12892,26467,182750,156283,No
NMIT,Artificial Intelligence and Data Science,COMEDK,2023,178544,75969,12556,16669,283738,267069,Yes
VVCE,Electrical and Electronics Engineering,COMEDK,2024,244504,65411,17225,19876,347016,327140,No
RVUNIV,Civil Engineering,KCET,2023,63551,72513,10091,17539,163694,146155,Yes
ACU,Chemical Engineering,COMEDK,2024,193116,82536,9645,26734,312031,285297,No
MSRIT,Biotechnology,COMEDK,2024,205610,83750,19520,16944,325824,308880,Yes
NHCE,Aerospace Engineering,COMEDK,2023,210512,68095,10830,29291,318728,289437,Yes
GMIT,Artificial Intelligence and Data Science,COMEDK,2024,222402,71443,8928,25443,328216,302773,No
RNSIT,Mechanical Engineering,COMEDK,2023,209455,68144,19835,15874,313308,297434,Yes
AIT,Electronics and Communication Engineering,COMEDK,2023,193450,81678,12466,26753,314347,287594,No
VVIT,Aerospace Engineering,COMEDK,2023,211498,80070,8259,11735,311562,299827,No
RIT,Data Science,COMEDK,2023,172791,90084,9572,20863,293310,272447,Yes
SDMCET,Aerospace Engineering,COMEDK,2023,166615,62241,16395,15907,261158,245251,No
BNMIT,Mechanical Engineering,KCET,2024,61225,79588,19369,27018,187200,160182,No
NIE,Robotics and Automation Engineering,KCET,2024,73138,62192,18983,22820,177133,154313,No
CITGubbi,Electrical and Electronics Engineering,KCET,2024,69611,91111,10436,10468,181626,171158,Yes
HKBK,Electrical and Electronics Engineering,COMEDK,2024,238828,73462,16586,18202,347078,328876,Yes
AIT,Biotechnology,KCET,2024,69345,60975,9520,10293,150133,139840,No
NIE,Artificial Intelligence and Data Science,COMEDK,2023,221408,78933,8730,16309,325380,309071,Yes
JSSSTU,Information Science and Engineering,KCET,2024,68323,84645,8374,18762,180104,161342,No
NIE,Biotechnology,COMEDK,2024,220154,83359,18013,16358,337884,321526,No
MVJCE,Electrical and Electronics Engineering,COMEDK,2023,221065,83268,18446,13346,336125,322779,No
AITM,Biotechnology,COMEDK,2024,169575,62068,17479,26812,275934,249122,No
AECMandya,Robotics and Automation Engineering,COMEDK,2023,200726,89160,14018,13507,317411,303904,No
PRES,Robotics and Automation Engineering,COMEDK,2023,216190,93876,14550,26307,350923,324616,Yes
DSATM,Biotechnology,KCET,2024,78910,65552,10531,19183,174176,154993,No
MSRUAS,Aerospace Engineering,KCET,2024,62467,76364,19789,17928,176548,158620,No
KSIT,Electronics and Communication Engineering,KCET,2023,52734,75736,19050,24806,172326,147520,Yes
VemanaIT,Computer Science and Engineering,KCET,2024,65097,76911,11338,21107,174453,153346,Yes
UVCE,Biotechnology,KCET,2024,67612,94900,19415,15738,197665,181927,No
RAIT,Computer Science and Engineering,KCET,2023,60252,94611,19542,17555,191960,174405,Yes
AECMandya,Artificial Intelligence and Data Science,KCET,2024,74893,75578,11489,10311,172271,161960,No
RAIT,Data Science,KCET,2024,57723,83759,13122,18846,173450,154604,Yes
JSSSTU,Robotics and Automation Engineering,COMEDK,2024,206924,89769,10950,29654,337297,307643,Yes
BMSIT,Computer Science and Engineering,KCET,2024,78724,84383,18987,26827,208921,182094,No
BMIT,Artificial Intelligence and Data Science,COMEDK,2023,196020,91414,18206,27108,332748,305640,Yes
MVJCE,Biotechnology,KCET,2024,62555,75391,14505,18601,171052,152451,No
VemanaIT,Information Science and Engineering,COMEDK,2024,232115,84278,12568,13973,342934,328961,No
VemanaIT,Civil Engineering,KCET,2023,80495,91044,13580,28532,213651,185119,Yes
BNMIT,Biotechnology,KCET,2024,53094,76012,15873,26257,171236,144979,Yes
GIT,Data Science,COMEDK,2024,212156,93795,17681,24392,348024,323632,Yes
JNNCE,Electronics and Communication Engineering,COMEDK,2024,191779,75915,13412,29065,310171,281106,No
AIT,Civil Engineering,COMEDK,2024,161264,67791,9881,15597,254533,238936,Yes
HKBK,Biotechnology,COMEDK,2024,229955,78946,13727,14417,337045,322628,No
SITM,Electrical and Electronics Engineering,COMEDK,2024,186515,62471,11222,29845,290053,260208,Yes
RNSIT,Data Science,KCET,2023,77340,94574,13935,13572,199421,185849,No
SJBIT,Chemical Engineering,COMEDK,2024,211383,61191,9764,20990,303328,282338,No
HKBK,Electrical and Electronics Engineering,KCET,2023,57259,73610,10022,14708,155599,140891,Yes
PESU,Civil Engineering,KCET,2024,82877,79510,9493,24780,196660,171880,No
AEC,Electronics and Communication Engineering,KCET,2024,82542,65765,18541,17214,184062,166848,No
VIT,Chemical Engineering,KCET,2024,57558,60766,16497,13881,148702,134821,Yes
VSM,Computer Science and Engineering,KCET,2024,58803,93188,12605,16138,180734,164596,Yes
BMSIT,Computer Science and Engineering,KCET,2024,65102,69824,19022,26570,180518,153948,Yes
NMIT,Civil Engineering,KCET,2024,73556,89547,19475,21669,204247,182578,No
RAIT,Information Science and Engineering,KCET,2023,78722,78043,16188,18278,191231,172953,No
RNSIT,Mechanical Engineering,KCET,2023,83014,91182,13711,12735,200642,187907,No
JNNCE,Artificial Intelligence and Data Science,COMEDK,2024,247419,81395,17620,22133,368567,346434,No
VSM,Chemical Engineering,KCET,2023,81591,90058,18087,23499,213235,189736,No
PRES,Electrical and Electronics Engineering,KCET,2023,74033,92159,17083,23424,206699,183275,Yes
RVUNIV,Artificial Intelligence and Data Science,COMEDK,2024,180385,92075,12200,25621,310281,284660,No
KLSGIT,Biotechnology,COMEDK,2023,237145,66724,12761,10012,326642,316630,Yes
UVCE,Robotics and Automation Engineering,KCET,2024,75771,91211,12826,22761,202569,179808,Yes
MSRIT,Electrical and Electronics Engineering,KCET,2024,70879,86927,8376,24591,190773,166182,Yes
NMIT,Civil Engineering,KCET,2024,79277,84569,17656,17913,199415,181502,Yes
RIT,Biotechnology,KCET,2024,84024,75031,19590,15643,194288,178645,No
KSIT,Mechanical Engineering,KCET,2023,54314,94951,11353,23982,184600,160618,No
ACU,Chemical Engineering,KCET,2023,54127,78603,8959,10159,151848,141689,Yes
UVCE,Electrical and Electronics Engineering,KCET,2023,82887,84258,13297,28940,209382,180442,No
VIT,Data Science,KCET,2023,60208,89590,11331,11343,172472,161129,No
PRES,Mechanical Engineering,KCET,2023,68442,77392,12173,26165,184172,158007,No
VVIT,Robotics and Automation Engineering,COMEDK,2024,167756,78752,10927,29667,287102,257435,Yes
RVUNIV,Aerospace Engineering,COMEDK,2023,188204,88002,13528,10618,300352,289734,No
PRES,Data Science,COMEDK,2024,188627,81721,10139,26129,306616,280487,Yes
NHCE,Artificial Intelligence and Data Science,KCET,2023,61281,72992,14837,11123,160233,149110,Yes
DSATM,Mechanical Engineering,KCET,2024,79062,69565,18778,17383,184788,167405,No
RAIT,Mechanical Engineering,COMEDK,2023,221526,64199,9663,10398,305786,295388,Yes
NIE,Artificial Intelligence and Data Science,KCET,2023,57842,88324,16374,14204,176744,162540,No
BNMIT,Aerospace Engineering,COMEDK,2024,203638,79918,12706,27648,323910,296262,No
BMSCE,Biotechnology,COMEDK,2024,228176,63282,8305,26979,326742,299763,No
AITM,Information Science and Engineering,KCET,2024,55432,66963,18844,21623,162862,141239,Yes
GMIT,Artificial Intelligence and Data Science,COMEDK,2023,177019,93521,10566,14230,295336,281106,Yes
PRES,Artificial Intelligence and Data Science,COMEDK,2023,208008,66482,18915,17273,310678,293405,Yes
PESCE,Robotics and Automation Engineering,COMEDK,2023,167558,69593,10063,28831,276045,247214,No
RVCE,Mechanical Engineering,COMEDK,2024,164414,72424,10628,12406,259872,247466,No
GMIT,Civil Engineering,COMEDK,2023,215973,64631,12773,25391,318768,293377,No
PESU,Computer Science and Engineering,KCET,2024,60634,65928,9134,16025,151721,135696,Yes
BMSIT,Robotics and Automation Engineering,KCET,2024,70220,62266,11303,28460,172249,143789,No
MVJCE,Biotechnology,COMEDK,2024,239873,81470,14732,24650,360725,336075,Yes
PESU,Robotics and Automation Engineering,COMEDK,2024,164724,90848,15554,25725,296851,271126,Yes
AITM,Mechanical Engineering,COMEDK,2024,223523,85291,16658,16103,341575,325472,Yes
PESCE,Information Science and Engineering,KCET,2024,77582,85822,10840,19673,193917,174244,No
AITM,Computer Science and Engineering,KCET,2023,65082,84767,9619,28293,187761,159468,No
AEC,Data Science,COMEDK,2024,218432,88532,17824,17706,342494,324788,No
BNMIT,Aerospace Engineering,COMEDK,2024,175559,77201,16265,14803,283828,269025,No
RIT,Data Science,KCET,2024,82738,86713,15669,12810,197930,185120,Yes
MSRIT,Electronics and Communication Engineering,COMEDK,2024,204959,73000,14115,15045,307119,292074,Yes
SJBIT,Electronics and Communication Engineering,KCET,2024,56046,90614,10526,12564,169750,157186,No
RAIT,Electronics and Communication Engineering,KCET,2023,76968,94269,11369,27886,210492,182606,Yes
SCEM,Information Science and Engineering,COMEDK,2023,231314,87464,9577,20020,348375,328355,Yes
UVCE,Civil Engineering,COMEDK,2024,207251,65664,19102,11039,303056,292017,No
AIT,Mechanical Engineering,KCET,2024,82348,78382,14708,27897,203335,175438,Yes
UVCE,Computer Science and Engineering,KCET,2024,73071,87181,16337,22052,198641,176589,No
BITM,Robotics and Automation Engineering,KCET,2023,51977,79142,11242,11237,153598,142361,Yes
SDMCET,Biotechnology,KCET,2024,53654,87761,11316,23775,176506,152731,No
GIT,Biotechnology,COMEDK,2024,232112,77042,11459,23487,344100,320613,No
EastPoint,Computer Science and Engineering,KCET,2024,69208,69949,12607,14616,166380,151764,Yes
BMIT,Aerospace Engineering,COMEDK,2023,188391,92211,13537,13269,307408,294139,No
BITM,Robotics and Automation Engineering,KCET,2024,76084,71963,16545,27602,192194,164592,No
HKBK,Aerospace Engineering,COMEDK,2024,175926,85037,9145,19955,290063,270108,Yes
VVIT,Civil Engineering,COMEDK,2023,227841,75359,19028,24665,346893,322228,Yes
BITM,Information Science and Engineering,COMEDK,2023,212853,91007,10487,25000,339347,314347,Yes
BMIT,Information Science and Engineering,KCET,2024,62448,90490,12451,11778,177167,165389,No
PESCE,Electronics and Communication Engineering,COMEDK,2024,238564,73520,16287,25988,354359,328371,No
KSIT,Robotics and Automation Engineering,KCET,2023,73489,91178,17336,20647,202650,182003,Yes
DSCE,Computer Science and Engineering,COMEDK,2024,240153,84139,10594,24998,359884,334886,Yes
NMIT,Data Science,KCET,2024,53600,83636,10569,15977,163782,147805,Yes
BMSCE,Aerospace Engineering,COMEDK,2024,241993,79841,19856,15687,357377,341690,No
BITM,Biotechnology,KCET,2024,65064,90875,13862,29568,199369,169801,No
SDMIT,Civil Engineering,KCET,2024,74193,84450,10443,11979,181065,169086,No
VSM,Artificial Intelligence and Data Science,COMEDK,2024,185620,74225,19326,24250,303421,279171,Yes
GMIT,Civil Engineering,COMEDK,2024,236172,66483,18494,17906,339055,321149,No
HKBK,Data Science,KCET,2024,55638,76826,8543,26015,167022,141007,Yes
RAIT,Data Science,COMEDK,2023,244476,92865,14337,13408,365086,351678,No
RAIT,Robotics and Automation Engineering,KCET,2024,72365,69545,17956,10848,170714,159866,Yes
CMRIT,Biotechnology,COMEDK,2024,228633,90281,19981,22690,361585,338895,Yes
BNMIT,Computer Science and Engineering,KCET,2023,61573,78508,10738,28770,179589,150819,No
AECMandya,Computer Science and Engineering,KCET,2024,76805,86419,16447,28639,208310,179671,No
MSRIT,Artificial Intelligence and Data Science,KCET,2024,80244,80744,8798,24617,194403,169786,No
GMIT,Information Science and Engineering,COMEDK,2023,229931,86883,15531,24208,356553,332345,No
CMRIT,Chemical Engineering,KCET,2024,83249,75647,19493,21667,200056,178389,Yes
AEC,Electrical and Electronics Engineering,COMEDK,2024,177380,69602,11923,25931,284836,258905,Yes
VVCE,Electronics and Communication Engineering,KCET,2024,53943,75213,19513,14174,162843,148669,Yes
BIT,Aerospace Engineering,KCET,2024,63421,87462,12595,21233,184711,163478,No
KLEIT,Civil Engineering,KCET,2023,79523,60618,9897,28390,178428,150038,Yes
SIT,Aerospace Engineering,KCET,2023,80971,76411,10574,24374,192330,167956,Yes
BIT,Artificial Intelligence and Data Science,KCET,2023,55030,77365,11602,25321,169318,143997,No
GIT,Chemical Engineering,COMEDK,2024,176377,64153,19502,12005,272037,260032,Yes
VSM,Information Science and Engineering,COMEDK,2024,218680,71370,11211,27351,328612,301261,Yes
JIT,Artificial Intelligence and Data Science,COMEDK,2023,178649,66756,18173,10313,273891,263578,Yes
BMSCE,Information Science and Engineering,KCET,2024,77825,76949,8790,14963,178527,163564,Yes
RIT,Computer Science and Engineering,KCET,2024,82368,67699,17824,27559,195450,167891,No
MSRUAS,Electrical and Electronics Engineering,COMEDK,2023,191350,72105,14786,26208,304449,278241,No
BNMIT,Civil Engineering,KCET,2024,63264,90874,13412,22179,189729,167550,Yes
KLSGIT,Electronics and Communication Engineering,KCET,2023,67569,60744,11886,25741,165940,140199,Yes
KLEIT,Chemical Engineering,COMEDK,2023,207415,66997,17158,10815,302385,291570,No
YKCE,Artificial Intelligence and Data Science,COMEDK,2024,178229,67241,19808,19448,284726,265278,Yes
MSRIT,Civil Engineering,COMEDK,2023,222586,81040,15538,25585,344749,319164,No
JIT,Artificial Intelligence and Data Science,COMEDK,2024,207897,80835,18258,11314,318304,306990,Yes
VVIT,Computer Science and Engineering,COMEDK,2023,200102,93990,11776,28963,334831,305868,Yes
UVCE,Electronics and Communication Engineering,COMEDK,2023,200786,87388,18630,16850,323654,306804,No
CMRIT,Computer Science and Engineering,COMEDK,2024,164764,88204,16825,21577,291370,269793,No
KLSGIT,Robotics and Automation Engineering,KCET,2023,51506,90609,8080,20050,170245,150195,No
RIT,Electrical and Electronics Engineering,COMEDK,2024,176729,89210,17522,20454,303915,283461,No
NIE,Robotics and Automation Engineering,KCET,2023,61931,88241,10193,19801,180166,160365,No
BMSCE,Robotics and Automation Engineering,COMEDK,2023,179550,68923,16404,20825,285702,264877,Yes
BIT,Robotics and Automation Engineering,COMEDK,2023,198997,66065,10587,13175,288824,275649,No
AIT,Information Science and Engineering,COMEDK,2023,202806,67620,19408,11694,301528,289834,No
CMRIT,Civil Engineering,KCET,2023,51957,89573,17728,27947,187205,159258,Yes
SJBCE,Electrical and Electronics Engineering,COMEDK,2023,183284,70925,19658,11012,284879,273867,No
RAIT,Data Science,KCET,2023,52089,72372,12717,17062,154240,137178,No
KSIT,Mechanical Engineering,COMEDK,2023,237865,62374,16874,27911,345024,317113,No
AEC,Data Science,KCET,2023,82121,65122,18236,21358,186837,165479,Yes
MSRIT,Aerospace Engineering,COMEDK,2024,184202,78375,13686,28698,304961,276263,No
AECMandya,Electronics and Communication Engineering,KCET,2023,69328,84338,17678,22324,193668,171344,No
AITM,Electrical and Electronics Engineering,KCET,2024,79995,93249,15345,28970,217559,188589,No
JNNCE,Robotics and Automation Engineering,COMEDK,2023,197068,72134,17915,18384,305501,287117,Yes
SDMIT,Electronics and Communication Engineering,KCET,2024,73838,85426,8196,29551,197011,167460,Yes
VVCE,Chemical Engineering,COMEDK,2023,171888,76086,8882,26283,283139,256856,No
PRES,Artificial Intelligence and Data Science,COMEDK,2024,221825,80875,15639,19119,337458,318339,No
YKCE,Electronics and Communication Engineering,COMEDK,2023,233894,94001,12800,20482,361177,340695,Yes
VVIT,Information Science and Engineering,COMEDK,2024,193141,88291,17401,21562,320395,298833,Yes
AECMandya,Computer Science and Engineering,KCET,2024,50855,86898,19120,24473,181346,156873,Yes
AITM,Aerospace Engineering,KCET,2023,58005,72426,13710,21121,165262,144141,Yes
NCET,Biotechnology,COMEDK,2023,249425,74214,12786,25924,362349,336425,No
SJBCE,Chemical Engineering,KCET,2024,82861,79451,10732,20898,193942,173044,Yes
MSRIT,Biotechnology,KCET,2023,65997,76801,9098,25364,177260,151896,Yes
BIT,Robotics and Automation Engineering,KCET,2024,66437,75876,13193,26074,181580,155506,No
VemanaIT,Computer Science and Engineering,COMEDK,2023,229388,73508,16475,13760,333131,319371,No
AIT,Electronics and Communication Engineering,KCET,2023,61981,92944,11409,27603,193937,166334,Yes
KLSGIT,Civil Engineering,KCET,2024,77708,68589,13698,10217,170212,159995,Yes
DSCE,Chemical Engineering,COMEDK,2023,216379,92071,18664,19889,347003,327114,No
NHCE,Computer Science and Engineering,COMEDK,2024,160590,90720,15277,15409,281996,266587,Yes
HKBK,Information Science and Engineering,KCET,2023,67817,70257,12740,14515,165329,150814,Yes
NHCE,Artificial Intelligence and Data Science,KCET,2023,59498,76150,16238,25854,177740,151886,Yes
MSRUAS,Civil Engineering,KCET,2023,76882,79354,19148,24853,200237,175384,Yes
PESU,Electronics and Communication Engineering,COMEDK,2023,222103,94622,8679,11282,336686,325404,No
SCEM,Biotechnology,COMEDK,2024,216442,81865,18741,26737,343785,317048,Yes
VSM,Information Science and Engineering,KCET,2024,68462,86151,19068,13860,187541,173681,No
SDMIT,Civil Engineering,COMEDK,2024,218249,66423,18029,18826,321527,302701,No
NMIT,Electronics and Communication Engineering,KCET,2023,54199,77962,13684,15585,161430,145845,No
MSRUAS,Artificial Intelligence and Data Science,KCET,2023,52971,90985,18129,20200,182285,162085,No
KSIT,Chemical Engineering,COMEDK,2023,214578,90522,14087,26487,345674,319187,No
NMIT,Computer Science and Engineering,KCET,2024,62771,72682,8854,11351,155658,144307,No
SJBCE,Chemical Engineering,KCET,2023,75261,80126,12749,18499,186635,168136,Yes
AEC,Computer Science and Engineering,COMEDK,2023,216208,79403,17162,20682,333455,312773,No
BMSCE,Aerospace Engineering,COMEDK,2023,184665,83769,15815,15237,299486,284249,No
VSM,Information Science and Engineering,COMEDK,2023,204226,68747,17559,29641,320173,290532,Yes
REVA,Chemical Engineering,KCET,2024,61870,66691,9079,11187,148827,137640,Yes
SCEM,Computer Science and Engineering,COMEDK,2023,177491,89385,12087,27811,306774,278963,Yes
GIT,Electrical and Electronics Engineering,KCET,2023,61871,81718,16318,17895,177802,159907,No
BMSIT,Robotics and Automation Engineering,COMEDK,2023,175753,78064,10763,24717,289297,264580,No
KSIT,Civil Engineering,COMEDK,2024,163933,89693,15014,11122,279762,268640,Yes
BITM,Electrical and Electronics Engineering,KCET,2023,75776,74034,12202,16497,178509,162012,Yes
MVJCE,Robotics and Automation Engineering,KCET,2024,54470,85491,16434,14332,170727,156395,Yes
AITM,Artificial Intelligence and Data Science,KCET,2023,70454,68371,8586,21062,168473,147411,No
SDMIT,Chemical Engineering,COMEDK,2023,213949,67787,16016,24054,321806,297752,No
JNNCE,Mechanical Engineering,KCET,2024,65403,67604,13505,18652,165164,146512,Yes
GIT,Civil Engineering,COMEDK,2024,212414,67007,19868,22743,322032,299289,Yes
ACU,Civil Engineering,KCET,2024,52220,83590,10971,19190,165971,146781,Yes
ACU,Artificial Intelligence and Data Science,COMEDK,2024,211966,70678,17411,26936,326991,300055,Yes
RVUNIV,Civil Engineering,KCET,2024,66554,76487,14911,12751,170703,157952,No
AEC,Civil Engineering,COMEDK,2024,221813,69063,9503,23136,323515,300379,No
MSRUAS,Biotechnology,KCET,2024,50279,68767,13627,22765,155438,132673,No
VSM,Biotechnology,COMEDK,2023,238344,85206,18910,15217,357677,342460,No
VIT,Computer Science and Engineering,KCET,2023,80629,68422,8374,21892,179317,157425,Yes
BITM,Data Science,COMEDK,2023,248844,79103,8502,27031,363480,336449,No
MVJCE,Mechanical Engineering,KCET,2023,81412,82896,10304,13154,187766,174612,No
SJBIT,Chemical Engineering,COMEDK,2023,241587,77163,15395,17162,351307,334145,Yes
VSM,Biotechnology,COMEDK,2023,236676,76063,18759,25250,356748,331498,No
AECMandya,Computer Science and Engineering,COMEDK,2023,223417,64661,11032,22192,321302,299110,Yes
SJBIT,Artificial Intelligence and Data Science,COMEDK,2024,228732,77412,17566,11172,334882,323710,No
VVIT,Chemical Engineering,KCET,2024,58222,86233,9810,28052,182317,154265,Yes
AIT,Artificial Intelligence and Data Science,KCET,2024,80764,93793,15746,27116,217419,190303,Yes
ACU,Electronics and Communication Engineering,COMEDK,2024,171866,62445,17455,25024,276790,251766,No
DrAIT,Biotechnology,KCET,2023,77465,93520,16751,13599,201335,187736,Yes
JSSSTU,Electronics and Communication Engineering,COMEDK,2024,201667,79626,11370,19941,312604,292663,No
PESU,Biotechnology,KCET,2023,82062,70686,17701,28160,198609,170449,No
SITM,Civil Engineering,KCET,2024,67516,76596,18929,21516,184557,163041,Yes
VemanaIT,Chemical Engineering,COMEDK,2024,184647,69582,14564,28248,297041,268793,Yes
GMIT,Electrical and Electronics Engineering,COMEDK,2024,212127,92953,11261,15030,331371,316341,Yes
SIT,Chemical Engineering,KCET,2023,69544,63727,15405,16481,165157,148676,Yes
BITM,Computer Science and Engineering,COMEDK,2023,249144,90586,10935,20458,371123,350665,Yes
SJBIT,Aerospace Engineering,KCET,2024,66524,73415,19616,23645,183200,159555,No
NIE,Mechanical Engineering,COMEDK,2023,172890,70973,17427,17628,278918,261290,No
RNSIT,Biotechnology,COMEDK,2023,193477,79386,13922,19460,306245,286785,No
PRES,Robotics and Automation Engineering,KCET,2024,73752,83828,8723,17037,183340,166303,No
AIT,Data Science,COMEDK,2023,242413,86558,14103,18520,361594,343074,No
JNNCE,Artificial Intelligence and Data Science,KCET,2024,71446,65976,8243,21145,166810,145665,No
DSATM,Electronics and Communication Engineering,KCET,2024,79894,90466,15580,12387,198327,185940,Yes
AIT,Electrical and Electronics Engineering,KCET,2024,72627,72028,12193,27017,183865,156848,Yes
RVUNIV,Civil Engineering,COMEDK,2024,173004,90079,16313,18478,297874,279396,Yes
KLEIT,Mechanical Engineering,KCET,2024,68746,74711,9742,23312,176511,153199,No
KSIT,Biotechnology,COMEDK,2024,169195,86721,12494,10165,278575,268410,No
MVJCE,Chemical Engineering,COMEDK,2024,199905,60131,19402,16198,295636,279438,Yes
AIT,Chemical Engineering,KCET,2023,84888,93435,12726,23437,214486,191049,No
SJBIT,Computer Science and Engineering,KCET,2023,67895,73198,13374,23128,177595,154467,Yes
CITGubbi,Electronics and Communication Engineering,COMEDK,2024,212640,67002,8175,21431,309248,287817,Yes
PESU,Information Science and Engineering,COMEDK,2024,237198,71706,11645,10575,331124,320549,No
ACU,Robotics and Automation Engineering,KCET,2024,59985,91753,12085,22828,186651,163823,No
NHCE,Aerospace Engineering,COMEDK,2023,168145,67274,18598,18082,272099,254017,No
GIT,Mechanical Engineering,KCET,2023,82883,62502,18132,22746,186263,163517,No
JSSSTU,Biotechnology,KCET,2023,63200,90255,11425,25702,190582,164880,No
MSRUAS,Mechanical Engineering,KCET,2024,50868,92943,11233,22417,177461,155044,Yes
PESCE,Electrical and Electronics Engineering,COMEDK,2024,181843,93008,19217,23304,317372,294068,No
HKBK,Information Science and Engineering,COMEDK,2024,228345,66366,18951,20610,334272,313662,No
DrAIT,Chemical Engineering,KCET,2023,50227,77140,12627,17451,157445,139994,No
PRES,Aerospace Engineering,COMEDK,2024,168932,73800,17238,28655,288625,259970,Yes
YKCE,Artificial Intelligence and Data Science,KCET,2023,68957,84195,8257,13464,174873,161409,No
SDMCET,Biotechnology,COMEDK,2024,160448,68884,17294,20808,267434,246626,No
JIT,Biotechnology,COMEDK,2024,199136,84803,9731,21897,315567,293670,No
DSATM,Aerospace Engineering,COMEDK,2023,233126,74304,16736,11552,335718,324166,Yes
AEC,Civil Engineering,KCET,2024,79624,66574,14130,18030,178358,160328,No
BMSIT,Artificial Intelligence and Data Science,KCET,2023,65529,86906,13555,28886,194876,165990,No
DSCE,Data Science,KCET,2024,70080,62887,9294,17676,159937,142261,Yes
DrAIT,Aerospace Engineering,KCET,2024,81824,87127,9092,21759,199802,178043,Yes
EastPoint,Electronics and Communication Engineering,COMEDK,2024,217906,70061,8517,18991,315475,296484,Yes
AECMandya,Electronics and Communication Engineering,COMEDK,2024,194961,93887,8898,24920,322666,297746,No
AIT,Robotics and Automation Engineering,KCET,2024,78117,73322,9266,27807,188512,160705,No
RVUNIV,Biotechnology,COMEDK,2023,212050,90739,9967,29304,342060,312756,No
SDMIT,Computer Science and Engineering,KCET,2023,71851,72880,12539,23840,181110,157270,Yes
AITM,Information Science and Engineering,KCET,2024,59022,66694,13188,11500,150404,138904,Yes
MSRIT,Information Science and Engineering,KCET,2024,75551,91483,19494,12280,198808,186528,No
HKBK,Data Science,COMEDK,2023,197719,81470,18916,14037,312142,298105,Yes
SJBIT,Civil Engineering,COMEDK,2023,219357,61721,11455,17672,310205,292533,No
VVCE,Information Science and Engineering,KCET,2024,50858,79768,18721,16495,165842,149347,No
MSRUAS,Computer Science and Engineering,COMEDK,2023,248009,71418,13461,15427,348315,332888,Yes
VVIT,Civil Engineering,COMEDK,2024,162076,67781,15484,21364,266705,245341,Yes
VemanaIT,Aerospace Engineering,COMEDK,2024,202688,80847,17009,27983,328527,300544,No
RAIT,Chemical Engineering,COMEDK,2023,202035,89618,12289,10643,314585,303942,Yes
DBIT,Robotics and Automation Engineering,COMEDK,2023,230750,80152,18804,19343,349049,329706,No
CITGubbi,Chemical Engineering,COMEDK,2024,205468,72876,12672,23735,314751,291016,No
SJBCE,Aerospace Engineering,COMEDK,2023,172691,83579,10906,24435,291611,267176,Yes
JNNCE,Mechanical Engineering,KCET,2023,52955,71426,8576,13084,146041,132957,Yes
AIT,Chemical Engineering,KCET,2024,73929,71084,8251,22406,175670,153264,Yes
DrAIT,Mechanical Engineering,KCET,2024,77474,94456,11469,11352,194751,183399,Yes
VVIT,Robotics and Automation Engineering,KCET,2024,70306,92588,12799,17334,193027,175693,No
SITM,Artificial Intelligence and Data Science,COMEDK,2024,162491,79717,8748,19350,270306,250956,No
AITM,Electronics and Communication Engineering,KCET,2023,57041,89075,16039,22927,185082,162155,No
GIT,Biotechnology,COMEDK,2024,211309,86805,18646,17801,334561,316760,No
DrAIT,Computer Science and Engineering,KCET,2024,82865,84555,18479,11149,197048,185899,No
BITM,Robotics and Automation Engineering,COMEDK,2023,170001,91578,16446,20503,298528,278025,No
VSM,Mechanical Engineering,COMEDK,2024,164762,65421,18647,22527,271357,248830,Yes
REVA,Biotechnology,COMEDK,2023,197351,60456,8164,24541,290512,265971,Yes
DBIT,Mechanical Engineering,KCET,2023,65913,69908,9586,26674,172081,145407,No
JNNCE,Artificial Intelligence and Data Science,COMEDK,2023,201840,85731,14286,15135,316992,301857,No
AECMandya,Information Science and Engineering,COMEDK,2023,206586,74312,16403,18354,315655,297301,Yes
EastPoint,Data Science,KCET,2024,69599,92772,14472,10149,186992,176843,No
RVCE,Biotechnology,KCET,2024,51839,65581,10093,29759,157272,127513,Yes
KLSGIT,Civil Engineering,COMEDK,2024,227224,61779,18029,21027,328059,307032,No
AITM,Artificial Intelligence and Data Science,COMEDK,2024,237547,70186,10743,13250,331726,318476,Yes
AEC,Artificial Intelligence and Data Science,KCET,2024,72396,86198,14414,26651,199659,173008,Yes
JNNCE,Electronics and Communication Engineering,KCET,2023,53312,60203,17031,10044,140590,130546,Yes
GMIT,Information Science and Engineering,COMEDK,2024,183629,60507,10631,16504,271271,254767,No
REVA,Information Science and Engineering,COMEDK,2024,240880,80371,14200,23146,358597,335451,No
CMRIT,Mechanical Engineering,KCET,2023,50961,60112,19991,16984,148048,131064,Yes
DrAIT,Aerospace Engineering,COMEDK,2024,180177,94716,11477,24372,310742,286370,Yes
DSCE,Biotechnology,COMEDK,2023,182328,82564,16319,21785,302996,281211,Yes
BNMIT,Civil Engineering,KCET,2023,56513,81795,17703,27798,183809,156011,No
DBIT,Artificial Intelligence and Data Science,KCET,2024,75739,85110,14745,16817,192411,175594,Yes
SITM,Aerospace Engineering,COMEDK,2024,201786,91773,14096,10186,317841,307655,Yes
AECMandya,Aerospace Engineering,KCET,2023,50290,86309,16991,15594,169184,153590,No
BNMIT,Information Science and Engineering,COMEDK,2023,233225,62980,18381,28982,343568,314586,Yes
GIT,Artificial Intelligence and Data Science,KCET,2023,54649,78920,13802,27298,174669,147371,Yes
JSSSTU,Information Science and Engineering,KCET,2024,83820,77433,15565,26668,203486,176818,No
NCET,Robotics and Automation Engineering,COMEDK,2023,220953,71494,15211,20426,328084,307658,Yes
MSRUAS,Chemical Engineering,COMEDK,2024,215663,64914,14624,19943,315144,295201,No
RVUNIV,Electrical and Electronics Engineering,COMEDK,2024,170042,83485,14214,22819,290560,267741,No
NCET,Biotechnology,KCET,2023,75676,82031,16203,23051,196961,173910,Yes
JIT,Information Science and Engineering,KCET,2023,68774,79276,15079,11077,174206,163129,No
BMIT,Chemical Engineering,KCET,2023,64321,85509,19351,23523,192704,169181,Yes
MSRUAS,Artificial Intelligence and Data Science,KCET,2024,53894,78098,15704,22430,170126,147696,Yes
GMIT,Electronics and Communication Engineering,COMEDK,2023,165754,82065,8646,12008,268473,256465,No
REVA,Robotics and Automation Engineering,COMEDK,2024,229639,74663,10061,14719,329082,314363,No
AIT,Electrical and Electronics Engineering,COMEDK,2023,212348,88234,14554,22750,337886,315136,Yes
JSSSTU,Data Science,KCET,2024,55308,82523,14659,10980,163470,152490,Yes
SITM,Biotechnology,KCET,2023,67958,62495,8888,12329,151670,139341,Yes
SDMIT,Chemical Engineering,KCET,2023,72767,92954,9245,12408,187374,174966,No
MVJCE,Chemical Engineering,COMEDK,2024,232719,71395,11553,17072,332739,315667,No
VVIT,Mechanical Engineering,COMEDK,2023,232110,74427,13402,17874,337813,319939,Yes
REVA,Aerospace Engineering,COMEDK,2024,240952,63046,10142,27592,341732,314140,Yes
UVCE,Artificial Intelligence and Data Science,COMEDK,2023,190374,61159,11894,12585,276012,263427,No
MVJCE,Robotics and Automation Engineering,COMEDK,2023,198749,65931,10719,11374,286773,275399,No
AEC,Aerospace Engineering,KCET,2024,66709,69459,16897,22104,175169,153065,No
RIT,Information Science and Engineering,COMEDK,2023,192293,65126,15608,24894,297921,273027,No
VemanaIT,Data Science,COMEDK,2023,189063,89296,8271,15840,302470,286630,Yes
VSM,Information Science and Engineering,KCET,2024,60980,62192,13587,24646,161405,136759,Yes
DSATM,Electronics and Communication Engineering,KCET,2024,61640,61199,8769,13843,145451,131608,Yes
BITM,Chemical Engineering,KCET,2024,58860,79678,8434,11285,158257,146972,Yes
SDMIT,Mechanical Engineering,KCET,2024,80847,65925,19393,10387,176552,166165,Yes
MSRIT,Mechanical Engineering,KCET,2023,62965,69771,17066,14861,164663,149802,Yes
DSATM,Civil Engineering,COMEDK,2023,189137,80787,12563,12543,295030,282487,Yes
CMRIT,Civil Engineering,COMEDK,2023,221358,83883,18376,24217,347834,323617,No
AIT,Artificial Intelligence and Data Science,KCET,2023,80782,75659,18869,22982,198292,175310,No
AIT,Chemical Engineering,COMEDK,2024,183435,74940,18314,21512,298201,276689,No
DSCE,Electronics and Communication Engineering,KCET,2024,68285,60128,18346,12293,159052,146759,Yes
VVIT,Robotics and Automation Engineering,KCET,2024,71100,68783,8970,13508,162361,148853,No
PESU,Information Science and Engineering,COMEDK,2023,201134,66819,8516,25483,301952,276469,Yes
DrAIT,Chemical Engineering,COMEDK,2023,237477,78656,19106,15624,350863,335239,Yes
SDMIT,Civil Engineering,COMEDK,2023,226014,70780,19054,22566,338414,315848,Yes
SITM,Biotechnology,COMEDK,2023,241585,84381,8469,23339,357774,334435,No
RVCE,Robotics and Automation Engineering,KCET,2024,63386,61017,11683,28485,164571,136086,No
BMSCE,Chemical Engineering,COMEDK,2023,193329,92767,16478,10879,313453,302574,No
VVCE,Aerospace Engineering,COMEDK,2023,216093,64802,16639,20500,318034,297534,Yes
PESU,Biotechnology,COMEDK,2024,238162,93081,11229,15321,357793,342472,Yes
BITM,Robotics and Automation Engineering,KCET,2024,50417,64896,12213,14801,142327,127526,Yes
MVJCE,Artificial Intelligence and Data Science,KCET,2023,82541,64530,8963,15653,171687,156034,No
MSRIT,Civil Engineering,COMEDK,2023,233199,92180,13824,23281,362484,339203,No
SDMIT,Data Science,KCET,2023,66437,71019,19632,14958,172046,157088,No
RVUNIV,Computer Science and Engineering,COMEDK,2023,222229,71698,18113,23266,335306,312040,No
UVCE,Computer Science and Engineering,COMEDK,2024,185638,79815,16354,27379,309186,281807,Yes
MSRUAS,Civil Engineering,COMEDK,2024,191135,71597,12514,28111,303357,275246,No
SCEM,Biotechnology,KCET,2024,70520,66686,9318,29570,176094,146524,No
EastPoint,Mechanical Engineering,COMEDK,2024,182381,89801,14810,14069,301061,286992,No
BMSCE,Biotechnology,COMEDK,2023,169109,88728,12220,12984,283041,270057,No
MVJCE,Information Science and Engineering,COMEDK,2024,166324,71978,15276,13636,267214,253578,Yes
DSATM,Mechanical Engineering,KCET,2023,59762,83205,18242,10525,171734,161209,Yes
DSATM,Computer Science and Engineering,COMEDK,2023,184620,92936,11804,25022,314382,289360,Yes
MVJCE,Aerospace Engineering,KCET,2024,83856,81955,18722,19073,203606,184533,Yes
BMSIT,Electrical and Electronics Engineering,COMEDK,2024,164190,81956,10092,29494,285732,256238,Yes
AIT,Electronics and Communication Engineering,KCET,2023,72180,70386,12806,11198,166570,155372,Yes
RNSIT,Computer Science and Engineering,KCET,2024,62758,85357,14878,21287,184280,162993,No
EastPoint,Artificial Intelligence and Data Science,COMEDK,2024,226654,74960,19530,12004,333148,321144,No
BMIT,Mechanical Engineering,COMEDK,2023,227006,81706,11299,22876,342887,320011,Yes
ACU,Information Science and Engineering,COMEDK,2024,211307,73202,14291,24464,323264,298800,Yes
MSRIT,Computer Science and Engineering,COMEDK,2023,191293,71708,9399,14695,287095,272400,Yes
PRES,Biotechnology,KCET,2023,67906,79238,14512,16076,177732,161656,No
PESCE,Biotechnology,COMEDK,2024,226720,73534,15994,19468,335716,316248,No
BMIT,Information Science and Engineering,COMEDK,2024,167510,72957,14490,27602,282559,254957,No
NIE,Data Science,COMEDK,2024,174637,75759,15822,27800,294018,266218,Yes
SITM,Electronics and Communication Engineering,COMEDK,2023,181943,63072,19322,16654,280991,264337,No
SIT,Chemical Engineering,COMEDK,2024,162215,77686,15171,23597,278669,255072,Yes
VVIT,Data Science,KCET,2023,68941,82775,19255,25661,196632,170971,No
VIT,Artificial Intelligence and Data Science,COMEDK,2024,196073,80710,11422,26526,314731,288205,Yes
RNSIT,Computer Science and Engineering,COMEDK,2023,191229,79178,12335,27707,310449,282742,Yes
UVCE,Robotics and Automation Engineering,KCET,2024,57622,82335,8907,10902,159766,148864,Yes
MSRUAS,Electronics and Communication Engineering,COMEDK,2023,180113,72937,12665,20450,286165,265715,No
VVIT,Biotechnology,KCET,2023,64970,89281,13918,13767,181936,168169,Yes
MVJCE,Chemical Engineering,COMEDK,2023,178716,78526,18457,16292,291991,275699,No
JNNCE,Electrical and Electronics Engineering,COMEDK,2024,243287,79429,9190,24984,356890,331906,No
VVIT,Computer Science and Engineering,COMEDK,2024,161807,65315,16071,18993,262186,243193,Yes
REVA,Artificial Intelligence and Data Science,COMEDK,2024,194791,72710,13869,26090,307460,281370,No
MSRIT,Artificial Intelligence and Data Science,KCET,2023,74615,69042,14018,16600,174275,157675,Yes
BMSIT,Civil Engineering,COMEDK,2023,194358,73171,8029,12836,288394,275558,No
SDMCET,Chemical Engineering,KCET,2024,51805,91473,19911,22329,185518,163189,No
BITM,Civil Engineering,COMEDK,2024,160553,73646,12708,24201,271108,246907,Yes
CITGubbi,Mechanical Engineering,KCET,2024,69051,94452,18361,24449,206313,181864,No
PESU,Computer Science and Engineering,KCET,2024,55567,89301,19156,15071,179095,164024,No
BMIT,Robotics and Automation Engineering,KCET,2024,72998,62707,12290,28046,176041,147995,No
GIT,Artificial Intelligence and Data Science,COMEDK,2023,239286,84234,16839,27035,367394,340359,No
PESCE,Robotics and Automation Engineering,COMEDK,2024,203969,84696,17730,25115,331510,306395,Yes
PESCE,Electrical and Electronics Engineering,COMEDK,2023,234171,74796,12898,19607,341472,321865,No
BMSCE,Artificial Intelligence and Data Science,COMEDK,2024,210545,65811,10377,13129,299862,286733,Yes
NHCE,Electronics and Communication Engineering,COMEDK,2024,234055,87312,13403,16548,351318,334770,No
BIT,Electronics and Communication Engineering,COMEDK,2024,185250,87910,15611,19984,308755,288771,Yes
VemanaIT,Chemical Engineering,COMEDK,2023,233376,74613,13004,16676,337669,320993,No
RVCE,Data Science,COMEDK,2024,236074,75254,15913,13702,340943,327241,Yes
RIT,Chemical Engineering,COMEDK,2023,247052,69893,19168,16006,352119,336113,Yes
JNNCE,Computer Science and Engineering,KCET,2023,79595,90306,16479,24382,210762,186380,No
NMIT,Electrical and Electronics Engineering,KCET,2024,83679,90545,18377,24176,216777,192601,No
RNSIT,Electrical and Electronics Engineering,KCET,2024,52925,81502,18798,16893,170118,153225,No
YKCE,Data Science,COMEDK,2024,232960,70518,15495,17609,336582,318973,Yes
REVA,Artificial Intelligence and Data Science,COMEDK,2023,225678,87771,10102,14287,337838,323551,No
AIT,Data Science,COMEDK,2023,198791,92773,13590,12450,317604,305154,No
DSCE,Electrical and Electronics Engineering,KCET,2023,61726,70591,12730,28408,173455,145047,Yes
KLEIT,Artificial Intelligence and Data Science,KCET,2023,53341,60614,16604,10903,141462,130559,No
BMIT,Data Science,KCET,2023,51939,86804,13060,11572,163375,151803,No
NHCE,Civil Engineering,COMEDK,2024,218449,73332,18943,14161,324885,310724,Yes
PRES,Robotics and Automation Engineering,COMEDK,2024,187254,83185,9897,17833,298169,280336,No
NIE,Mechanical Engineering,COMEDK,2024,203076,66150,16759,13464,299449,285985,No
MVJCE,Information Science and Engineering,KCET,2024,55220,91902,13768,21913,182803,160890,Yes
VVIT,Civil Engineering,KCET,2023,79044,67279,11464,25026,182813,157787,No
DSCE,Computer Science and Engineering,COMEDK,2024,167876,67354,16905,29117,281252,252135,No
KSIT,Electronics and Communication Engineering,COMEDK,2023,185986,61774,9520,28060,285340,257280,No
JSSSTU,Electronics and Communication Engineering,KCET,2024,54153,85169,15306,27099,181727,154628,No
NCET,Civil Engineering,COMEDK,2024,191465,77300,12866,15721,297352,281631,Yes
SJBIT,Artificial Intelligence and Data Science,KCET,2023,77188,72594,10000,13680,173462,159782,No
VSM,Biotechnology,COMEDK,2023,228605,88349,11259,15280,343493,328213,No
PESU,Artificial Intelligence and Data Science,COMEDK,2024,213434,67197,14312,29666,324609,294943,No
MSRUAS,Robotics and Automation Engineering,KCET,2024,79606,75229,16282,29053,200170,171117,No
DrAIT,Robotics and Automation Engineering,COMEDK,2023,223011,79367,10346,14254,326978,312724,No
SJBIT,Mechanical Engineering,KCET,2024,81093,66590,12720,27922,188325,160403,Yes
RAIT,Artificial Intelligence and Data Science,COMEDK,2024,219136,63664,14375,10054,307229,297175,Yes
RVUNIV,Data Science,COMEDK,2024,243277,65341,13577,25046,347241,322195,Yes
CMRIT,Information Science and Engineering,COMEDK,2024,234473,60827,14543,17601,327444,309843,Yes
BNMIT,Civil Engineering,COMEDK,2023,190631,64594,15041,28913,299179,270266,No
YKCE,Robotics and Automation Engineering,KCET,2023,54256,82499,9958,14661,161374,146713,No
SDMCET,Artificial Intelligence and Data Science,COMEDK,2023,247086,64057,16456,22161,349760,327599,Yes
REVA,Chemical Engineering,KCET,2023,68435,67159,19670,10199,165463,155264,No
SDMIT,Computer Science and Engineering,KCET,2023,53141,65472,13857,21257,153727,132470,Yes
BMIT,Computer Science and Engineering,COMEDK,2023,231452,78936,19935,26664,356987,330323,Yes
KSIT,Electronics and Communication Engineering,COMEDK,2023,224947,64228,11163,23294,323632,300338,No
RIT,Information Science and Engineering,KCET,2023,63517,83881,12884,18412,178694,160282,Yes
AITM,Mechanical Engineering,COMEDK,2023,160434,64147,15848,11800,252229,240429,Yes
PESCE,Aerospace Engineering,COMEDK,2023,248939,72416,16133,18184,355672,337488,Yes
NHCE,Robotics and Automation Engineering,KCET,2023,59169,66603,11659,24603,162034,137431,Yes
KLSGIT,Computer Science and Engineering,COMEDK,2024,220869,84653,19775,12859,338156,325297,Yes
BMSIT,Chemical Engineering,COMEDK,2023,163099,89294,14904,10318,277615,267297,Yes
JIT,Mechanical Engineering,KCET,2024,74687,71494,11334,20807,178322,157515,Yes
KLEIT,Mechanical Engineering,KCET,2024,70176,66167,10422,29758,176523,146765,Yes
RIT,Electronics and Communication Engineering,COMEDK,2023,243410,80157,19596,11309,354472,343163,No
AIT,Chemical Engineering,KCET,2024,62803,73076,8485,10514,154878,144364,Yes
UVCE,Biotechnology,COMEDK,2023,188433,67902,16927,28799,302061,273262,Yes
RVUNIV,Mechanical Engineering,COMEDK,2024,232638,82713,14939,28541,358831,330290,Yes
ACU,Mechanical Engineering,COMEDK,2024,216284,87982,13548,24007,341821,317814,No
BNMIT,Chemical Engineering,KCET,2024,80690,73700,18538,17422,190350,172928,No
PESU,Electrical and Electronics Engineering,KCET,2024,84066,68029,13022,23874,188991,165117,Yes
MSRUAS,Computer Science and Engineering,KCET,2024,80638,66201,11157,12662,170658,157996,Yes
MSRUAS,Aerospace Engineering,KCET,2024,66149,87749,19696,26259,199853,173594,No
GIT,Robotics and Automation Engineering,COMEDK,2024,194712,75520,16801,15264,302297,287033,No
AIT,Biotechnology,KCET,2023,52696,81619,19236,17794,171345,153551,Yes
NHCE,Data Science,KCET,2024,77362,61924,16285,20886,176457,155571,No
BIT,Electrical and Electronics Engineering,KCET,2024,59440,70289,19650,28211,177590,149379,No
VemanaIT,Electronics and Communication Engineering,COMEDK,2023,199724,74510,17134,14468,305836,291368,No
DrAIT,Aerospace Engineering,COMEDK,2023,201993,78038,8974,15238,304243,289005,No
CITGubbi,Robotics and Automation Engineering,KCET,2023,81363,90914,15626,15670,203573,187903,Yes
DSATM,Biotechnology,COMEDK,2024,237013,83546,8863,29071,358493,329422,Yes
PESU,Data Science,COMEDK,2024,161182,85596,17418,14346,278542,264196,No
DSCE,Mechanical Engineering,COMEDK,2024,189924,93520,9733,29404,322581,293177,Yes
BITM,Data Science,COMEDK,2024,246735,93454,18135,19893,378217,358324,No
AEC,Civil Engineering,COMEDK,2023,222930,85214,18489,26382,353015,326633,Yes
CMRIT,Computer Science and Engineering,KCET,2024,67613,83987,8306,27460,187366,159906,Yes
AIT,Biotechnology,KCET,2023,75782,69369,10115,26830,182096,155266,Yes
ACU,Information Science and Engineering,KCET,2023,52419,72009,19092,24093,167613,143520,Yes
RAIT,Civil Engineering,KCET,2024,76271,78604,19405,22085,196365,174280,Yes
DSCE,Robotics and Automation Engineering,KCET,2024,81691,84204,8597,22344,196836,174492,No
CMRIT,Aerospace Engineering,COMEDK,2024,221559,86356,12706,21360,341981,320621,No
DSCE,Artificial Intelligence and Data Science,COMEDK,2023,175833,86487,12717,19177,294214,275037,Yes
JNNCE,Civil Engineering,COMEDK,2024,248366,75105,17585,12775,353831,341056,No
JSSSTU,Electrical and Electronics Engineering,COMEDK,2024,212949,80738,14888,28629,337204,308575,No
VVCE,Robotics and Automation Engineering,KCET,2023,62014,89877,10350,22179,184420,162241,No
HKBK,Biotechnology,KCET,2024,66610,85363,12834,23855,188662,164807,No
UVCE,Chemical Engineering,KCET,2024,64043,93474,18497,24484,200498,176014,Yes
NIE,Data Science,COMEDK,2024,234122,73412,11089,29917,348540,318623,Yes
MVJCE,Mechanical Engineering,KCET,2023,78810,62194,18444,20595,180043,159448,No
DBIT,Electrical and Electronics Engineering,KCET,2023,69220,86006,10161,19973,185360,165387,Yes
SDMCET,Biotechnology,KCET,2024,66883,66916,9040,10089,152928,142839,No
SJBCE,Biotechnology,COMEDK,2023,188470,63647,13278,14969,280364,265395,No
BITM,Data Science,COMEDK,2024,162970,74042,12654,19180,268846,249666,Yes
JSSSTU,Artificial Intelligence and Data Science,KCET,2024,51559,69375,11006,24839,156779,131940,Yes
RNSIT,Electronics and Communication Engineering,KCET,2023,62719,85882,16943,21046,186590,165544,Yes
SJBCE,Robotics and Automation Engineering,COMEDK,2024,185486,94661,19027,20149,319323,299174,Yes
SDMCET,Artificial Intelligence and Data Science,COMEDK,2023,217450,93009,16572,18308,345339,327031,Yes
KLEIT,Electronics and Communication Engineering,COMEDK,2024,219812,71575,17733,19881,329001,309120,No
BMSIT,Civil Engineering,COMEDK,2024,236816,81230,15164,17688,350898,333210,No
DSCE,Electrical and Electronics Engineering,KCET,2024,69155,61443,11972,15433,158003,142570,Yes
BMSIT,Mechanical Engineering,KCET,2023,60080,64329,11469,26734,162612,135878,Yes
KSIT,Data Science,COMEDK,2024,193209,86605,11887,16008,307709,291701,Yes
JSSSTU,Mechanical Engineering,COMEDK,2024,226931,63989,19178,20590,330688,310098,No
VSM,Civil Engineering,COMEDK,2023,184362,66731,9518,12598,273209,260611,No
PRES,Computer Science and Engineering,KCET,2024,52579,61974,17482,17788,149823,132035,Yes
REVA,Biotechnology,COMEDK,2023,215573,88986,13934,22029,340522,318493,No
GIT,Information Science and Engineering,COMEDK,2023,175895,89728,8189,12925,286737,273812,Yes
KLEIT,Electronics and Communication Engineering,COMEDK,2024,195109,73273,17543,28963,314888,285925,Yes
NMIT,Robotics and Automation Engineering,COMEDK,2024,246154,68859,19573,23830,358416,334586,No
UVCE,Electronics and Communication Engineering,KCET,2023,83292,65633,13016,14431,176372,161941,Yes
RVUNIV,Artificial Intelligence and Data Science,KCET,2024,55316,66825,19997,21311,163449,142138,No
SIT,Civil Engineering,COMEDK,2024,241532,61236,18832,13882,335482,321600,No
KSIT,Information Science and Engineering,KCET,2024,57057,73719,17307,11109,159192,148083,Yes
VVCE,Data Science,KCET,2023,70782,62404,18200,16133,167519,151386,No
SCEM,Chemical Engineering,KCET,2024,57330,93526,9048,17869,177773,159904,No
BMIT,Electrical and Electronics Engineering,COMEDK,2024,160228,90061,17895,11950,280134,268184,Yes
UVCE,Civil Engineering,COMEDK,2023,223077,80102,16916,23135,343230,320095,Yes
DrAIT,Electrical and Electronics Engineering,KCET,2023,78602,63279,8623,29472,179976,150504,No
GMIT,Biotechnology,KCET,2023,83116,87378,19376,12002,201872,189870,Yes
UVCE,Artificial Intelligence and Data Science,COMEDK,2023,243021,60678,19188,10457,333344,322887,Yes
BMSCE,Information Science and Engineering,KCET,2024,62439,88620,19752,20784,191595,170811,Yes
NMIT,Chemical Engineering,KCET,2023,53578,74917,15668,29659,173822,144163,Yes
CITGubbi,Aerospace Engineering,COMEDK,2024,161775,89606,16229,24201,291811,267610,No
SCEM,Robotics and Automation Engineering,KCET,2024,73537,85896,13329,17339,190101,172762,No
NMIT,Aerospace Engineering,KCET,2024,80198,79518,15966,13222,188904,175682,Yes
REVA,Computer Science and Engineering,COMEDK,2023,160981,85830,18922,25816,291549,265733,No
AECMandya,Biotechnology,KCET,2024,82598,77705,19731,14901,194935,180034,Yes
JIT,Mechanical Engineering,KCET,2023,83983,67559,15016,23731,190289,166558,Yes
SCEM,Information Science and Engineering,KCET,2024,61948,94164,19226,14491,189829,175338,Yes
BITM,Mechanical Engineering,COMEDK,2023,184361,86204,10493,18424,299482,281058,Yes
RIT,Artificial Intelligence and Data Science,COMEDK,2024,166901,88512,16089,20089,291591,271502,Yes
VVIT,Artificial Intelligence and Data Science,KCET,2024,68286,90795,12092,22502,193675,171173,No
AECMandya,Robotics and Automation Engineering,KCET,2023,73688,68608,16747,24779,183822,159043,Yes
GIT,Artificial Intelligence and Data Science,COMEDK,2024,216258,69893,11685,29459,327295,297836,Yes
RNSIT,Data Science,KCET,2024,65931,91524,11822,11028,180305,169277,Yes
SJBCE,Information Science and Engineering,KCET,2024,53101,60772,11057,17985,142915,124930,Yes
JIT,Biotechnology,COMEDK,2023,229936,65136,12098,12073,319243,307170,Yes
GIT,Information Science and Engineering,KCET,2023,82055,76837,16072,23928,198892,174964,No
RVCE,Aerospace Engineering,COMEDK,2024,166080,79147,14814,27724,287765,260041,No
VemanaIT,Electrical and Electronics Engineering,COMEDK,2024,227201,74176,10268,16382,328027,311645,Yes
DrAIT,Electrical and Electronics Engineering,KCET,2024,80129,74598,13189,14874,182790,167916,No
BNMIT,Mechanical Engineering,COMEDK,2024,201083,75700,18286,10420,305489,295069,Yes
BMIT,Computer Science and Engineering,KCET,2024,62299,82100,12585,26368,183352,156984,No
EastPoint,Artificial Intelligence and Data Science,COMEDK,2023,198623,67035,12631,20417,298706,278289,No
SDMIT,Aerospace Engineering,KCET,2023,74441,61812,17673,27835,181761,153926,No
KLSGIT,Chemical Engineering,COMEDK,2023,234458,74744,8434,16690,334326,317636,No
SIT,Artificial Intelligence and Data Science,KCET,2024,79837,77319,9511,28741,195408,166667,Yes
RNSIT,Computer Science and Engineering,COMEDK,2024,180827,62586,17314,24766,285493,260727,Yes
KLSGIT,Data Science,KCET,2023,64018,84283,16649,19920,184870,164950,Yes
DBIT,Robotics and Automation Engineering,KCET,2023,62891,85368,13951,28138,190348,162210,No
SJBCE,Chemical Engineering,KCET,2024,68746,76063,11096,24362,180267,155905,Yes
YKCE,Aerospace Engineering,COMEDK,2024,235331,64794,14730,26075,340930,314855,No
BITM,Aerospace Engineering,KCET,2023,50302,78425,19386,23999,172112,148113,Yes
NHCE,Electronics and Communication Engineering,COMEDK,2024,165586,60251,15410,13217,254464,241247,Yes
RVCE,Civil Engineering,COMEDK,2024,166827,69265,16857,28296,281245,252949,Yes
RVUNIV,Electronics and Communication Engineering,COMEDK,2024,203289,75175,13128,13572,305164,291592,No
SDMIT,Mechanical Engineering,COMEDK,2023,186448,66953,19913,12377,285691,273314,Yes
KLEIT,Data Science,KCET,2024,67015,83065,11790,16928,178798,161870,No
NIE,Civil Engineering,KCET,2024,81072,88350,11398,27566,208386,180820,Yes
AEC,Aerospace Engineering,KCET,2023,72910,77234,9679,23113,182936,159823,No
SCEM,Computer Science and Engineering,COMEDK,2024,202448,86691,15251,26718,331108,304390,Yes
NHCE,Robotics and Automation Engineering,COMEDK,2024,202327,92403,9707,10584,315021,304437,No
KLSGIT,Mechanical Engineering,KCET,2024,59335,64533,13678,18040,155586,137546,No
GMIT,Robotics and Automation Engineering,KCET,2024,50554,90041,13555,23541,177691,154150,Yes
KLEIT,Electrical and Electronics Engineering,COMEDK,2024,215711,76736,17620,23614,333681,310067,No
REVA,Data Science,COMEDK,2024,248580,62541,12914,12804,336839,324035,Yes
BNMIT,Computer Science and Engineering,KCET,2024,52436,73682,12100,18725,156943,138218,No
MSRIT,Electrical and Electronics Engineering,COMEDK,2024,164574,87979,18171,12539,283263,270724,No
BITM,Biotechnology,COMEDK,2024,163372,75511,15383,13360,267626,254266,Yes
SIT,Information Science and Engineering,COMEDK,2024,212273,76994,10663,13522,313452,299930,Yes
DSCE,Artificial Intelligence and Data Science,KCET,2023,63194,72843,16238,25797,178072,152275,Yes
VVCE,Biotechnology,KCET,2023,60198,64210,12574,15303,152285,136982,Yes
BIT,Mechanical Engineering,COMEDK,2024,164126,91237,15206,22224,292793,270569,Yes
PRES,Computer Science and Engineering,COMEDK,2024,214932,66351,8549,14534,304366,289832,Yes
DSCE,Chemical Engineering,COMEDK,2024,232191,71450,12822,25375,341838,316463,No
DBIT,Information Science and Engineering,KCET,2023,80354,76978,14282,26294,197908,171614,Yes
AITM,Computer Science and Engineering,KCET,2024,52884,73849,19403,26162,172298,146136,No
BMIT,Chemical Engineering,KCET,2024,64133,89043,8570,22831,184577,161746,Yes
NCET,Robotics and Automation Engineering,COMEDK,2024,170197,76807,17902,16536,281442,264906,No
PRES,Chemical Engineering,KCET,2024,73407,95000,10400,20398,199205,178807,No
NCET,Electronics and Communication Engineering,COMEDK,2023,237564,75819,15142,28373,356898,328525,No
NIE,Civil Engineering,COMEDK,2024,173559,65615,11880,14651,265705,251054,No
RAIT,Electronics and Communication Engineering,COMEDK,2023,218908,64528,18250,13871,315557,301686,Yes
PESU,Artificial Intelligence and Data Science,COMEDK,2024,171507,71310,8269,26317,277403,251086,Yes
MSRIT,Biotechnology,COMEDK,2023,198734,67124,15431,17134,298423,281289,No
CMRIT,Electronics and Communication Engineering,COMEDK,2024,171638,60131,8020,26590,266379,239789,Yes
RVCE,Mechanical Engineering,COMEDK,2023,176796,73065,15586,18540,283987,265447,Yes
MVJCE,Civil Engineering,COMEDK,2023,203659,69196,18893,10954,302702,291748,Yes
SDMIT,Electronics and Communication Engineering,KCET,2023,51251,91167,11124,18495,172037,153542,Yes
MVJCE,Robotics and Automation Engineering,COMEDK,2023,208696,85905,16751,19079,330431,311352,Yes
AECMandya,Information Science and Engineering,COMEDK,2024,190735,64501,11327,27790,294353,266563,Yes
RAIT,Aerospace Engineering,COMEDK,2024,242123,87597,17516,18390,365626,347236,No
SIT,Artificial Intelligence and Data Science,COMEDK,2023,230037,67581,12797,27158,337573,310415,No
RVUNIV,Electronics and Communication Engineering,KCET,2023,78588,81444,11330,10652,182014,171362,No
JNNCE,Computer Science and Engineering,KCET,2024,69379,70252,8616,26656,174903,148247,Yes
BMSIT,Electrical and Electronics Engineering,KCET,2024,62114,61602,9678,23302,156696,133394,No
GMIT,Data Science,COMEDK,2023,208895,87842,14197,13951,324885,310934,Yes
DSATM,Information Science and Engineering,COMEDK,2023,186124,91883,14686,10761,303454,292693,No
YKCE,Aerospace Engineering,COMEDK,2024,206845,69402,15854,26232,318333,292101,No
PESCE,Artificial Intelligence and Data Science,COMEDK,2023,228416,93038,13785,18127,353366,335239,No
VVCE,Chemical Engineering,KCET,2023,80974,87949,11396,26337,206656,180319,No
CITGubbi,Electronics and Communication Engineering,COMEDK,2024,207895,68130,18496,24176,318697,294521,No
SDMIT,Aerospace Engineering,COMEDK,2023,222020,70733,9754,14542,317049,302507,No
VSM,Chemical Engineering,KCET,2023,80509,93684,18613,24345,217151,192806,Yes
RVCE,Aerospace Engineering,KCET,2024,64778,66898,19797,20483,171956,151473,Yes
RVUNIV,Civil Engineering,KCET,2023,67668,60188,12498,11072,151426,140354,No
DSCE,Mechanical Engineering,COMEDK,2024,194173,78197,18254,24498,315122,290624,Yes
VIT,Chemical Engineering,KCET,2024,56934,91762,18141,13622,180459,166837,No
BIT,Robotics and Automation Engineering,KCET,2024,81957,93262,11020,23344,209583,186239,Yes
YKCE,Robotics and Automation Engineering,COMEDK,2024,171705,74987,11660,18393,276745,258352,Yes
JIT,Electrical and Electronics Engineering,KCET,2023,55598,80577,13155,22210,171540,149330,No
SJBIT,Biotechnology,KCET,2023,71655,93014,18718,26332,209719,183387,Yes
RVCE,Electrical and Electronics Engineering,COMEDK,2024,162467,89931,15068,24234,291700,267466,No
PRES,Aerospace Engineering,COMEDK,2024,227033,78893,10356,24132,340414,316282,No
UVCE,Artificial Intelligence and Data Science,COMEDK,2024,237913,82061,16587,11908,348469,336561,Yes
SIT,Computer Science and Engineering,COMEDK,2024,235435,60321,14207,29595,339558,309963,Yes
VemanaIT,Data Science,COMEDK,2024,241112,60541,13443,15781,330877,315096,No
AIT,Data Science,COMEDK,2023,204775,71454,17676,20739,314644,293905,No
SIT,Robotics and Automation Engineering,COMEDK,2023,186719,71513,14992,14702,287926,273224,No
RAIT,Chemical Engineering,COMEDK,2024,227498,77556,16881,12644,334579,321935,No
RVCE,Robotics and Automation Engineering,COMEDK,2024,160068,91975,18851,10709,281603,270894,No
RAIT,Aerospace Engineering,COMEDK,2023,180378,91145,12330,12820,296673,283853,No
RVCE,Electronics and Communication Engineering,COMEDK,2024,168308,64120,8563,27223,268214,240991,Yes
EastPoint,Artificial Intelligence and Data Science,KCET,2024,78605,76338,9930,29613,194486,164873,Yes
SJBIT,Mechanical Engineering,KCET,2024,83449,79991,11417,26297,201154,174857,Yes
MVJCE,Aerospace Engineering,KCET,2023,67597,67503,9571,19641,164312,144671,Yes
SDMIT,Mechanical Engineering,KCET,2023,77779,86121,18660,25093,207653,182560,Yes
DrAIT,Information Science and Engineering,COMEDK,2024,183245,84944,17071,15453,300713,285260,No
DSATM,Chemical Engineering,COMEDK,2024,238231,69119,11729,22247,341326,319079,No
HKBK,Aerospace Engineering,COMEDK,2024,179259,90453,19981,13708,303401,289693,No
MVJCE,Artificial Intelligence and Data Science,KCET,2024,57843,84649,8856,20109,171457,151348,No
GIT,Computer Science and Engineering,COMEDK,2023,165387,82622,17267,23160,288436,265276,Yes
MVJCE,Robotics and Automation Engineering,KCET,2024,61194,88101,10768,21990,182053,160063,No
VIT,Computer Science and Engineering,COMEDK,2023,166403,75147,9195,18854,269599,250745,No
BMSCE,Biotechnology,KCET,2024,77797,90092,9933,12172,189994,177822,No
JIT,Information Science and Engineering,KCET,2023,79759,94005,10530,22984,207278,184294,No
VSM,Robotics and Automation Engineering,COMEDK,2024,249205,79467,10511,14786,353969,339183,No
NCET,Aerospace Engineering,COMEDK,2024,249733,91149,18502,17338,376722,359384,Yes
NCET,Mechanical Engineering,KCET,2024,68200,78267,14640,29913,191020,161107,Yes
VSM,Electrical and Electronics Engineering,KCET,2023,64168,94468,18767,24685,202088,177403,No
MSRIT,Aerospace Engineering,KCET,2023,82100,87257,10841,22053,202251,180198,Yes
NCET,Electronics and Communication Engineering,KCET,2023,60939,83071,9742,18234,171986,153752,No
EastPoint,Mechanical Engineering,COMEDK,2023,226795,66061,14669,14609,322134,307525,Yes
ACU,Information Science and Engineering,KCET,2024,71497,62719,17783,14260,166259,151999,Yes
JIT,Artificial Intelligence and Data Science,COMEDK,2024,173945,80517,17889,10729,283080,272351,No
KLSGIT,Artificial Intelligence and Data Science,KCET,2023,69775,60352,10752,15029,155908,140879,No
SDMCET,Computer Science and Engineering,COMEDK,2024,210557,74887,8668,27168,321280,294112,Yes
SITM,Chemical Engineering,KCET,2024,50481,81346,15360,13715,160902,147187,No
DSATM,Information Science and Engineering,KCET,2024,80073,82555,9875,10013,182516,172503,No
PRES,Artificial Intelligence and Data Science,COMEDK,2024,219551,85367,8643,24428,337989,313561,Yes
BMSCE,Mechanical Engineering,COMEDK,2023,228069,66107,11830,11671,317677,306006,No
ACU,Artificial Intelligence and Data Science,COMEDK,2023,199551,92622,10691,23881,326745,302864,Yes
HKBK,Biotechnology,COMEDK,2023,167297,68095,11617,29437,276446,247009,Yes
DSATM,Information Science and Engineering,KCET,2023,54546,65470,13380,23177,156573,133396,Yes
MVJCE,Electronics and Communication Engineering,COMEDK,2024,241238,79585,11435,21906,354164,332258,Yes
NIE,Biotechnology,KCET,2024,60718,94981,15776,13612,185087,171475,No
JSSSTU,Robotics and Automation Engineering,KCET,2024,76471,72148,18835,17541,184995,167454,Yes
VemanaIT,Mechanical Engineering,COMEDK,2023,235303,74146,9327,10631,329407,318776,Yes
NMIT,Aerospace Engineering,COMEDK,2024,190777,85135,8850,23400,308162,284762,Yes
PRES,Information Science and Engineering,KCET,2023,79229,93796,13536,14346,200907,186561,No
BITM,Robotics and Automation Engineering,COMEDK,2024,221253,88023,15855,11343,336474,325131,Yes
SJBIT,Data Science,COMEDK,2024,170090,60197,9028,11704,251019,239315,No
SCEM,Electrical and Electronics Engineering,COMEDK,2023,171188,89669,8806,26882,296545,269663,Yes
RIT,Data Science,KCET,2023,78034,90889,9227,23690,201840,178150,Yes
YKCE,Computer Science and Engineering,COMEDK,2023,233446,84151,8060,29035,354692,325657,No
CMRIT,Civil Engineering,KCET,2023,84532,62264,9204,10803,166803,156000,Yes
EastPoint,Electronics and Communication Engineering,COMEDK,2023,244245,62087,10430,14317,331079,316762,Yes
AEC,Electrical and Electronics Engineering,KCET,2023,60107,84865,14403,26601,185976,159375,No
SITM,Information Science and Engineering,COMEDK,2024,222824,67201,18760,12353,321138,308785,No
HKBK,Data Science,COMEDK,2023,210201,77928,10456,29096,327681,298585,No
BMSCE,Information Science and Engineering,COMEDK,2023,214186,78830,11300,23941,328257,304316,No
BIT,Electronics and Communication Engineering,COMEDK,2023,177019,67246,15368,23150,282783,259633,No
MSRIT,Robotics and Automation Engineering,KCET,2023,57667,89321,14771,11522,173281,161759,No
BIT,Aerospace Engineering,COMEDK,2023,200526,61710,19953,12761,294950,282189,No
JSSSTU,Robotics and Automation Engineering,KCET,2023,60817,81149,14073,25597,181636,156039,Yes
UVCE,Aerospace Engineering,COMEDK,2023,209004,68005,9101,25257,311367,286110,No
RIT,Data Science,KCET,2024,69674,81078,17851,21971,190574,168603,No
BITM,Robotics and Automation Engineering,COMEDK,2023,213431,93109,19700,29974,356214,326240,No
MSRIT,Information Science and Engineering,KCET,2024,53624,83405,15745,24872,177646,152774,Yes
PESU,Civil Engineering,COMEDK,2023,188294,70667,10122,14445,283528,269083,Yes
BMSIT,Electrical and Electronics Engineering,COMEDK,2023,163146,64825,11975,24116,264062,239946,Yes
KLSGIT,Aerospace Engineering,KCET,2023,81768,86512,18040,25351,211671,186320,No
VemanaIT,Mechanical Engineering,KCET,2024,70152,68497,16047,22040,176736,154696,Yes
UVCE,Chemical Engineering,COMEDK,2023,223999,73032,10820,28583,336434,307851,No
CITGubbi,Civil Engineering,COMEDK,2023,229472,80948,10740,14043,335203,321160,Yes
PESCE,Data Science,KCET,2024,69772,81126,17888,12756,181542,168786,Yes
HKBK,Artificial Intelligence and Data Science,COMEDK,2024,205503,85820,17881,21933,331137,309204,Yes
DBIT,Electrical and Electronics Engineering,COMEDK,2023,169961,79463,14791,13907,278122,264215,Yes
SDMIT,Civil Engineering,KCET,2023,67853,84498,14657,20471,187479,167008,No
GIT,Chemical Engineering,KCET,2023,73933,76175,10636,27448,188192,160744,No
AEC,Chemical Engineering,KCET,2024,80800,67884,16200,16968,181852,164884,No
DSATM,Chemical Engineering,KCET,2024,66714,71325,18253,22609,178901,156292,No
NMIT,Aerospace Engineering,KCET,2023,78043,88593,19036,26897,212569,185672,No
CITGubbi,Electrical and Electronics Engineering,COMEDK,2024,188350,68429,14252,28775,299806,271031,No
PESCE,Civil Engineering,KCET,2024,72170,80909,13907,16728,183714,166986,No
BNMIT,Chemical Engineering,KCET,2023,79648,94867,12724,28797,216036,187239,Yes
AECMandya,Information Science and Engineering,KCET,2023,71758,68014,18305,29089,187166,158077,No
DBIT,Electronics and Communication Engineering,COMEDK,2023,167261,63900,10743,26750,268654,241904,Yes
GIT,Biotechnology,COMEDK,2024,190934,87050,15576,18623,312183,293560,Yes
KLSGIT,Biotechnology,COMEDK,2024,189495,79545,16396,29911,315347,285436,Yes
ACU,Chemical Engineering,KCET,2024,72113,86119,16750,13780,188762,174982,No
GIT,Electrical and Electronics Engineering,KCET,2023,76241,69329,17038,11192,173800,162608,Yes
PESCE,Chemical Engineering,COMEDK,2023,223175,77386,16752,23791,341104,317313,No
YKCE,Electrical and Electronics Engineering,KCET,2023,53306,74386,12271,23299,163262,139963,No
VVIT,Robotics and Automation Engineering,COMEDK,2023,236006,92516,10360,12926,351808,338882,No
RIT,Civil Engineering,COMEDK,2024,224456,83772,10543,22457,341228,318771,Yes
HKBK,Computer Science and Engineering,COMEDK,2023,201828,74990,14147,25751,316716,290965,No
NMIT,Biotechnology,KCET,2024,60437,69792,14396,25235,169860,144625,Yes
AIT,Computer Science and Engineering,COMEDK,2023,190026,71852,12507,24558,298943,274385,Yes
CMRIT,Computer Science and Engineering,KCET,2024,66669,65426,14283,20887,167265,146378,Yes
KLSGIT,Electronics and Communication Engineering,KCET,2024,53626,63661,14354,17306,148947,131641,Yes
VIT,Information Science and Engineering,COMEDK,2023,165884,68248,12827,27002,273961,246959,No
JIT,Computer Science and Engineering,COMEDK,2023,193570,76269,14370,23678,307887,284209,Yes
VIT,Electronics and Communication Engineering,COMEDK,2024,179171,93635,19531,17345,309682,292337,No
KLEIT,Computer Science and Engineering,KCET,2024,51018,74380,10042,14464,149904,135440,No
VIT,Electronics and Communication Engineering,KCET,2023,72395,92552,18118,17952,201017,183065,Yes
RNSIT,Data Science,COMEDK,2023,162722,88695,14975,14702,281094,266392,No
EastPoint,Computer Science and Engineering,COMEDK,2024,231780,68724,8082,18311,326897,308586,Yes
NCET,Aerospace Engineering,KCET,2023,69730,70716,14790,11223,166459,155236,No
RNSIT,Aerospace Engineering,COMEDK,2023,247003,83750,16221,23489,370463,346974,Yes
UVCE,Civil Engineering,KCET,2023,55804,74002,8526,14027,152359,138332,Yes
BMSCE,Information Science and Engineering,COMEDK,2024,176684,78695,14215,17767,287361,269594,Yes
NCET,Data Science,KCET,2023,73930,93455,9627,12192,189204,177012,No
VSM,Robotics and Automation Engineering,COMEDK,2024,229661,81111,8991,11302,331065,319763,No
JIT,Robotics and Automation Engineering,COMEDK,2024,173918,73799,19299,27239,294255,267016,Yes
JSSSTU,Civil Engineering,COMEDK,2023,237763,78895,9352,27088,353098,326010,No
SIT,Mechanical Engineering,KCET,2023,64567,75062,19676,21255,180560,159305,No
NCET,Aerospace Engineering,COMEDK,2024,168565,88662,11186,17162,285575,268413,No
AECMandya,Biotechnology,KCET,2023,70032,76053,18655,26538,191278,164740,No
DrAIT,Civil Engineering,KCET,2024,60594,64908,8627,24964,159093,134129,No
CITGubbi,Data Science,KCET,2024,83866,79875,11871,21625,197237,175612,No
RNSIT,Biotechnology,COMEDK,2023,168979,84300,11200,12994,277473,264479,No
VemanaIT,Aerospace Engineering,COMEDK,2024,180152,69358,10059,27139,286708,259569,No
ACU,Electronics and Communication Engineering,KCET,2023,50536,93316,12198,26068,182118,156050,No
REVA,Biotechnology,COMEDK,2024,199931,76779,18592,18136,313438,295302,No
RIT,Chemical Engineering,KCET,2023,71928,92117,9037,11875,184957,173082,No
JIT,Electronics and Communication Engineering,KCET,2023,55733,89615,9090,17197,171635,154438,Yes
JNNCE,Computer Science and Engineering,COMEDK,2024,226307,91618,11275,29511,358711,329200,Yes
AEC,Biotechnology,COMEDK,2023,181711,88480,18685,21246,310122,288876,No
CITGubbi,Chemical Engineering,COMEDK,2024,227532,91545,18120,23749,360946,337197,No
RIT,Mechanical Engineering,COMEDK,2023,240422,94105,13179,17797,365503,347706,Yes
NCET,Artificial Intelligence and Data Science,KCET,2024,82043,88512,12601,16455,199611,183156,Yes
SIT,Electrical and Electronics Engineering,KCET,2023,61144,89569,12693,27032,190438,163406,Yes
RVCE,Electrical and Electronics Engineering,KCET,2023,71838,71718,14082,21074,178712,157638,No
REVA,Civil Engineering,COMEDK,2024,248338,82701,14765,21409,367213,345804,Yes
SJBCE,Biotechnology,COMEDK,2024,230131,83644,10920,19019,343714,324695,Yes
BIT,Computer Science and Engineering,COMEDK,2024,186970,89162,8949,28667,313748,285081,Yes
SIT,Information Science and Engineering,COMEDK,2023,173433,60553,15497,15250,264733,249483,No
REVA,Robotics and Automation Engineering,KCET,2023,77178,90094,12372,17527,197171,179644,No
BNMIT,Electrical and Electronics Engineering,KCET,2024,84349,84209,17213,12228,197999,185771,Yes
RNSIT,Chemical Engineering,KCET,2024,56209,90708,12693,10405,170015,159610,Yes
SDMIT,Information Science and Engineering,KCET,2023,55723,60229,10033,27134,153119,125985,No
BMIT,Electronics and Communication Engineering,KCET,2023,83020,79292,15565,26383,204260,177877,Yes
SJBCE,Mechanical Engineering,KCET,2023,68386,79497,12767,17491,178141,160650,No
MVJCE,Computer Science and Engineering,COMEDK,2023,204797,64051,11518,14055,294421,280366,No
BNMIT,Mechanical Engineering,KCET,2023,70816,82838,14051,23596,191301,167705,No
SDMCET,Electronics and Communication Engineering,COMEDK,2024,192169,70279,9026,25597,297071,271474,No
DBIT,Computer Science and Engineering,KCET,2024,67534,62071,17706,29352,176663,147311,No
VIT,Biotechnology,KCET,2024,79250,72084,10327,20818,182479,161661,No
SJBIT,Electronics and Communication Engineering,KCET,2023,76999,64308,13061,16910,171278,154368,No
REVA,Electronics and Communication Engineering,COMEDK,2024,216081,68655,15561,18157,318454,300297,No
PESU,Computer Science and Engineering,COMEDK,2023,237686,87126,13027,11445,349284,337839,Yes
JIT,Robotics and Automation Engineering,COMEDK,2023,187725,94120,9474,25137,316456,291319,No
UVCE,Computer Science and Engineering,COMEDK,2024,207091,60568,13670,18381,299710,281329,Yes
NHCE,Computer Science and Engineering,COMEDK,2024,170816,66379,13605,29715,280515,250800,Yes
CMRIT,Artificial Intelligence and Data Science,KCET,2023,76690,71247,10999,10182,169118,158936,No
VemanaIT,Chemical Engineering,COMEDK,2023,161954,69989,15345,21547,268835,247288,No
EastPoint,Electronics and Communication Engineering,KCET,2024,72600,84271,18984,16924,192779,175855,No
SJBIT,Robotics and Automation Engineering,KCET,2023,52666,80229,16868,18021,167784,149763,Yes
SIT,Data Science,COMEDK,2023,221115,89605,10383,10869,331972,321103,Yes
YKCE,Information Science and Engineering,COMEDK,2023,160027,70629,9538,28126,268320,240194,No
REVA,Artificial Intelligence and Data Science,COMEDK,2023,208029,61134,9647,21856,300666,278810,No
BIT,Data Science,COMEDK,2024,239375,72375,9036,14127,334913,320786,No
KLSGIT,Information Science and Engineering,COMEDK,2024,243355,91791,14360,20952,370458,349506,No
SJBIT,Chemical Engineering,COMEDK,2024,213610,71831,13603,21766,320810,299044,No
VIT,Chemical Engineering,COMEDK,2023,232631,64269,12902,21946,331748,309802,No
SITM,Biotechnology,COMEDK,2024,248791,60459,9497,20163,338910,318747,No
SJBCE,Aerospace Engineering,KCET,2023,73850,80091,17800,12267,184008,171741,No
KLSGIT,Biotechnology,KCET,2023,60447,67964,11256,27067,166734,139667,Yes
JSSSTU,Mechanical Engineering,KCET,2023,59869,86188,16630,10351,173038,162687,Yes
ACU,Aerospace Engineering,KCET,2024,76310,72944,14059,21312,184625,163313,Yes
UVCE,Electronics and Communication Engineering,COMEDK,2024,204480,86275,16966,16086,323807,307721,No
BITM,Mechanical Engineering,COMEDK,2024,204294,65085,16247,13919,299545,285626,Yes
AECMandya,Data Science,KCET,2023,66644,88841,11642,27550,194677,167127,No
UVCE,Electrical and Electronics Engineering,KCET,2024,57806,83277,19280,19005,179368,160363,No
NCET,Data Science,COMEDK,2024,194864,76019,8242,20143,299268,279125,No
VVCE,Electrical and Electronics Engineering,COMEDK,2023,227800,74802,15559,20437,338598,318161,Yes
SIT,Computer Science and Engineering,KCET,2023,51016,91391,8273,19083,169763,150680,Yes
BMSCE,Chemical Engineering,KCET,2024,65699,80475,18340,18487,183001,164514,No
AECMandya,Information Science and Engineering,KCET,2024,66684,81419,10608,18266,176977,158711,No
BMIT,Biotechnology,KCET,2024,65128,86422,14706,15524,181780,166256,Yes
BNMIT,Artificial Intelligence and Data Science,KCET,2024,62912,73109,19373,12950,168344,155394,Yes
SDMIT,Biotechnology,COMEDK,2024,223332,73917,15084,11773,324106,312333,No
RVCE,Electronics and Communication Engineering,KCET,2023,76638,87363,12720,15743,192464,176721,No
CMRIT,Aerospace Engineering,KCET,2024,71858,91343,18952,12630,194783,182153,Yes
JIT,Aerospace Engineering,COMEDK,2024,162921,83639,16820,23737,287117,263380,No
CITGubbi,Civil Engineering,KCET,2024,75127,83673,15886,20736,195422,174686,No
PESCE,Robotics and Automation Engineering,KCET,2024,64047,64845,19484,10290,158666,148376,No
REVA,Aerospace Engineering,KCET,2023,55171,63864,16388,11109,146532,135423,No
SDMCET,Information Science and Engineering,COMEDK,2023,194525,63632,12323,23911,294391,270480,No
SDMCET,Information Science and Engineering,COMEDK,2024,238109,68511,11995,13217,331832,318615,No
NCET,Electronics and Communication Engineering,COMEDK,2024,166986,82925,15659,26742,292312,265570,Yes
SCEM,Aerospace Engineering,KCET,2023,80179,73435,13969,10621,178204,167583,Yes
VemanaIT,Data Science,COMEDK,2023,217284,92202,17921,19950,347357,327407,Yes
RIT,Data Science,KCET,2024,84749,65004,13681,17615,181049,163434,Yes
PRES,Civil Engineering,KCET,2023,52198,71738,18763,23916,166615,142699,Yes
RIT,Computer Science and Engineering,KCET,2024,60716,61882,12998,23190,158786,135596,No
CMRIT,Civil Engineering,COMEDK,2024,189371,94251,17747,13304,314673,301369,Yes
JSSSTU,Civil Engineering,KCET,2024,71287,73803,15562,28941,189593,160652,No
REVA,Electronics and Communication Engineering,KCET,2023,77035,93283,18383,21118,209819,188701,No
VVIT,Civil Engineering,KCET,2024,60202,64552,11720,20761,157235,136474,Yes
BNMIT,Information Science and Engineering,COMEDK,2024,191415,91146,9521,25792,317874,292082,No
BITM,Civil Engineering,COMEDK,2024,167368,65728,18478,24009,275583,251574,Yes
DrAIT,Data Science,KCET,2023,72898,80841,18339,12250,184328,172078,Yes
VVIT,Chemical Engineering,KCET,2023,70743,60581,14829,15100,161253,146153,No
JIT,Chemical Engineering,KCET,2023,60932,88526,15922,19516,184896,165380,Yes
PESCE,Artificial Intelligence and Data Science,KCET,2024,74990,83681,16577,28751,203999,175248,Yes
PRES,Electrical and Electronics Engineering,KCET,2024,52937,76997,11054,12780,153768,140988,Yes
JNNCE,Aerospace Engineering,COMEDK,2024,203478,81556,17895,14926,317855,302929,Yes
SJBIT,Mechanical Engineering,COMEDK,2023,235157,62075,18052,19384,334668,315284,No
BMSIT,Electrical and Electronics Engineering,KCET,2024,59556,65264,9255,14276,148351,134075,Yes
SDMIT,Computer Science and Engineering,COMEDK,2023,236348,78962,18507,14612,348429,333817,Yes
GMIT,Robotics and Automation Engineering,COMEDK,2024,208372,82844,18421,25514,335151,309637,No
REVA,Computer Science and Engineering,COMEDK,2023,176962,78539,14925,28973,299399,270426,No
PESCE,Aerospace Engineering,KCET,2024,54526,80185,10332,26585,171628,145043,Yes
VemanaIT,Data Science,KCET,2024,56581,94642,9018,23655,183896,160241,Yes
CMRIT,Computer Science and Engineering,KCET,2024,64996,63110,14037,26785,168928,142143,No
KLSGIT,Civil Engineering,KCET,2023,82638,65984,11278,13628,173528,159900,No
VVIT,Electrical and Electronics Engineering,COMEDK,2024,227923,79068,12113,16027,335131,319104,Yes
GMIT,Computer Science and Engineering,KCET,2023,68036,62397,10380,16604,157417,140813,No
SDMIT,Data Science,KCET,2023,58749,65609,17785,21080,163223,142143,No
HKBK,Robotics and Automation Engineering,COMEDK,2023,169862,81099,11959,12196,275116,262920,Yes
RVUNIV,Computer Science and Engineering,KCET,2024,58400,61975,13641,25368,159384,134016,Yes
CITGubbi,Robotics and Automation Engineering,COMEDK,2023,178110,80506,12551,22691,293858,271167,No
RNSIT,Computer Science and Engineering,COMEDK,2024,185099,74069,14311,26290,299769,273479,Yes
VVCE,Civil Engineering,KCET,2024,65054,61117,13846,16265,156282,140017,No
JIT,Civil Engineering,COMEDK,2024,248004,92072,10566,29500,380142,350642,Yes
KLEIT,Computer Science and Engineering,KCET,2023,54430,78388,16844,12788,162450,149662,Yes
JSSSTU,Biotechnology,KCET,2024,65632,64932,17609,28489,176662,148173,Yes
AECMandya,Robotics and Automation Engineering,COMEDK,2024,191179,88399,14210,23392,317180,293788,No
RVUNIV,Mechanical Engineering,COMEDK,2023,178701,61181,17175,29718,286775,257057,Yes
DSCE,Biotechnology,KCET,2024,84103,61200,16825,11319,173447,162128,No
DrAIT,Electrical and Electronics Engineering,KCET,2024,82475,88394,10482,16158,197509,181351,No
PESCE,Information Science and Engineering,COMEDK,2023,195815,84025,17831,17836,315507,297671,Yes
PESU,Aerospace Engineering,KCET,2024,72033,68784,15092,24881,180790,155909,Yes
RVCE,Mechanical Engineering,COMEDK,2023,223744,94626,13651,21488,353509,332021,No
MSRUAS,Computer Science and Engineering,KCET,2023,65410,85592,17185,29286,197473,168187,Yes
RVCE,Robotics and Automation Engineering,COMEDK,2023,203189,74514,11579,24016,313298,289282,Yes
RIT,Information Science and Engineering,KCET,2023,50904,91623,10940,22665,176132,153467,No
ACU,Biotechnology,KCET,2023,68069,74705,13358,26731,182863,156132,Yes
SIT,Artificial Intelligence and Data Science,COMEDK,2023,169399,68147,14917,18287,270750,252463,No
MSRUAS,Chemical Engineering,KCET,2024,84942,86631,18279,19568,209420,189852,Yes
EastPoint,Data Science,COMEDK,2024,226942,82144,16876,23995,349957,325962,No
SDMIT,Aerospace Engineering,KCET,2024,54766,78475,10994,16273,160508,144235,Yes
SDMIT,Civil Engineering,KCET,2024,70194,94381,18094,16759,199428,182669,Yes
YKCE,Robotics and Automation Engineering,KCET,2024,70084,62877,14221,22090,169272,147182,No
EastPoint,Robotics and Automation Engineering,COMEDK,2024,199345,92805,14007,11038,317195,306157,No
NHCE,Robotics and Automation Engineering,KCET,2023,70087,88725,16032,18974,193818,174844,No
PRES,Information Science and Engineering,KCET,2023,77750,64455,9377,23235,174817,151582,Yes
SJBIT,Biotechnology,KCET,2024,77023,72903,17794,16081,183801,167720,No
RIT,Robotics and Automation Engineering,COMEDK,2023,196219,87623,19412,28063,331317,303254,Yes
SJBCE,Computer Science and Engineering,COMEDK,2023,162010,65581,13825,11709,253125,241416,No
VVIT,Electronics and Communication Engineering,KCET,2023,80323,70168,16662,11012,178165,167153,No
RIT,Mechanical Engineering,KCET,2024,62683,61567,18556,18648,161454,142806,Yes
JIT,Electrical and Electronics Engineering,KCET,2023,58009,61527,13807,29849,163192,133343,No
DBIT,Chemical Engineering,COMEDK,2023,232406,82913,8014,10017,333350,323333,No
AECMandya,Chemical Engineering,KCET,2024,80167,79493,17788,29288,206736,177448,Yes
CITGubbi,Electronics and Communication Engineering,COMEDK,2024,235589,67937,16692,11448,331666,320218,No
PESCE,Mechanical Engineering,COMEDK,2023,182564,83524,8688,13225,288001,274776,Yes
REVA,Aerospace Engineering,COMEDK,2023,161515,65722,16195,26113,269545,243432,No
DrAIT,Robotics and Automation Engineering,COMEDK,2024,206525,86223,18633,14791,326172,311381,Yes
RVUNIV,Artificial Intelligence and Data Science,COMEDK,2023,231385,76009,11574,25143,344111,318968,Yes
BITM,Chemical Engineering,KCET,2023,79444,69368,15770,15346,179928,164582,No
NMIT,Electrical and Electronics Engineering,COMEDK,2023,230021,71458,14424,20920,336823,315903,Yes
NMIT,Electronics and Communication Engineering,COMEDK,2024,170433,75691,16569,23169,285862,262693,No
KSIT,Mechanical Engineering,KCET,2023,59794,80856,11864,14224,166738,152514,No
PRES,Robotics and Automation Engineering,KCET,2024,83759,79844,12163,10568,186334,175766,Yes
GIT,Chemical Engineering,KCET,2024,56103,70149,16961,12019,155232,143213,Yes
GMIT,Information Science and Engineering,COMEDK,2023,226829,80965,10532,26469,344795,318326,No
KLEIT,Information Science and Engineering,COMEDK,2024,223505,70548,18942,20597,333592,312995,No
PRES,Information Science and Engineering,KCET,2024,80955,89792,19452,24000,214199,190199,Yes
NMIT,Electrical and Electronics Engineering,COMEDK,2023,214969,88029,12085,19639,334722,315083,Yes
DSATM,Aerospace Engineering,KCET,2024,51847,66126,10592,21199,149764,128565,Yes
RVUNIV,Chemical Engineering,COMEDK,2024,243670,66863,11429,10584,332546,321962,Yes
SDMCET,Aerospace Engineering,KCET,2023,79603,91117,15198,27629,213547,185918,Yes
DrAIT,Biotechnology,KCET,2023,80643,70565,16851,20196,188255,168059,Yes
PESCE,Biotechnology,COMEDK,2024,198854,89065,15868,22536,326323,303787,No
REVA,Mechanical Engineering,KCET,2023,65840,77981,18890,25682,188393,162711,No
BMSIT,Biotechnology,COMEDK,2023,176364,74262,18928,23540,293094,269554,Yes
BMIT,Civil Engineering,KCET,2023,61375,76636,13663,26366,178040,151674,No
AITM,Electronics and Communication Engineering,COMEDK,2023,219730,62282,13038,11578,306628,295050,No
RAIT,Computer Science and Engineering,COMEDK,2024,242484,76019,12547,29132,360182,331050,No
JSSSTU,Mechanical Engineering,KCET,2023,63087,63998,15017,16702,158804,142102,No
KSIT,Chemical Engineering,KCET,2023,58439,89385,9747,24055,181626,157571,No
BITM,Biotechnology,COMEDK,2023,194010,73367,17997,22042,307416,285374,No
VVIT,Data Science,KCET,2024,63985,69371,16596,17334,167286,149952,Yes
KLEIT,Information Science and Engineering,COMEDK,2023,173874,78162,19948,13420,285404,271984,Yes
JIT,Electronics and Communication Engineering,COMEDK,2023,217322,69920,9317,18762,315321,296559,Yes
RNSIT,Artificial Intelligence and Data Science,COMEDK,2024,174464,91796,12560,15637,294457,278820,No
MVJCE,Information Science and Engineering,COMEDK,2024,214034,92244,14860,14992,336130,321138,No
AIT,Robotics and Automation Engineering,KCET,2023,56661,80336,12642,13348,162987,149639,Yes
ACU,Electrical and Electronics Engineering,KCET,2023,77266,92968,19535,23410,213179,189769,Yes
NCET,Computer Science and Engineering,KCET,2024,74620,94811,8500,28166,206097,177931,Yes
KSIT,Chemical Engineering,KCET,2024,74582,84780,11012,13065,183439,170374,No
PESU,Aerospace Engineering,COMEDK,2023,214900,77770,18635,16818,328123,311305,Yes
BMSCE,Data Science,COMEDK,2024,249722,86138,15271,10952,362083,351131,No
MSRIT,Electrical and Electronics Engineering,KCET,2023,84609,61495,13377,11828,171309,159481,Yes
JSSSTU,Artificial Intelligence and Data Science,KCET,2024,73451,92172,11221,25555,202399,176844,Yes
AEC,Electrical and Electronics Engineering,KCET,2024,60381,75099,16364,14814,166658,151844,Yes
VVIT,Computer Science and Engineering,COMEDK,2023,225966,89390,9856,27114,352326,325212,Yes
PESCE,Chemical Engineering,KCET,2024,82277,86247,9710,25652,203886,178234,No
VVIT,Civil Engineering,KCET,2024,83770,89310,16347,13346,202773,189427,Yes
NMIT,Information Science and Engineering,COMEDK,2023,239426,87605,13097,18986,359114,340128,No
BMSCE,Computer Science and Engineering,COMEDK,2024,163116,60703,11402,19828,255049,235221,Yes
AECMandya,Mechanical Engineering,KCET,2024,55050,75685,8237,10352,149324,138972,No
UVCE,Aerospace Engineering,COMEDK,2024,213869,80772,18412,29268,342321,313053,No
NMIT,Electrical and Electronics Engineering,COMEDK,2023,243874,85592,13988,15860,359314,343454,Yes
RVUNIV,Electrical and Electronics Engineering,COMEDK,2024,239840,79802,8645,22691,350978,328287,No
GMIT,Chemical Engineering,KCET,2024,55871,61697,10907,27581,156056,128475,Yes
EastPoint,Data Science,COMEDK,2023,169029,70759,9701,13214,262703,249489,No
VVIT,Civil Engineering,KCET,2023,80957,81495,8058,28873,199383,170510,No
GMIT,Biotechnology,KCET,2024,53268,89568,9848,15289,167973,152684,Yes
JSSSTU,Information Science and Engineering,KCET,2023,79395,87742,12691,25473,205301,179828,No
NIE,Information Science and Engineering,COMEDK,2023,212715,63890,8923,16009,301537,285528,No
BITM,Electronics and Communication Engineering,COMEDK,2024,223784,82326,18323,20573,345006,324433,Yes
CMRIT,Chemical Engineering,KCET,2024,72262,89491,10294,15197,187244,172047,Yes
RAIT,Mechanical Engineering,KCET,2023,83441,86051,13433,15581,198506,182925,No
SCEM,Artificial Intelligence and Data Science,COMEDK,2023,197444,82654,14679,19101,313878,294777,No
VVCE,Artificial Intelligence and Data Science,COMEDK,2023,178445,76724,13974,18368,287511,269143,No
BIT,Robotics and Automation Engineering,COMEDK,2023,183395,67249,12523,25857,289024,263167,Yes
VIT,Aerospace Engineering,KCET,2023,59346,80368,18324,23325,181363,158038,Yes
DSCE,Data Science,KCET,2023,72582,93475,14503,14039,194599,180560,No
NHCE,Data Science,KCET,2023,50193,84536,19772,10317,164818,154501,No
VVCE,Computer Science and Engineering,COMEDK,2024,247402,65259,11506,18869,343036,324167,Yes
JNNCE,Artificial Intelligence and Data Science,KCET,2024,83386,84723,13738,23844,205691,181847,Yes
MVJCE,Artificial Intelligence and Data Science,COMEDK,2023,208741,71142,18760,23980,322623,298643,No
BITM,Electrical and Electronics Engineering,COMEDK,2024,203717,90667,9006,12070,315460,303390,Yes
VSM,Civil Engineering,COMEDK,2023,245715,61541,9628,13596,330480,316884,Yes
REVA,Civil Engineering,COMEDK,2024,168179,72309,18137,26487,285112,258625,Yes
VIT,Mechanical Engineering,COMEDK,2024,204455,66341,12323,29516,312635,283119,No
BNMIT,Artificial Intelligence and Data Science,COMEDK,2023,173827,73699,13497,25844,286867,261023,Yes
SIT,Biotechnology,COMEDK,2023,185055,91909,17877,27923,322764,294841,No
BMIT,Artificial Intelligence and Data Science,KCET,2023,64292,74020,9740,15053,163105,148052,Yes
JSSSTU,Artificial Intelligence and Data Science,COMEDK,2023,190981,70652,12711,26001,300345,274344,No
VSM,Aerospace Engineering,KCET,2023,55703,65157,17151,23251,161262,138011,No
MSRIT,Computer Science and Engineering,COMEDK,2023,241342,80062,10246,29898,361548,331650,No
JIT,Computer Science and Engineering,COMEDK,2024,181115,80466,19393,17769,298743,280974,No
BMIT,Robotics and Automation Engineering,COMEDK,2024,238727,83077,8125,20107,350036,329929,Yes
DrAIT,Biotechnology,COMEDK,2024,219788,89548,14885,17927,342148,324221,Yes
SDMCET,Civil Engineering,COMEDK,2023,235333,93251,16014,14777,359375,344598,Yes
RVUNIV,Information Science and Engineering,KCET,2023,56784,78903,9213,24147,169047,144900,No
NCET,Information Science and Engineering,COMEDK,2023,202403,68693,19009,17203,307308,290105,Yes
BITM,Mechanical Engineering,COMEDK,2023,180242,86098,9769,16869,292978,276109,No
YKCE,Civil Engineering,COMEDK,2024,245957,76846,17345,12778,352926,340148,No
SDMIT,Biotechnology,KCET,2023,74047,66529,14967,23545,179088,155543,No
BNMIT,Robotics and Automation Engineering,KCET,2023,80822,77791,16565,11662,186840,175178,Yes
RVCE,Biotechnology,KCET,2023,74405,83434,14806,27779,200424,172645,No
RNSIT,Electrical and Electronics Engineering,KCET,2024,79513,85831,13310,13187,191841,178654,No
SJBIT,Aerospace Engineering,KCET,2024,64029,92784,13563,23741,194117,170376,No
BITM,Information Science and Engineering,KCET,2023,65211,87379,11789,17832,182211,164379,Yes
KLSGIT,Electrical and Electronics Engineering,COMEDK,2023,240086,78732,17847,10943,347608,336665,Yes
YKCE,Artificial Intelligence and Data Science,KCET,2023,61582,74962,18253,10492,165289,154797,No
EastPoint,Data Science,KCET,2023,55924,76846,15083,26917,174770,147853,Yes
GMIT,Biotechnology,COMEDK,2023,206265,66193,10632,10600,293690,283090,Yes
VIT,Electrical and Electronics Engineering,KCET,2023,54601,79524,12795,11182,158102,146920,Yes
DBIT,Artificial Intelligence and Data Science,KCET,2024,62732,67878,10173,19412,160195,140783,Yes
SIT,Information Science and Engineering,COMEDK,2024,249830,78466,14908,23035,366239,343204,No
RVCE,Mechanical Engineering,COMEDK,2024,177057,63771,12479,11834,265141,253307,No
NHCE,Aerospace Engineering,KCET,2024,78771,73381,15215,29159,196526,167367,No
BMSCE,Civil Engineering,KCET,2023,55318,73094,11740,21776,161928,140152,No
DrAIT,Electronics and Communication Engineering,COMEDK,2023,177604,80287,10562,26307,294760,268453,No
BMIT,Information Science and Engineering,KCET,2024,76684,92858,11673,15750,196965,181215,No
AECMandya,Electrical and Electronics Engineering,KCET,2023,81502,67897,9573,26952,185924,158972,Yes
CITGubbi,Aerospace Engineering,KCET,2024,74405,65523,12056,12267,164251,151984,No
VemanaIT,Artificial Intelligence and Data Science,COMEDK,2024,234143,84904,17007,25471,361525,336054,Yes
HKBK,Information Science and Engineering,KCET,2024,68333,92864,8316,15395,184908,169513,Yes
RVUNIV,Artificial Intelligence and Data Science,KCET,2024,61677,83939,13048,29005,187669,158664,Yes
DrAIT,Chemical Engineering,KCET,2024,62520,86908,16921,10081,176430,166349,No
YKCE,Artificial Intelligence and Data Science,COMEDK,2023,166165,61134,12215,24023,263537,239514,Yes
HKBK,Artificial Intelligence and Data Science,COMEDK,2023,219775,66411,12285,25399,323870,298471,Yes
GIT,Data Science,KCET,2023,51770,82952,9439,23973,168134,144161,No
KLEIT,Computer Science and Engineering,COMEDK,2023,236281,75486,13758,20888,346413,325525,Yes
RVUNIV,Civil Engineering,COMEDK,2023,180537,76369,14909,23562,295377,271815,No
RVCE,Information Science and Engineering,COMEDK,2024,243737,74040,11140,20241,349158,328917,Yes
REVA,Biotechnology,COMEDK,2024,242008,82043,9505,18392,351948,333556,No
RAIT,Artificial Intelligence and Data Science,COMEDK,2023,186209,88952,16268,20267,311696,291429,No
NHCE,Electronics and Communication Engineering,KCET,2023,81615,88152,10674,16086,196527,180441,Yes
VemanaIT,Information Science and Engineering,KCET,2023,56063,64806,19300,21075,161244,140169,Yes
RAIT,Information Science and Engineering,COMEDK,2024,161916,86462,14041,13741,276160,262419,No
JSSSTU,Mechanical Engineering,KCET,2023,84854,82085,16914,19082,202935,183853,Yes
NIE,Chemical Engineering,KCET,2024,52050,64861,8585,19374,144870,125496,No
RVUNIV,Information Science and Engineering,COMEDK,2024,171453,85935,16125,19882,293395,273513,Yes
JNNCE,Computer Science and Engineering,COMEDK,2024,225646,83724,11046,25627,346043,320416,No
YKCE,Mechanical Engineering,KCET,2023,74467,92675,9651,17165,193958,176793,No
SIT,Chemical Engineering,COMEDK,2024,203457,67804,9113,28415,308789,280374,Yes
AEC,Biotechnology,KCET,2023,80870,65307,16060,26463,188700,162237,Yes
AECMandya,Biotechnology,COMEDK,2024,179941,62997,17935,13448,274321,260873,No
YKCE,Electronics and Communication Engineering,COMEDK,2023,243395,62767,13229,29302,348693,319391,No
ACU,Robotics and Automation Engineering,KCET,2024,68210,93997,8416,26014,196637,170623,No
BIT,Artificial Intelligence and Data Science,COMEDK,2023,244173,93201,19474,13968,370816,356848,No
PRES,Aerospace Engineering,KCET,2023,59144,76510,15654,18271,169579,151308,No
RNSIT,Biotechnology,KCET,2024,73959,90330,14473,29215,207977,178762,No
AIT,Robotics and Automation Engineering,COMEDK,2023,236766,73352,15962,15706,341786,326080,Yes
GIT,Electronics and Communication Engineering,KCET,2023,74483,80074,15205,27905,197667,169762,Yes
RNSIT,Computer Science and Engineering,COMEDK,2024,170431,90591,11950,17990,290962,272972,Yes
SCEM,Chemical Engineering,KCET,2023,65813,81505,13770,21255,182343,161088,Yes
SIT,Civil Engineering,KCET,2024,54680,86036,18734,27379,186829,159450,No
VVIT,Mechanical Engineering,KCET,2024,75928,78301,9413,18427,182069,163642,No
AECMandya,Aerospace Engineering,COMEDK,2024,211434,68425,16516,26222,322597,296375,No
DBIT,Chemical Engineering,COMEDK,2024,186895,61654,16473,22822,287844,265022,No
DSATM,Robotics and Automation Engineering,COMEDK,2024,249454,69732,17526,19327,356039,336712,No
SDMCET,Civil Engineering,COMEDK,2024,215240,90689,16007,15308,337244,321936,Yes
JSSSTU,Data Science,KCET,2023,71398,77459,13806,25483,188146,162663,No
SJBIT,Data Science,COMEDK,2023,209835,89674,13015,23665,336189,312524,No
BMSIT,Civil Engineering,KCET,2024,83772,69498,17658,21933,192861,170928,Yes
GMIT,Data Science,KCET,2023,84151,66263,15916,26575,192905,166330,No
SIT,Civil Engineering,COMEDK,2024,172238,64575,10261,15092,262166,247074,No
VVIT,Data Science,COMEDK,2024,244829,90260,18845,27833,381767,353934,Yes
NMIT,Electrical and Electronics Engineering,KCET,2023,68680,91962,16867,10790,188299,177509,No
RVCE,Information Science and Engineering,KCET,2023,61742,65314,18433,28398,173887,145489,Yes
BNMIT,Artificial Intelligence and Data Science,COMEDK,2024,174602,60146,16446,14912,266106,251194,Yes
AEC,Aerospace Engineering,COMEDK,2023,214434,71878,13913,19798,320023,300225,No
VIT,Computer Science and Engineering,COMEDK,2024,249192,83829,15019,26672,374712,348040,Yes
GIT,Robotics and Automation Engineering,KCET,2024,70185,89942,11323,21518,192968,171450,No
RVUNIV,Biotechnology,COMEDK,2024,194753,73545,11872,21043,301213,280170,Yes
AIT,Mechanical Engineering,KCET,2023,80078,60093,16201,15864,172236,156372,Yes
DBIT,Electrical and Electronics Engineering,COMEDK,2023,167305,89371,13427,25697,295800,270103,No
NHCE,Aerospace Engineering,KCET,2023,53647,86057,13621,27093,180418,153325,Yes
SJBIT,Data Science,KCET,2023,58617,62756,17409,13396,152178,138782,No
KLSGIT,Data Science,COMEDK,2023,206807,66000,13362,11245,297414,286169,No
SCEM,Robotics and Automation Engineering,KCET,2024,54235,67800,12629,12833,147497,134664,Yes
GMIT,Computer Science and Engineering,COMEDK,2024,203292,61354,19221,10749,294616,283867,No
NMIT,Electrical and Electronics Engineering,KCET,2023,77165,67384,16248,18361,179158,160797,Yes
VVIT,Artificial Intelligence and Data Science,COMEDK,2024,219505,81421,15703,18891,335520,316629,Yes
SDMIT,Electrical and Electronics Engineering,COMEDK,2024,171537,74672,16303,22092,284604,262512,Yes
MSRUAS,Biotechnology,KCET,2023,71748,90468,10380,27645,200241,172596,Yes
DrAIT,Civil Engineering,COMEDK,2023,178694,64346,11624,16637,271301,254664,Yes
BIT,Computer Science and Engineering,COMEDK,2023,214349,62723,13461,11296,301829,290533,Yes
EastPoint,Chemical Engineering,KCET,2023,62574,66065,15493,29404,173536,144132,No
RIT,Chemical Engineering,KCET,2023,70598,80870,14752,19615,185835,166220,No
RAIT,Electrical and Electronics Engineering,COMEDK,2024,219013,69485,19365,20670,328533,307863,Yes
JNNCE,Chemical Engineering,COMEDK,2023,243634,70795,11136,24675,350240,325565,Yes
GMIT,Electronics and Communication Engineering,COMEDK,2024,201791,65797,14407,12725,294720,281995,No
BNMIT,Computer Science and Engineering,COMEDK,2023,215672,62858,10281,28754,317565,288811,Yes
NIE,Robotics and Automation Engineering,KCET,2024,63169,79552,13331,26140,182192,156052,Yes
NHCE,Aerospace Engineering,KCET,2024,79673,74168,15714,13254,182809,169555,No
NMIT,Data Science,COMEDK,2024,222303,76848,12637,15813,327601,311788,Yes
NIE,Data Science,COMEDK,2024,235374,66463,14227,16367,332431,316064,No
NIE,Aerospace Engineering,KCET,2023,69016,63532,19695,19797,172040,152243,No
KLSGIT,Computer Science and Engineering,COMEDK,2024,212881,89187,15736,11244,329048,317804,Yes
MVJCE,Data Science,COMEDK,2024,249940,78460,16665,27530,372595,345065,No
VIT,Civil Engineering,KCET,2023,51493,72548,17620,11975,153636,141661,No
DBIT,Mechanical Engineering,KCET,2023,63058,65016,8855,10377,147306,136929,No
RVCE,Data Science,COMEDK,2023,168886,80903,16573,13131,279493,266362,Yes
SDMIT,Aerospace Engineering,KCET,2024,77574,88356,18229,19854,204013,184159,No
RVUNIV,Electrical and Electronics Engineering,KCET,2024,79133,62240,16523,22818,180714,157896,No
SCEM,Data Science,KCET,2023,54507,68128,10583,19074,152292,133218,Yes
UVCE,Robotics and Automation Engineering,COMEDK,2023,200589,70701,14682,14572,300544,285972,No
MVJCE,Computer Science and Engineering,KCET,2023,52934,78196,8638,22990,162758,139768,Yes
NHCE,Information Science and Engineering,COMEDK,2024,215352,67916,14733,18007,316008,298001,Yes
SITM,Robotics and Automation Engineering,KCET,2024,76899,76371,18399,21378,193047,171669,No
RNSIT,Robotics and Automation Engineering,KCET,2023,53290,83440,10647,29087,176464,147377,No
SITM,Artificial Intelligence and Data Science,KCET,2024,61969,70604,17429,22599,172601,150002,No
VSM,Computer Science and Engineering,COMEDK,2023,244301,62485,15450,29514,351750,322236,Yes
RNSIT,Computer Science and Engineering,KCET,2023,79583,75132,18780,14614,188109,173495,No
SDMCET,Electronics and Communication Engineering,COMEDK,2023,227465,86899,8227,10667,333258,322591,No
VVIT,Chemical Engineering,KCET,2024,67464,78311,10844,25449,182068,156619,Yes
RIT,Data Science,KCET,2023,55411,60496,12977,15415,144299,128884,Yes
BMSCE,Data Science,KCET,2023,59009,65071,8655,23043,155778,132735,No
VemanaIT,Computer Science and Engineering,KCET,2023,65024,93145,9666,10859,178694,167835,Yes
DrAIT,Information Science and Engineering,KCET,2023,70414,89223,15754,10368,185759,175391,Yes
RIT,Robotics and Automation Engineering,KCET,2024,52028,81398,19419,25193,178038,152845,No
CITGubbi,Artificial Intelligence and Data Science,COMEDK,2024,208154,90782,9650,26869,335455,308586,No
VIT,Civil Engineering,COMEDK,2023,213049,82945,19160,13124,328278,315154,No
SIT,Electronics and Communication Engineering,KCET,2023,56029,88500,8677,13650,166856,153206,Yes
PESU,Mechanical Engineering,COMEDK,2023,222959,83527,15377,18457,340320,321863,Yes
BMIT,Aerospace Engineering,KCET,2024,81410,91440,11666,10188,194704,184516,No
DrAIT,Computer Science and Engineering,COMEDK,2024,236680,64869,11158,17086,329793,312707,Yes
VSM,Biotechnology,COMEDK,2023,197840,81759,15112,16812,311523,294711,Yes
GIT,Computer Science and Engineering,COMEDK,2023,239984,65577,18701,28774,353036,324262,No
NCET,Information Science and Engineering,COMEDK,2023,161249,68905,14011,25949,270114,244165,No
KLEIT,Chemical Engineering,COMEDK,2024,211915,87857,8934,16661,325367,308706,Yes
NCET,Artificial Intelligence and Data Science,COMEDK,2024,168024,81720,9143,21424,280311,258887,Yes
AIT,Aerospace Engineering,KCET,2024,80872,67339,10876,24977,184064,159087,No
BNMIT,Data Science,KCET,2023,50241,82509,14127,13273,160150,146877,Yes
MSRIT,Civil Engineering,COMEDK,2023,193819,74383,8307,16099,292608,276509,No
SCEM,Biotechnology,KCET,2024,53672,82419,9434,15222,160747,145525,No
SJBCE,Civil Engineering,COMEDK,2024,166632,66212,16600,28460,277904,249444,No
YKCE,Computer Science and Engineering,KCET,2024,54842,88981,8499,18833,171155,152322,No
DSATM,Computer Science and Engineering,COMEDK,2023,194667,86569,8691,27694,317621,289927,Yes
MSRIT,Artificial Intelligence and Data Science,COMEDK,2023,244496,62255,8855,18253,333859,315606,Yes
SJBCE,Information Science and Engineering,COMEDK,2024,244224,94092,18203,18724,375243,356519,Yes
VVCE,Electrical and Electronics Engineering,COMEDK,2023,196209,92032,10302,19935,318478,298543,Yes
NCET,Artificial Intelligence and Data Science,KCET,2023,65370,92731,17944,20899,196944,176045,Yes
RAIT,Biotechnology,COMEDK,2023,223517,94626,15720,27563,361426,333863,No
KSIT,Civil Engineering,KCET,2024,73564,74930,19379,26491,194364,167873,Yes
SDMIT,Mechanical Engineering,COMEDK,2024,171701,69370,17714,12067,270852,258785,No
DSATM,Civil Engineering,KCET,2023,69397,76847,18982,23215,188441,165226,Yes
SIT,Biotechnology,COMEDK,2023,187677,69678,17393,10541,285289,274748,Yes
YKCE,Civil Engineering,COMEDK,2024,214263,83959,14213,26692,339127,312435,No
MVJCE,Information Science and Engineering,KCET,2024,55905,79062,14970,23088,173025,149937,No
DBIT,Mechanical Engineering,KCET,2024,84334,79025,9461,13699,186519,172820,Yes
JNNCE,Computer Science and Engineering,KCET,2024,76244,81314,10596,24303,192457,168154,Yes
VemanaIT,Aerospace Engineering,KCET,2023,78542,81733,18319,13702,192296,178594,Yes
PESU,Civil Engineering,COMEDK,2024,189166,89353,10179,13155,301853,288698,No
RIT,Artificial Intelligence and Data Science,COMEDK,2023,198784,82510,16038,23540,320872,297332,No
DSATM,Artificial Intelligence and Data Science,COMEDK,2023,195423,61656,17575,25791,300445,274654,Yes
AECMandya,Artificial Intelligence and Data Science,KCET,2023,51064,66068,10395,10825,138352,127527,Yes
KLEIT,Aerospace Engineering,KCET,2023,52299,69748,17293,13284,152624,139340,No
BMSCE,Information Science and Engineering,COMEDK,2023,249069,63036,17149,19008,348262,329254,Yes
UVCE,Mechanical Engineering,KCET,2023,70999,93927,13740,29612,208278,178666,No
RVUNIV,Civil Engineering,COMEDK,2023,231723,93712,16579,21153,363167,342014,No
RAIT,Artificial Intelligence and Data Science,COMEDK,2024,198306,88872,8006,15705,310889,295184,Yes
CMRIT,Aerospace Engineering,COMEDK,2024,216530,82542,9193,18834,327099,308265,No
PESU,Robotics and Automation Engineering,KCET,2024,58797,85995,10622,19273,174687,155414,No
MSRIT,Artificial Intelligence and Data Science,KCET,2023,59740,64162,8315,19775,151992,132217,No
REVA,Data Science,COMEDK,2024,237905,86284,14350,19040,357579,338539,Yes
PESU,Information Science and Engineering,KCET,2023,71068,92490,13198,11045,187801,176756,No
DrAIT,Mechanical Engineering,KCET,2024,81893,74006,12220,22160,190279,168119,Yes
BMIT,Chemical Engineering,COMEDK,2023,170995,76344,12563,28119,288021,259902,Yes
MVJCE,Robotics and Automation Engineering,COMEDK,2024,187129,77107,19653,19875,303764,283889,No
DBIT,Electrical and Electronics Engineering,KCET,2023,79567,65983,10804,21072,177426,156354,Yes
NHCE,Information Science and Engineering,COMEDK,2024,245620,94014,10713,10827,361174,350347,No
MSRUAS,Biotechnology,COMEDK,2024,174202,87197,13894,15156,290449,275293,No
RVUNIV,Electronics and Communication Engineering,KCET,2024,70522,61867,19791,28525,180705,152180,Yes
VemanaIT,Mechanical Engineering,KCET,2023,69653,63342,11331,28655,172981,144326,No
SJBIT,Mechanical Engineering,COMEDK,2023,246736,72168,9779,19443,348126,328683,Yes
RNSIT,Civil Engineering,COMEDK,2024,189832,81716,12298,23944,307790,283846,No
YKCE,Aerospace Engineering,KCET,2024,84940,78352,12550,26998,202840,175842,No
MSRUAS,Electrical and Electronics Engineering,COMEDK,2023,239421,81052,14176,12932,347581,334649,Yes
YKCE,Mechanical Engineering,KCET,2024,68154,89902,12952,13241,184249,171008,Yes
VIT,Information Science and Engineering,KCET,2023,80512,90678,8561,12229,191980,179751,No
SDMCET,Electronics and Communication Engineering,COMEDK,2024,248306,75323,13567,24935,362131,337196,Yes
PRES,Electronics and Communication Engineering,COMEDK,2023,219154,93873,19414,16972,349413,332441,Yes
DSATM,Data Science,COMEDK,2024,224530,89371,11483,14362,339746,325384,Yes
NHCE,Information Science and Engineering,KCET,2023,79421,90315,19687,29928,219351,189423,No
KLSGIT,Information Science and Engineering,KCET,2023,72951,61431,8293,15025,157700,142675,No
REVA,Electrical and Electronics Engineering,KCET,2024,83278,65931,14356,20185,183750,163565,Yes
GMIT,Data Science,COMEDK,2024,244590,73142,9651,10793,338176,327383,No
BMSIT,Aerospace Engineering,KCET,2023,71924,79604,19285,29518,200331,170813,No
REVA,Artificial Intelligence and Data Science,KCET,2023,71543,78638,11544,27120,188845,161725,Yes
DSATM,Robotics and Automation Engineering,COMEDK,2023,213185,90783,8464,22327,334759,312432,No
SCEM,Electronics and Communication Engineering,KCET,2023,61791,93271,9753,17016,181831,164815,No
HKBK,Biotechnology,KCET,2023,52016,65061,16027,10706,143810,133104,Yes
REVA,Data Science,KCET,2023,83198,86776,9378,12551,191903,179352,No
BMSCE,Chemical Engineering,COMEDK,2023,163474,90157,11226,19214,284071,264857,No
SITM,Electrical and Electronics Engineering,KCET,2023,74704,70261,8493,26079,179537,153458,No
DrAIT,Aerospace Engineering,COMEDK,2024,163992,84371,8556,21725,278644,256919,No
EastPoint,Robotics and Automation Engineering,COMEDK,2024,247519,75686,9012,17172,349389,332217,Yes
NHCE,Aerospace Engineering,COMEDK,2023,213768,70967,14164,28882,327781,298899,Yes
DrAIT,Information Science and Engineering,COMEDK,2024,177203,68623,19216,16941,281983,265042,No
MVJCE,Mechanical Engineering,COMEDK,2024,165123,90422,19099,25453,300097,274644,Yes
BMSIT,Electronics and Communication Engineering,KCET,2024,65829,75493,14912,15149,171383,156234,No
NHCE,Artificial Intelligence and Data Science,COMEDK,2024,191106,78238,16560,28085,313989,285904,No
AEC,Chemical Engineering,COMEDK,2023,240280,67509,8158,19191,335138,315947,No
REVA,Artificial Intelligence and Data Science,COMEDK,2024,180940,76792,19956,17176,294864,277688,Yes
JSSSTU,Information Science and Engineering,COMEDK,2023,230574,89158,9707,19734,349173,329439,No
YKCE,Chemical Engineering,KCET,2023,66535,79603,8372,17552,172062,154510,No
VIT,Artificial Intelligence and Data Science,KCET,2023,53014,75007,17837,24860,170718,145858,No
JSSSTU,Chemical Engineering,COMEDK,2023,162564,89155,8961,10875,271555,260680,Yes
PESCE,Electronics and Communication Engineering,KCET,2024,68928,85272,10223,11163,175586,164423,No
SDMIT,Electronics and Communication Engineering,COMEDK,2024,160189,90414,15575,12932,279110,266178,Yes
JNNCE,Information Science and Engineering,KCET,2023,78665,65293,13055,20216,177229,157013,Yes
AEC,Electrical and Electronics Engineering,COMEDK,2023,229614,67915,17930,21346,336805,315459,No
AITM,Chemical Engineering,COMEDK,2024,184026,69385,12780,28229,294420,266191,Yes
KLEIT,Data Science,COMEDK,2023,170086,93096,9694,16239,289115,272876,No
BIT,Robotics and Automation Engineering,COMEDK,2024,222780,78030,16089,13208,330107,316899,No
HKBK,Chemical Engineering,KCET,2024,57121,85497,15794,25944,184356,158412,Yes
NCET,Chemical Engineering,COMEDK,2023,219046,71903,13862,11832,316643,304811,Yes
AEC,Robotics and Automation Engineering,COMEDK,2024,174200,82724,19122,23964,300010,276046,Yes
PESU,Aerospace Engineering,COMEDK,2024,194195,93810,18729,12539,319273,306734,No
SDMCET,Robotics and Automation Engineering,KCET,2024,77430,60898,11641,14824,164793,149969,No
RIT,Information Science and Engineering,COMEDK,2024,178831,76757,8691,18047,282326,264279,No
JNNCE,Electronics and Communication Engineering,COMEDK,2023,189395,86894,8432,15331,300052,284721,Yes
JSSSTU,Biotechnology,KCET,2023,56761,87746,16762,10929,172198,161269,No
EastPoint,Aerospace Engineering,COMEDK,2024,179373,60969,8263,25195,273800,248605,No
KLEIT,Robotics and Automation Engineering,COMEDK,2023,217864,77415,8424,24518,328221,303703,Yes
SDMIT,Computer Science and Engineering,KCET,2023,80257,83878,15935,12772,192842,180070,No
AECMandya,Biotechnology,COMEDK,2024,230602,89907,12419,20178,353106,332928,No
DrAIT,Artificial Intelligence and Data Science,KCET,2023,54935,79759,13735,25142,173571,148429,Yes
MSRUAS,Biotechnology,KCET,2023,56183,93550,13315,24517,187565,163048,No
PESCE,Information Science and Engineering,COMEDK,2024,167541,92347,13272,14760,287920,273160,Yes
NMIT,Electrical and Electronics Engineering,KCET,2024,70203,83610,16149,17062,187024,169962,Yes
BMIT,Biotechnology,KCET,2023,82725,69263,11708,16157,179853,163696,Yes
PESU,Chemical Engineering,COMEDK,2023,173230,62658,19849,10173,265910,255737,Yes
KLSGIT,Chemical Engineering,KCET,2023,56327,81819,9690,22792,170628,147836,Yes
RIT,Civil Engineering,KCET,2023,84325,73834,16989,19503,194651,175148,Yes
VVIT,Artificial Intelligence and Data Science,COMEDK,2024,169349,61898,8022,23946,263215,239269,No
VVCE,Data Science,COMEDK,2023,195580,77423,10895,16171,300069,283898,Yes
HKBK,Aerospace Engineering,KCET,2024,60164,74406,8193,16053,158816,142763,No
AECMandya,Data Science,KCET,2024,55878,79802,9983,19873,165536,145663,No
NIE,Data Science,COMEDK,2023,233012,76662,12290,22425,344389,321964,Yes
SIT,Biotechnology,KCET,2024,69857,70151,16395,19252,175655,156403,No
DrAIT,Aerospace Engineering,KCET,2024,68755,91520,8135,12410,180820,168410,No
BMSCE,Civil Engineering,KCET,2023,63624,93288,12800,18238,187950,169712,No
RVUNIV,Electronics and Communication Engineering,COMEDK,2023,217446,94075,9358,10976,331855,320879,Yes
CITGubbi,Mechanical Engineering,COMEDK,2023,171550,89202,16297,28645,305694,277049,No
CMRIT,Robotics and Automation Engineering,COMEDK,2023,248876,68607,8277,28620,354380,325760,Yes
SDMIT,Civil Engineering,COMEDK,2024,231000,63672,17079,29921,341672,311751,No
NHCE,Computer Science and Engineering,COMEDK,2023,173625,81260,17264,25219,297368,272149,Yes
BMSIT,Biotechnology,KCET,2023,54684,93761,14719,25508,188672,163164,Yes
RIT,Mechanical Engineering,KCET,2023,69840,78574,9618,29563,187595,158032,No
JNNCE,Chemical Engineering,COMEDK,2023,169423,84299,9728,20082,283532,263450,Yes
JNNCE,Civil Engineering,COMEDK,2024,177001,64080,12077,24684,277842,253158,Yes
RVCE,Electronics and Communication Engineering,KCET,2024,73806,88779,12378,21187,196150,174963,No
VVCE,Robotics and Automation Engineering,KCET,2023,50349,62897,19948,13976,147170,133194,No
VSM,Computer Science and Engineering,COMEDK,2023,201289,75526,19815,20664,317294,296630,No
BMIT,Information Science and Engineering,KCET,2023,79704,74439,11935,27256,193334,166078,Yes
MSRUAS,Civil Engineering,COMEDK,2024,195772,77284,18062,16361,307479,291118,Yes
RVUNIV,Electronics and Communication Engineering,KCET,2023,67046,86271,14210,25062,192589,167527,Yes
SIT,Chemical Engineering,KCET,2024,79323,68535,10317,26699,184874,158175,No
RIT,Information Science and Engineering,COMEDK,2024,173050,77755,9963,20303,281071,260768,Yes
MSRUAS,Information Science and Engineering,COMEDK,2024,225782,86733,15801,12746,341062,328316,No
SCEM,Artificial Intelligence and Data Science,KCET,2023,75234,93953,18504,13986,201677,187691,Yes
UVCE,Aerospace Engineering,COMEDK,2024,249799,93271,12442,25977,381489,355512,Yes
AECMandya,Data Science,COMEDK,2023,227971,83250,16098,21806,349125,327319,No
PESU,Chemical Engineering,KCET,2024,82762,65857,10842,15343,174804,159461,No
BMIT,Data Science,COMEDK,2023,219171,78621,18610,17825,334227,316402,Yes
EastPoint,Electronics and Communication Engineering,KCET,2024,58956,64838,15119,22636,161549,138913,Yes
MSRIT,Aerospace Engineering,COMEDK,2024,216996,86741,12244,18769,334750,315981,No
DBIT,Mechanical Engineering,COMEDK,2024,162974,76644,12479,23985,276082,252097,No
RNSIT,Aerospace Engineering,KCET,2023,78468,77687,13527,25124,194806,169682,Yes
BMIT,Chemical Engineering,COMEDK,2023,218075,88840,11919,16018,334852,318834,Yes
SDMIT,Aerospace Engineering,COMEDK,2024,181199,89611,11150,23509,305469,281960,Yes
DBIT,Aerospace Engineering,COMEDK,2023,168712,74482,11048,28944,283186,254242,Yes
RNSIT,Data Science,COMEDK,2024,196469,60139,13371,12393,282372,269979,Yes
RAIT,Computer Science and Engineering,KCET,2024,84597,89905,12606,12045,199153,187108,No
PESU,Civil Engineering,KCET,2024,65055,76183,17927,12101,171266,159165,No
VIT,Chemical Engineering,KCET,2023,50173,64183,16987,12172,143515,131343,No
BNMIT,Chemical Engineering,COMEDK,2024,247159,60633,13207,23235,344234,320999,Yes
KSIT,Civil Engineering,COMEDK,2024,182084,63160,9858,12396,267498,255102,Yes
BIT,Data Science,KCET,2024,67800,68803,15971,26340,178914,152574,No
DSCE,Robotics and Automation Engineering,COMEDK,2024,176506,83756,9403,25731,295396,269665,Yes
NCET,Electronics and Communication Engineering,KCET,2023,55478,93522,9954,12730,171684,158954,No
RVCE,Electrical and Electronics Engineering,KCET,2024,82436,73405,18430,14916,189187,174271,Yes
NIE,Robotics and Automation Engineering,KCET,2024,54668,66881,8920,24242,154711,130469,Yes
ACU,Information Science and Engineering,KCET,2024,64276,70488,18515,23448,176727,153279,Yes
BNMIT,Artificial Intelligence and Data Science,KCET,2023,56551,64324,18918,24134,163927,139793,No
DBIT,Artificial Intelligence and Data Science,COMEDK,2023,219738,93233,8589,15548,337108,321560,Yes
AEC,Robotics and Automation Engineering,COMEDK,2023,183129,75880,16090,16196,291295,275099,No
RNSIT,Electronics and Communication Engineering,KCET,2024,78764,73454,9641,25970,187829,161859,No
BMSIT,Electronics and Communication Engineering,COMEDK,2024,248322,62325,14509,14862,340018,325156,Yes
RVUNIV,Information Science and Engineering,KCET,2024,70539,84065,15679,22692,192975,170283,Yes
RIT,Aerospace Engineering,COMEDK,2024,219914,62050,18234,21668,321866,300198,Yes
NCET,Data Science,COMEDK,2024,234092,63639,9807,16257,323795,307538,Yes
VVIT,Biotechnology,KCET,2024,53896,70863,19794,26461,171014,144553,Yes
AEC,Chemical Engineering,COMEDK,2023,167826,90545,8320,25587,292278,266691,Yes
AIT,Artificial Intelligence and Data Science,COMEDK,2024,217427,78308,19209,12149,327093,314944,No
NMIT,Robotics and Automation Engineering,COMEDK,2024,214556,93555,19255,27447,354813,327366,No
BMIT,Chemical Engineering,COMEDK,2023,163393,88989,9292,26791,288465,261674,No
DSATM,Information Science and Engineering,COMEDK,2023,185030,92789,14131,27248,319198,291950,No
DSCE,Aerospace Engineering,COMEDK,2023,197547,70138,18385,18338,304408,286070,No
BMSIT,Electrical and Electronics Engineering,COMEDK,2023,187679,84797,11830,17068,301374,284306,No
SJBCE,Computer Science and Engineering,COMEDK,2024,178906,92066,16481,14559,302012,287453,Yes
DrAIT,Aerospace Engineering,COMEDK,2024,174430,63608,9724,18436,266198,247762,Yes
BIT,Mechanical Engineering,KCET,2024,70275,82205,15508,22580,190568,167988,No
JSSSTU,Chemical Engineering,COMEDK,2023,227549,66506,13675,28297,336027,307730,Yes
AECMandya,Aerospace Engineering,COMEDK,2023,172255,82993,10017,29248,294513,265265,No
JIT,Aerospace Engineering,KCET,2024,63075,61806,10251,25919,161051,135132,Yes
RVCE,Artificial Intelligence and Data Science,KCET,2023,65524,79067,19008,21104,184703,163599,No
GMIT,Mechanical Engineering,COMEDK,2024,235184,93426,11286,21921,361817,339896,Yes
JIT,Electronics and Communication Engineering,COMEDK,2023,188593,90920,14391,25811,319715,293904,No
NHCE,Electronics and Communication Engineering,COMEDK,2023,248539,93897,10400,12111,364947,352836,No
PESCE,Information Science and Engineering,COMEDK,2024,209405,93955,18833,24310,346503,322193,Yes
DSATM,Information Science and Engineering,KCET,2023,66239,77179,10719,21085,175222,154137,Yes
DSATM,Biotechnology,KCET,2024,78375,74700,19108,14208,186391,172183,Yes
CITGubbi,Electrical and Electronics Engineering,KCET,2023,77531,78822,12483,21112,189948,168836,Yes
SJBCE,Artificial Intelligence and Data Science,COMEDK,2023,246698,85487,15159,23916,371260,347344,No
AEC,Electronics and Communication Engineering,COMEDK,2023,202689,62798,13695,26445,305627,279182,No
BIT,Mechanical Engineering,COMEDK,2023,169733,69568,12679,16165,268145,251980,No
EastPoint,Artificial Intelligence and Data Science,KCET,2024,81606,64326,11321,16567,173820,157253,No
BNMIT,Artificial Intelligence and Data Science,KCET,2024,50764,68799,17124,17671,154358,136687,No
VIT,Robotics and Automation Engineering,KCET,2024,76866,78049,11579,19361,185855,166494,Yes
PESU,Electronics and Communication Engineering,COMEDK,2024,213140,70666,18487,19322,321615,302293,Yes
REVA,Electronics and Communication Engineering,COMEDK,2024,201259,92207,9524,13200,316190,302990,Yes
JIT,Data Science,COMEDK,2023,241330,63056,19051,23415,346852,323437,No
EastPoint,Biotechnology,COMEDK,2023,182541,80373,9941,10204,283059,272855,Yes
GIT,Electronics and Communication Engineering,KCET,2024,81868,67271,14315,26899,190353,163454,No
CMRIT,Mechanical Engineering,KCET,2024,82249,61856,8050,15653,167808,152155,Yes
BMIT,Chemical Engineering,KCET,2023,64566,71455,19783,28049,183853,155804,No
GMIT,Data Science,KCET,2024,58883,61125,15098,19989,155095,135106,No
MSRIT,Computer Science and Engineering,COMEDK,2023,176509,64948,19312,17222,277991,260769,Yes
SDMCET,Aerospace Engineering,COMEDK,2023,178758,84842,14403,25696,303699,278003,No
AITM,Electrical and Electronics Engineering,KCET,2023,66301,78866,10262,21205,176634,155429,Yes
MSRUAS,Electronics and Communication Engineering,KCET,2023,73156,91056,13539,14502,192253,177751,Yes
DSATM,Civil Engineering,COMEDK,2024,200839,93368,15217,22868,332292,309424,No
CMRIT,Computer Science and Engineering,KCET,2023,64140,72918,18923,10082,166063,155981,No
RVUNIV,Robotics and Automation Engineering,KCET,2024,69404,76173,11067,28427,185071,156644,Yes
VIT,Information Science and Engineering,KCET,2023,72168,94447,13602,25682,205899,180217,No
RVUNIV,Artificial Intelligence and Data Science,COMEDK,2023,209319,93240,15241,18346,336146,317800,No
GMIT,Chemical Engineering,COMEDK,2024,219601,88286,12895,21041,341823,320782,Yes
EastPoint,Civil Engineering,KCET,2024,79178,87700,18016,25458,210352,184894,No
VSM,Mechanical Engineering,KCET,2024,82952,92655,14995,27818,218420,190602,No
DSATM,Biotechnology,KCET,2023,52257,66536,10867,26612,156272,129660,No
RVCE,Electrical and Electronics Engineering,KCET,2024,67588,68057,16663,26296,178604,152308,No
SITM,Civil Engineering,COMEDK,2023,228964,65467,19410,13860,327701,313841,No
BMSCE,Aerospace Engineering,KCET,2023,80356,74868,11313,17574,184111,166537,No
DSCE,Electrical and Electronics Engineering,COMEDK,2023,216833,78395,18968,10793,324989,314196,No
BMSCE,Biotechnology,KCET,2023,71741,67661,9244,26173,174819,148646,No
KLEIT,Chemical Engineering,COMEDK,2023,197902,93464,10568,12354,314288,301934,Yes
JNNCE,Mechanical Engineering,COMEDK,2023,176844,73082,14295,12733,276954,264221,Yes
DSATM,Robotics and Automation Engineering,KCET,2024,54664,64855,15915,29052,164486,135434,Yes
JSSSTU,Computer Science and Engineering,COMEDK,2024,160064,62085,10583,18156,250888,232732,No
NMIT,Data Science,COMEDK,2023,212048,79966,17181,21721,330916,309195,Yes
BMSIT,Electrical and Electronics Engineering,COMEDK,2024,178443,91848,16131,17074,303496,286422,Yes
GMIT,Data Science,COMEDK,2024,233506,82832,15318,22675,354331,331656,No
SCEM,Electrical and Electronics Engineering,COMEDK,2024,216288,61760,18995,24712,321755,297043,No
REVA,Artificial Intelligence and Data Science,KCET,2023,63228,74930,11490,19919,169567,149648,Yes
VIT,Aerospace Engineering,COMEDK,2023,165262,70042,18155,10980,264439,253459,No
VSM,Data Science,KCET,2024,60545,70203,12139,13098,155985,142887,Yes
BMIT,Computer Science and Engineering,COMEDK,2024,248276,78005,12408,12434,351123,338689,Yes
RVUNIV,Biotechnology,KCET,2023,64956,77667,15141,17951,175715,157764,Yes
VVIT,Electrical and Electronics Engineering,COMEDK,2024,186539,90611,13124,23600,313874,290274,No
EastPoint,Civil Engineering,KCET,2024,67354,89525,8265,22245,187389,165144,Yes
BITM,Computer Science and Engineering,KCET,2023,84092,88270,17500,22087,211949,189862,No
VVIT,Electronics and Communication Engineering,COMEDK,2023,188829,89054,18072,25387,321342,295955,No
SJBCE,Information Science and Engineering,KCET,2024,59292,72397,9161,14345,155195,140850,No
MSRUAS,Artificial Intelligence and Data Science,COMEDK,2023,246642,93446,11097,23911,375096,351185,No
NHCE,Chemical Engineering,KCET,2023,61620,64541,12714,17435,156310,138875,Yes
PESU,Mechanical Engineering,KCET,2023,77540,64378,16899,23272,182089,158817,No
BMSIT,Chemical Engineering,KCET,2023,58401,81123,11442,11910,162876,150966,Yes
RNSIT,Chemical Engineering,KCET,2023,63942,94510,13530,17766,189748,171982,No
RNSIT,Electrical and Electronics Engineering,KCET,2024,54685,83175,19972,28679,186511,157832,Yes
ACU,Information Science and Engineering,COMEDK,2024,176711,68706,19251,18489,283157,264668,Yes
PESCE,Mechanical Engineering,COMEDK,2023,241505,85568,13039,12949,353061,340112,Yes
BMSIT,Electronics and Communication Engineering,COMEDK,2023,247106,63466,9311,19225,339108,319883,No
PESU,Civil Engineering,KCET,2023,50809,92657,12969,26386,182821,156435,Yes
BNMIT,Electronics and Communication Engineering,COMEDK,2024,231790,67555,12988,14595,326928,312333,Yes
CITGubbi,Chemical Engineering,COMEDK,2023,162651,94581,15952,29450,302634,273184,No
BIT,Biotechnology,KCET,2024,60980,60357,17833,10503,149673,139170,Yes
JIT,Civil Engineering,KCET,2023,75274,81440,15713,13480,185907,172427,Yes
KLSGIT,Information Science and Engineering,KCET,2023,72096,60386,15213,13492,161187,147695,No
ACU,Biotechnology,KCET,2023,76044,70390,16628,16799,179861,163062,Yes
UVCE,Computer Science and Engineering,COMEDK,2023,187606,76191,8606,26132,298535,272403,No
DrAIT,Biotechnology,COMEDK,2023,214877,88617,17554,14747,335795,321048,No
VVIT,Artificial Intelligence and Data Science,KCET,2024,64635,91425,16088,27801,199949,172148,No
RVUNIV,Mechanical Engineering,COMEDK,2024,180865,67098,16879,25658,290500,264842,No
ACU,Robotics and Automation Engineering,COMEDK,2023,181628,87676,8932,18844,297080,278236,Yes
NHCE,Civil Engineering,KCET,2024,69209,91815,11652,12470,185146,172676,Yes
MSRIT,Civil Engineering,COMEDK,2024,182167,92295,15141,13314,302917,289603,Yes
JNNCE,Electronics and Communication Engineering,COMEDK,2023,164181,79970,18816,14447,277414,262967,No
AITM,Data Science,COMEDK,2023,245793,74210,14583,11644,346230,334586,No
DSCE,Aerospace Engineering,COMEDK,2023,223917,71538,15806,23237,334498,311261,Yes
VemanaIT,Mechanical Engineering,COMEDK,2024,176365,60358,16299,13018,266040,253022,Yes
GIT,Mechanical Engineering,COMEDK,2024,179885,60397,8658,25357,274297,248940,No
KSIT,Biotechnology,COMEDK,2023,170386,91343,16905,25141,303775,278634,No
MVJCE,Computer Science and Engineering,KCET,2023,68161,93821,18246,24506,204734,180228,Yes
BITM,Computer Science and Engineering,COMEDK,2024,230130,76917,14213,26626,347886,321260,Yes
GMIT,Artificial Intelligence and Data Science,KCET,2023,64173,63694,16862,22304,167033,144729,No
PESCE,Information Science and Engineering,COMEDK,2023,245507,86167,14739,13378,359791,346413,Yes
JIT,Computer Science and Engineering,COMEDK,2023,171665,84828,19843,23584,299920,276336,Yes
BITM,Electrical and Electronics Engineering,KCET,2023,63440,92113,14685,17945,188183,170238,No
ACU,Chemical Engineering,KCET,2024,53918,70893,17910,21227,163948,142721,Yes
VVCE,Data Science,KCET,2024,83103,61184,13453,17960,175700,157740,No
BNMIT,Aerospace Engineering,KCET,2023,65471,72916,8954,10208,157549,147341,No
JIT,Electrical and Electronics Engineering,KCET,2023,83755,81110,17463,21901,204229,182328,Yes
SIT,Information Science and Engineering,KCET,2023,51884,69900,14638,14041,150463,136422,Yes
JNNCE,Artificial Intelligence and Data Science,COMEDK,2023,214818,60396,13742,25108,314064,288956,No
DBIT,Robotics and Automation Engineering,COMEDK,2023,234651,83484,18170,12348,348653,336305,Yes
BIT,Civil Engineering,KCET,2023,59886,76661,17384,11306,165237,153931,No
GMIT,Computer Science and Engineering,COMEDK,2023,184621,72141,10229,21324,288315,266991,Yes
DSATM,Aerospace Engineering,COMEDK,2024,209282,72402,14610,21768,318062,296294,Yes
CITGubbi,Biotechnology,KCET,2024,52409,73861,13805,10265,150340,140075,Yes
DSCE,Chemical Engineering,KCET,2024,72695,60195,9974,24598,167462,142864,Yes
MSRUAS,Civil Engineering,KCET,2023,59405,72189,10708,20367,162669,142302,No
ACU,Data Science,KCET,2024,70683,65746,8737,12253,157419,145166,Yes
HKBK,Chemical Engineering,KCET,2024,51978,92879,9208,29156,183221,154065,Yes
VVCE,Data Science,KCET,2023,78206,93491,19759,17055,208511,191456,Yes
HKBK,Biotechnology,COMEDK,2024,173222,91783,10714,14781,290500,275719,No
RIT,Computer Science and Engineering,COMEDK,2024,220634,74408,17068,15308,327418,312110,Yes
SITM,Mechanical Engineering,COMEDK,2023,204723,85002,11407,22548,323680,301132,Yes
CMRIT,Civil Engineering,KCET,2023,80380,70643,17950,23485,192458,168973,Yes
EastPoint,Data Science,COMEDK,2024,172881,78587,12773,19250,283491,264241,Yes
RVUNIV,Chemical Engineering,COMEDK,2023,167409,89578,14595,28499,300081,271582,No
BIT,Mechanical Engineering,COMEDK,2024,172060,71865,8062,13017,265004,251987,No
NCET,Robotics and Automation Engineering,COMEDK,2024,191959,63748,14507,13017,283231,270214,No
GIT,Civil Engineering,KCET,2024,74887,85752,18615,20775,200029,179254,No
KLSGIT,Aerospace Engineering,KCET,2023,72446,84799,11152,15540,183937,168397,Yes
KLSGIT,Chemical Engineering,COMEDK,2024,184498,76663,13803,23726,298690,274964,No
ACU,Electrical and Electronics Engineering,COMEDK,2023,197345,82393,12731,13516,305985,292469,Yes
BMSCE,Biotechnology,KCET,2024,78158,70292,10417,17722,176589,158867,Yes
CITGubbi,Civil Engineering,COMEDK,2024,177990,64428,17217,20192,279827,259635,Yes
YKCE,Data Science,COMEDK,2023,224422,60208,14518,24200,323348,299148,No
BNMIT,Artificial Intelligence and Data Science,COMEDK,2023,184592,67950,12595,13863,279000,265137,No
SCEM,Biotechnology,COMEDK,2023,187342,69668,8033,20141,285184,265043,No
NCET,Mechanical Engineering,KCET,2024,55318,62672,18319,23922,160231,136309,No
GMIT,Mechanical Engineering,COMEDK,2023,217613,82077,14811,18109,332610,314501,Yes
MSRIT,Electronics and Communication Engineering,COMEDK,2023,246513,86062,16163,21181,369919,348738,No
PRES,Data Science,COMEDK,2023,208896,73521,16188,23716,322321,298605,Yes
BMSIT,Civil Engineering,COMEDK,2023,179837,82790,14226,14056,290909,276853,Yes
SITM,Computer Science and Engineering,COMEDK,2024,210898,66551,15455,18472,311376,292904,Yes
VVIT,Artificial Intelligence and Data Science,COMEDK,2023,189819,88163,9551,22803,310336,287533,Yes
BIT,Electronics and Communication Engineering,KCET,2024,51820,65435,12633,21301,151189,129888,Yes
UVCE,Aerospace Engineering,KCET,2023,55337,66296,15955,15716,153304,137588,Yes
AITM,Information Science and Engineering,COMEDK,2023,185713,73394,12877,21948,293932,271984,Yes
BMSCE,Data Science,KCET,2024,57230,92551,11200,27251,188232,160981,No
AECMandya,Civil Engineering,KCET,2023,55198,89421,19736,26151,190506,164355,Yes
KSIT,Computer Science and Engineering,COMEDK,2024,231021,91897,14654,27623,365195,337572,No
UVCE,Computer Science and Engineering,COMEDK,2024,245861,94047,9587,28030,377525,349495,Yes
GMIT,Data Science,COMEDK,2023,167090,82860,18161,27345,295456,268111,No
VVIT,Biotechnology,COMEDK,2023,224414,87901,15241,10828,338384,327556,No
KLSGIT,Electronics and Communication Engineering,COMEDK,2024,249310,82360,9169,27872,368711,340839,No
AIT,Robotics and Automation Engineering,COMEDK,2024,237081,66381,8245,22208,333915,311707,No
KSIT,Mechanical Engineering,KCET,2024,65895,90252,18516,18252,192915,174663,Yes
BMIT,Data Science,COMEDK,2024,186005,83226,10383,29532,309146,279614,Yes
KLEIT,Chemical Engineering,COMEDK,2024,161736,76923,14700,19792,273151,253359,Yes
DrAIT,Information Science and Engineering,KCET,2024,75000,81077,12112,19589,187778,168189,Yes
PESCE,Robotics and Automation Engineering,KCET,2023,78524,85184,8074,24220,196002,171782,Yes
DSATM,Artificial Intelligence and Data Science,KCET,2024,64535,64427,10317,29210,168489,139279,No
DSCE,Mechanical Engineering,KCET,2024,62288,64862,14571,28612,170333,141721,Yes
RNSIT,Electrical and Electronics Engineering,KCET,2023,66870,92038,8997,21649,189554,167905,Yes
KSIT,Mechanical Engineering,COMEDK,2024,171775,86915,13147,29037,300874,271837,No
RIT,Electronics and Communication Engineering,KCET,2023,84422,71421,11246,24795,191884,167089,No
BMSCE,Artificial Intelligence and Data Science,COMEDK,2023,178646,81030,11561,12242,283479,271237,Yes
RAIT,Chemical Engineering,KCET,2024,51703,63979,15065,29616,160363,130747,Yes
HKBK,Mechanical Engineering,KCET,2024,59864,91653,15786,23282,190585,167303,No
DSATM,Electrical and Electronics Engineering,KCET,2023,52127,62401,19523,15710,149761,134051,Yes
EastPoint,Civil Engineering,COMEDK,2024,220412,66254,15152,25854,327672,301818,No
BMSCE,Biotechnology,COMEDK,2024,190934,81952,12768,13033,298687,285654,No
RIT,Civil Engineering,KCET,2023,50763,75181,16678,10093,152715,142622,Yes
NMIT,Computer Science and Engineering,COMEDK,2024,238479,76943,8444,14735,338601,323866,No
SDMIT,Aerospace Engineering,COMEDK,2024,160683,62364,13501,16418,252966,236548,No
MSRIT,Biotechnology,KCET,2023,60177,74791,13175,10724,158867,148143,Yes
PRES,Artificial Intelligence and Data Science,KCET,2023,70481,81161,11944,28078,191664,163586,No
SIT,Mechanical Engineering,KCET,2023,57236,71160,17675,21855,167926,146071,No
RIT,Biotechnology,KCET,2024,74261,61930,8570,25772,170533,144761,Yes
PESCE,Chemical Engineering,KCET,2023,81009,72128,19944,29896,202977,173081,Yes
NMIT,Data Science,COMEDK,2023,206130,68981,17084,18494,310689,292195,No
JNNCE,Civil Engineering,COMEDK,2023,207487,93454,9510,22082,332533,310451,Yes
VVCE,Data Science,COMEDK,2023,219206,61599,19045,22595,322445,299850,Yes
BMSIT,Biotechnology,COMEDK,2024,214991,90078,12048,20637,337754,317117,No
PESU,Robotics and Automation Engineering,COMEDK,2023,162541,60473,19309,18384,260707,242323,No
KSIT,Civil Engineering,COMEDK,2023,179906,69843,15887,15268,280904,265636,Yes
DSATM,Data Science,KCET,2023,52798,81112,17341,28632,179883,151251,No
SITM,Electronics and Communication Engineering,COMEDK,2024,240290,64545,11590,13528,329953,316425,Yes
SDMIT,Electrical and Electronics Engineering,KCET,2024,59424,81856,12158,25348,178786,153438,No
KSIT,Electrical and Electronics Engineering,KCET,2023,67513,83854,14735,12205,178307,166102,Yes
PRES,Information Science and Engineering,COMEDK,2023,242254,75867,11763,29300,359184,329884,No
CMRIT,Artificial Intelligence and Data Science,COMEDK,2023,212718,86386,18736,20187,338027,317840,No
JIT,Civil Engineering,COMEDK,2024,171386,94501,8532,12328,286747,274419,Yes
DrAIT,Data Science,COMEDK,2024,167300,87243,16152,22869,293564,270695,No
VemanaIT,Data Science,COMEDK,2023,213400,62121,8139,13487,297147,283660,Yes
BMIT,Information Science and Engineering,KCET,2023,78842,69756,13041,27624,189263,161639,Yes
KLEIT,Biotechnology,COMEDK,2023,172622,90098,14861,21379,298960,277581,No
KSIT,Aerospace Engineering,COMEDK,2023,173518,67236,19323,24103,284180,260077,No
CMRIT,Artificial Intelligence and Data Science,KCET,2023,54440,85804,19026,13382,172652,159270,No
VSM,Biotechnology,COMEDK,2023,236204,73836,14886,28626,353552,324926,Yes
AECMandya,Electronics and Communication Engineering,COMEDK,2023,171446,79326,11363,19739,281874,262135,Yes
PESU,Chemical Engineering,KCET,2023,72190,62196,8315,12361,155062,142701,Yes
SITM,Artificial Intelligence and Data Science,COMEDK,2023,174424,80485,10456,13512,278877,265365,No
AITM,Mechanical Engineering,KCET,2024,54332,76092,17142,14327,161893,147566,No
JIT,Civil Engineering,KCET,2024,68733,81376,15661,16589,182359,165770,No
RNSIT,Computer Science and Engineering,KCET,2023,70510,70375,18477,22408,181770,159362,Yes
DrAIT,Data Science,COMEDK,2024,215068,89394,11952,29958,346372,316414,Yes
KLEIT,Electrical and Electronics Engineering,COMEDK,2023,206819,83266,10905,20029,321019,300990,No
BITM,Civil Engineering,KCET,2023,58828,84076,10674,14492,168070,153578,No
AITM,Artificial Intelligence and Data Science,KCET,2023,77970,89851,8523,29009,205353,176344,No
NMIT,Artificial Intelligence and Data Science,COMEDK,2024,188521,92094,19866,20955,321436,300481,Yes
BIT,Chemical Engineering,COMEDK,2024,209098,74599,14917,13894,312508,298614,Yes
JSSSTU,Electrical and Electronics Engineering,KCET,2023,73603,75830,13447,17537,180417,162880,No
AEC,Information Science and Engineering,COMEDK,2023,198118,72822,17985,24709,313634,288925,Yes
HKBK,Information Science and Engineering,COMEDK,2024,166468,68479,16091,15176,266214,251038,No
AEC,Civil Engineering,COMEDK,2023,244395,81498,15719,15585,357197,341612,No
ACU,Computer Science and Engineering,KCET,2024,55781,69374,17493,24663,167311,142648,No
SJBCE,Electronics and Communication Engineering,COMEDK,2023,207682,72530,10011,25380,315603,290223,No
BMIT,Civil Engineering,KCET,2023,71030,75518,18368,14736,179652,164916,Yes
MVJCE,Civil Engineering,COMEDK,2024,241834,81385,14190,29983,367392,337409,No
BITM,Robotics and Automation Engineering,COMEDK,2024,170288,75194,12741,17522,275745,258223,Yes
PESCE,Artificial Intelligence and Data Science,COMEDK,2024,222350,68068,10674,13503,314595,301092,No
AEC,Information Science and Engineering,COMEDK,2023,219036,62428,12082,15277,308823,293546,Yes
VVIT,Aerospace Engineering,COMEDK,2023,195764,61598,18231,17838,293431,275593,No
GIT,Robotics and Automation Engineering,COMEDK,2023,230587,76396,18062,20154,345199,325045,Yes
DSATM,Electronics and Communication Engineering,KCET,2023,54385,65302,16880,21063,157630,136567,Yes
AITM,Electronics and Communication Engineering,KCET,2024,53614,73861,19635,26863,173973,147110,Yes
SCEM,Information Science and Engineering,KCET,2023,80544,69680,16795,11526,178545,167019,Yes
VVIT,Electronics and Communication Engineering,KCET,2024,78197,70781,16488,25606,191072,165466,No
BMSIT,Computer Science and Engineering,COMEDK,2024,210879,93102,16303,29828,350112,320284,No
RNSIT,Electrical and Electronics Engineering,COMEDK,2023,243059,75164,13665,13227,345115,331888,No
NCET,Information Science and Engineering,KCET,2023,82647,87690,16059,14203,200599,186396,No
KSIT,Robotics and Automation Engineering,KCET,2023,82375,65026,17419,16536,181356,164820,Yes
VVIT,Civil Engineering,COMEDK,2024,246935,80620,11136,14331,353022,338691,Yes
ACU,Chemical Engineering,KCET,2023,82779,89037,9644,28162,209622,181460,No
REVA,Robotics and Automation Engineering,KCET,2023,61171,79108,13164,21459,174902,153443,No
RVCE,Civil Engineering,COMEDK,2023,233025,82048,13657,29943,358673,328730,No
NCET,Computer Science and Engineering,KCET,2024,78768,75707,12469,22577,189521,166944,Yes
SDMCET,Robotics and Automation Engineering,KCET,2023,51350,63016,17884,11531,143781,132250,No
MSRIT,Robotics and Automation Engineering,COMEDK,2024,229681,92605,19432,27034,368752,341718,Yes
JNNCE,Aerospace Engineering,COMEDK,2023,168233,85447,12348,14462,280490,266028,Yes
BMSCE,Civil Engineering,COMEDK,2024,196113,85512,18771,21016,321412,300396,Yes
YKCE,Computer Science and Engineering,KCET,2023,68612,63440,15174,28894,176120,147226,No
SITM,Artificial Intelligence and Data Science,COMEDK,2024,190543,78768,12939,12801,295051,282250,Yes
RVUNIV,Data Science,COMEDK,2024,165231,89698,14889,29142,298960,269818,No
VemanaIT,Artificial Intelligence and Data Science,COMEDK,2024,232433,88485,18968,19183,359069,339886,No
SJBCE,Mechanical Engineering,KCET,2024,55857,68551,9338,23103,156849,133746,Yes
DrAIT,Electronics and Communication Engineering,COMEDK,2024,195467,84631,12363,26799,319260,292461,Yes
PESU,Mechanical Engineering,COMEDK,2024,240427,79294,11473,26464,357658,331194,Yes
BITM,Aerospace Engineering,COMEDK,2023,175777,87076,8570,29132,300555,271423,Yes
AECMandya,Mechanical Engineering,COMEDK,2023,243686,92985,17451,12714,366836,354122,No
VVCE,Mechanical Engineering,KCET,2024,83919,78845,13669,19877,196310,176433,Yes
NCET,Information Science and Engineering,KCET,2023,50795,86127,18967,15588,171477,155889,Yes
EastPoint,Computer Science and Engineering,COMEDK,2023,164134,66159,16747,10135,257175,247040,Yes
NCET,Computer Science and Engineering,KCET,2024,71362,80314,15166,26034,192876,166842,Yes
JSSSTU,Aerospace Engineering,COMEDK,2024,161648,78061,16137,25957,281803,255846,No
BIT,Data Science,COMEDK,2023,197626,85919,10462,27962,321969,294007,No
VVIT,Aerospace Engineering,KCET,2024,57657,94442,14447,13587,180133,166546,Yes
JSSSTU,Artificial Intelligence and Data Science,KCET,2024,55005,70257,19587,11632,156481,144849,No
VIT,Mechanical Engineering,COMEDK,2023,187291,71826,15770,25013,299900,274887,No
CITGubbi,Mechanical Engineering,KCET,2024,82734,61038,8233,27508,179513,152005,No
CITGubbi,Chemical Engineering,COMEDK,2024,202065,86652,19918,19612,328247,308635,No
GIT,Electronics and Communication Engineering,KCET,2023,55809,80588,17303,19578,173278,153700,Yes
VSM,Electrical and Electronics Engineering,KCET,2023,65744,84859,17957,17265,185825,168560,Yes
GIT,Mechanical Engineering,COMEDK,2023,220610,88202,12822,29452,351086,321634,No
SDMCET,Chemical Engineering,COMEDK,2023,171954,72572,12724,14973,272223,257250,Yes
DSATM,Robotics and Automation Engineering,COMEDK,2024,235952,71839,12520,27972,348283,320311,No
HKBK,Artificial Intelligence and Data Science,COMEDK,2023,170470,79826,10544,24433,285273,260840,No
NMIT,Computer Science and Engineering,COMEDK,2023,244221,61370,15557,20171,341319,321148,Yes
HKBK,Mechanical Engineering,KCET,2024,62668,79690,9676,18122,170156,152034,Yes
PRES,Artificial Intelligence and Data Science,COMEDK,2024,245887,93160,18822,14640,372509,357869,Yes
YKCE,Artificial Intelligence and Data Science,KCET,2023,51885,61005,16059,23915,152864,128949,Yes
VSM,Robotics and Automation Engineering,KCET,2023,55483,73508,11589,22447,163027,140580,No
HKBK,Mechanical Engineering,COMEDK,2024,194530,90098,12870,27522,325020,297498,No
BNMIT,Electronics and Communication Engineering,KCET,2023,80168,76994,19458,16807,193427,176620,Yes
SDMCET,Robotics and Automation Engineering,KCET,2023,80089,70677,14512,22628,187906,165278,No
VVCE,Civil Engineering,KCET,2023,77781,91992,8393,23138,201304,178166,Yes
RAIT,Electrical and Electronics Engineering,COMEDK,2023,217943,78333,18870,10741,325887,315146,Yes
VIT,Mechanical Engineering,COMEDK,2024,178594,74305,19105,18225,290229,272004,Yes
NHCE,Information Science and Engineering,COMEDK,2024,248001,73436,16421,15758,353616,337858,No
SITM,Aerospace Engineering,KCET,2024,50399,87274,9971,22851,170495,147644,No
GMIT,Chemical Engineering,COMEDK,2023,204708,88758,19371,18796,331633,312837,No
KLSGIT,Civil Engineering,COMEDK,2024,229216,77743,9573,20449,336981,316532,No
ACU,Biotechnology,COMEDK,2023,226196,74083,8132,13682,322093,308411,No
MSRUAS,Data Science,COMEDK,2023,174512,89336,13938,27331,305117,277786,Yes
MVJCE,Computer Science and Engineering,COMEDK,2023,174468,84389,14385,14685,287927,273242,Yes
SDMIT,Civil Engineering,KCET,2024,70873,68370,19491,15710,174444,158734,No
BMIT,Mechanical Engineering,KCET,2024,53805,71754,10742,15718,152019,136301,No
KSIT,Chemical Engineering,COMEDK,2024,231307,69346,11076,25018,336747,311729,Yes
KLEIT,Computer Science and Engineering,COMEDK,2023,165756,64184,12745,10010,252695,242685,Yes
SCEM,Chemical Engineering,KCET,2023,67405,91229,14914,10237,183785,173548,Yes
YKCE,Civil Engineering,COMEDK,2024,219280,72288,19749,22864,334181,311317,Yes
RVUNIV,Robotics and Automation Engineering,KCET,2024,75113,85940,19837,16895,197785,180890,Yes
KSIT,Chemical Engineering,COMEDK,2023,185731,62619,16930,27696,292976,265280,No
PRES,Computer Science and Engineering,KCET,2024,82571,75730,9728,27293,195322,168029,No
YKCE,Biotechnology,COMEDK,2023,168938,88535,12234,24961,294668,269707,Yes
BMSIT,Robotics and Automation Engineering,KCET,2023,65243,80160,9557,20930,175890,154960,Yes
MSRUAS,Artificial Intelligence and Data Science,COMEDK,2023,184625,92720,12551,19140,309036,289896,No
PESCE,Artificial Intelligence and Data Science,COMEDK,2024,213692,86184,12562,18683,331121,312438,Yes
REVA,Chemical Engineering,COMEDK,2023,218139,65834,12663,21679,318315,296636,Yes
GIT,Biotechnology,KCET,2024,73226,80291,10776,24409,188702,164293,Yes
NHCE,Biotechnology,COMEDK,2024,240486,70967,13860,24174,349487,325313,Yes
AECMandya,Biotechnology,KCET,2023,67900,91201,17097,29292,205490,176198,No
RVUNIV,Chemical Engineering,KCET,2023,81832,69850,8747,17259,177688,160429,Yes
SDMCET,Computer Science and Engineering,COMEDK,2023,231558,64163,13354,15170,324245,309075,No
SDMIT,Artificial Intelligence and Data Science,COMEDK,2024,225034,78544,9009,12099,324686,312587,Yes
PRES,Biotechnology,COMEDK,2023,222960,66963,17135,20718,327776,307058,Yes
NIE,Chemical Engineering,KCET,2023,81224,84661,13789,29006,208680,179674,No
RIT,Mechanical Engineering,COMEDK,2023,200891,70498,16826,26616,314831,288215,Yes
RVCE,Information Science and Engineering,COMEDK,2024,187893,80996,16207,16756,301852,285096,Yes
RVCE,Computer Science and Engineering,KCET,2024,64102,82414,17493,19072,183081,164009,No
JIT,Civil Engineering,COMEDK,2023,235968,92188,12993,18086,359235,341149,Yes
BIT,Artificial Intelligence and Data Science,COMEDK,2024,211337,81853,8480,21063,322733,301670,No
VVIT,Chemical Engineering,COMEDK,2023,205668,75689,15018,14506,310881,296375,No
MVJCE,Electronics and Communication Engineering,KCET,2023,64789,87260,18545,24926,195520,170594,No
KLSGIT,Civil Engineering,COMEDK,2023,217525,92348,17269,18793,345935,327142,No
EastPoint,Electrical and Electronics Engineering,KCET,2023,67413,91198,17604,25396,201611,176215,Yes
RIT,Artificial Intelligence and Data Science,COMEDK,2024,162472,92228,16486,14836,286022,271186,Yes
KLSGIT,Civil Engineering,COMEDK,2023,202121,91052,13457,17494,324124,306630,No
BNMIT,Electronics and Communication Engineering,COMEDK,2023,188462,88261,17070,17999,311792,293793,No
YKCE,Data Science,KCET,2023,75368,60181,9632,21070,166251,145181,Yes
AEC,Civil Engineering,COMEDK,2024,169705,64612,8460,27861,270638,242777,Yes
NCET,Data Science,KCET,2024,68476,84423,13508,24410,190817,166407,No
EastPoint,Electrical and Electronics Engineering,COMEDK,2024,161981,60697,9347,10684,242709,232025,Yes
KSIT,Mechanical Engineering,COMEDK,2024,176116,60395,10715,23791,271017,247226,No
GIT,Artificial Intelligence and Data Science,COMEDK,2024,227328,69828,17097,12547,326800,314253,Yes
NIE,Civil Engineering,KCET,2024,53833,86976,16507,25140,182456,157316,No
BMSIT,Information Science and Engineering,COMEDK,2024,230684,88766,18753,13651,351854,338203,No
SCEM,Civil Engineering,KCET,2023,74698,76442,9475,27624,188239,160615,No
BMSCE,Artificial Intelligence and Data Science,COMEDK,2024,239723,68273,10743,12006,330745,318739,No
DBIT,Chemical Engineering,COMEDK,2024,210754,85028,19602,19406,334790,315384,Yes
YKCE,Electrical and Electronics Engineering,COMEDK,2024,237058,91969,11903,21846,362776,340930,No
VVIT,Robotics and Automation Engineering,KCET,2023,79683,72179,16596,28159,196617,168458,No
PESU,Chemical Engineering,KCET,2023,73586,68774,11429,11653,165442,153789,No
HKBK,Aerospace Engineering,KCET,2024,73440,93236,8216,17285,192177,174892,Yes
KSIT,Aerospace Engineering,KCET,2024,50411,73420,19442,23579,166852,143273,Yes
AITM,Robotics and Automation Engineering,KCET,2024,51548,84489,17524,15311,168872,153561,Yes
RAIT,Artificial Intelligence and Data Science,KCET,2024,83370,93975,16772,12818,206935,194117,No
BMSCE,Civil Engineering,COMEDK,2023,239027,68296,8473,24727,340523,315796,Yes
BITM,Information Science and Engineering,KCET,2024,55237,68969,10836,14620,149662,135042,Yes
RVUNIV,Information Science and Engineering,KCET,2023,72625,80479,16589,27100,196793,169693,Yes
MVJCE,Information Science and Engineering,KCET,2023,63330,68715,12117,14932,159094,144162,No
HKBK,Civil Engineering,KCET,2024,66505,78542,13609,10150,168806,158656,Yes
SDMIT,Information Science and Engineering,KCET,2024,58092,80000,14476,27889,180457,152568,Yes
MSRIT,Computer Science and Engineering,KCET,2024,83994,62894,14828,26607,188323,161716,Yes
BNMIT,Data Science,KCET,2024,62286,70759,8991,13287,155323,142036,Yes
MSRIT,Mechanical Engineering,KCET,2023,58725,64961,17613,11075,152374,141299,No
SDMCET,Civil Engineering,COMEDK,2023,231467,67291,11103,15727,325588,309861,No
NMIT,Information Science and Engineering,KCET,2024,77137,64987,11342,12320,165786,153466,Yes
CITGubbi,Electrical and Electronics Engineering,KCET,2024,56332,86456,8004,28031,178823,150792,Yes
MSRIT,Biotechnology,KCET,2024,60557,89465,16307,10385,176714,166329,Yes
NHCE,Civil Engineering,KCET,2023,51544,86496,10573,15127,163740,148613,Yes
SDMIT,Biotechnology,COMEDK,2024,200526,71478,16269,10215,298488,288273,No
MSRIT,Robotics and Automation Engineering,KCET,2023,75087,78913,17653,22484,194137,171653,Yes
MSRUAS,Aerospace Engineering,COMEDK,2024,167740,93753,9742,16068,287303,271235,Yes
PRES,Artificial Intelligence and Data Science,COMEDK,2024,229166,60858,19869,17228,327121,309893,Yes
BITM,Aerospace Engineering,KCET,2024,68629,78117,15907,11216,173869,162653,Yes
KSIT,Electronics and Communication Engineering,KCET,2024,63605,61894,9601,22562,157662,135100,No
VemanaIT,Robotics and Automation Engineering,COMEDK,2024,204268,94788,19039,29926,348021,318095,Yes
DBIT,Chemical Engineering,COMEDK,2023,177148,65956,8397,29450,280951,251501,No
GMIT,Electronics and Communication Engineering,KCET,2024,80805,81579,19707,13563,195654,182091,No
AEC,Computer Science and Engineering,KCET,2023,61564,65131,12390,27120,166205,139085,No
BMSCE,Aerospace Engineering,KCET,2023,65641,63431,14917,13872,157861,143989,Yes
SIT,Artificial Intelligence and Data Science,COMEDK,2023,247279,62700,10554,18583,339116,320533,No
SITM,Robotics and Automation Engineering,KCET,2023,72654,65429,15909,18385,172377,153992,No
SDMCET,Aerospace Engineering,KCET,2023,57669,86517,14362,11960,170508,158548,No
UVCE,Data Science,COMEDK,2023,212779,72206,17999,14980,317964,302984,No
PESU,Civil Engineering,KCET,2023,61091,65295,13858,15358,155602,140244,Yes
PESCE,Mechanical Engineering,KCET,2023,62130,85614,14608,28323,190675,162352,Yes
VVIT,Mechanical Engineering,COMEDK,2024,191261,64645,15093,15483,286482,270999,No
MSRIT,Computer Science and Engineering,COMEDK,2024,163606,94660,9506,29366,297138,267772,No
DSATM,Chemical Engineering,KCET,2024,76853,82719,11651,14381,185604,171223,Yes
MVJCE,Electrical and Electronics Engineering,KCET,2023,67817,74865,15604,16381,174667,158286,No
KLEIT,Data Science,KCET,2024,80595,81751,11853,10857,185056,174199,No
AECMandya,Mechanical Engineering,KCET,2024,57518,83013,14730,28929,184190,155261,Yes
CMRIT,Civil Engineering,COMEDK,2024,192709,66576,18060,29659,307004,277345,Yes
RNSIT,Aerospace Engineering,COMEDK,2023,173504,73220,17059,11761,275544,263783,No
PESU,Civil Engineering,COMEDK,2023,170211,73315,19634,21076,284236,263160,No
EastPoint,Artificial Intelligence and Data Science,KCET,2023,54893,78879,18725,20207,172704,152497,No
NCET,Civil Engineering,COMEDK,2024,187820,69886,17316,20714,295736,275022,Yes
DBIT,Electronics and Communication Engineering,KCET,2024,72290,88578,11888,15233,187989,172756,No
PESCE,Information Science and Engineering,KCET,2023,64752,60107,12205,12416,149480,137064,Yes
BMIT,Electrical and Electronics Engineering,KCET,2024,53135,88924,11716,27334,181109,153775,Yes
SITM,Mechanical Engineering,KCET,2024,53162,60890,19322,14224,147598,133374,Yes
VSM,Data Science,COMEDK,2024,241089,86203,17885,28332,373509,345177,No
HKBK,Chemical Engineering,COMEDK,2023,194393,84957,14509,14028,307887,293859,No
AECMandya,Electrical and Electronics Engineering,KCET,2024,53570,88375,17322,15322,174589,159267,No
EastPoint,Robotics and Automation Engineering,KCET,2023,52170,94301,15750,21636,183857,162221,Yes
ACU,Electrical and Electronics Engineering,KCET,2023,74493,65768,15679,16850,172790,155940,Yes
SDMCET,Artificial Intelligence and Data Science,KCET,2023,80054,77491,12322,17558,187425,169867,Yes
KLSGIT,Aerospace Engineering,COMEDK,2023,164094,65029,9953,19269,258345,239076,No
DSATM,Chemical Engineering,KCET,2024,66716,82389,9169,21426,179700,158274,No
AITM,Information Science and Engineering,COMEDK,2023,167449,79396,17503,11814,276162,264348,Yes
BITM,Biotechnology,COMEDK,2023,232571,62866,10883,10806,317126,306320,Yes
REVA,Information Science and Engineering,COMEDK,2024,225854,82936,12831,21496,343117,321621,No
VVIT,Information Science and Engineering,KCET,2023,60794,77734,10399,25549,174476,148927,Yes
NHCE,Electrical and Electronics Engineering,KCET,2023,72845,94269,12352,26356,205822,179466,Yes
SDMCET,Artificial Intelligence and Data Science,COMEDK,2024,237952,67634,9894,17105,332585,315480,No
HKBK,Computer Science and Engineering,KCET,2024,71082,69640,10931,20322,171975,151653,No
PESU,Computer Science and Engineering,KCET,2023,67529,75949,15990,14816,174284,159468,No
DrAIT,Computer Science and Engineering,COMEDK,2023,167883,89229,8742,19473,285327,265854,No
RNSIT,Robotics and Automation Engineering,KCET,2024,82126,84307,16111,19283,201827,182544,Yes
RVUNIV,Robotics and Automation Engineering,COMEDK,2024,243792,73657,18599,16560,352608,336048,Yes
JIT,Electronics and Communication Engineering,KCET,2024,51814,88282,8733,21881,170710,148829,Yes
VVCE,Aerospace Engineering,COMEDK,2024,215207,76364,10718,10336,312625,302289,Yes
ACU,Aerospace Engineering,COMEDK,2023,244260,75564,8701,18064,346589,328525,No
SJBCE,Data Science,KCET,2023,80234,73666,18251,28127,200278,172151,Yes
DBIT,Electrical and Electronics Engineering,KCET,2024,73266,85289,19167,11903,189625,177722,No
VemanaIT,Biotechnology,KCET,2024,67139,72481,10960,23137,173717,150580,No
PESU,Biotechnology,KCET,2024,76330,62767,14801,22524,176422,153898,No
AECMandya,Robotics and Automation Engineering,KCET,2023,61588,90552,14035,23920,190095,166175,No
RVUNIV,Computer Science and Engineering,KCET,2023,60575,86320,17556,22532,186983,164451,No
NMIT,Information Science and Engineering,KCET,2023,77327,66626,16098,10244,170295,160051,Yes
VIT,Computer Science and Engineering,KCET,2024,58443,94483,18929,16723,188578,171855,No
NIE,Biotechnology,COMEDK,2023,178335,72081,13682,19590,283688,264098,Yes
BIT,Artificial Intelligence and Data Science,COMEDK,2023,169783,77714,19895,28570,295962,267392,No
MSRIT,Information Science and Engineering,COMEDK,2024,195398,90502,8219,12545,306664,294119,Yes
AITM,Artificial Intelligence and Data Science,KCET,2024,80922,64188,8265,14932,168307,153375,No
PESU,Biotechnology,COMEDK,2024,169541,90323,12802,27581,300247,272666,No
KLSGIT,Civil Engineering,KCET,2024,77739,71525,14523,15865,179652,163787,Yes
DBIT,Electronics and Communication Engineering,COMEDK,2024,178312,74010,9662,29187,291171,261984,No
DSATM,Electronics and Communication Engineering,COMEDK,2024,189059,62221,8125,15537,274942,259405,No
JSSSTU,Data Science,KCET,2023,70362,63731,10217,27971,172281,144310,No
DBIT,Chemical Engineering,KCET,2024,56120,67473,12946,13350,149889,136539,No
NMIT,Electronics and Communication Engineering,COMEDK,2023,211946,76528,10095,21174,319743,298569,Yes
UVCE,Electronics and Communication Engineering,KCET,2024,79821,89290,17823,17499,204433,186934,Yes
MSRUAS,Mechanical Engineering,COMEDK,2024,196891,74740,15192,28986,315809,286823,No
AIT,Aerospace Engineering,COMEDK,2024,244179,77742,11899,10683,344503,333820,No
KLSGIT,Artificial Intelligence and Data Science,COMEDK,2023,249922,72894,8313,29072,360201,331129,Yes
GIT,Artificial Intelligence and Data Science,KCET,2023,68401,91506,15690,14705,190302,175597,No
KLSGIT,Aerospace Engineering,COMEDK,2024,246477,91535,16843,17606,372461,354855,Yes
VVIT,Electronics and Communication Engineering,KCET,2024,68892,69109,8132,17199,163332,146133,No
RAIT,Robotics and Automation Engineering,COMEDK,2023,230902,71604,14289,11275,328070,316795,No
CITGubbi,Computer Science and Engineering,COMEDK,2023,203981,63319,16586,17636,301522,283886,Yes
MVJCE,Robotics and Automation Engineering,KCET,2023,66713,64396,12640,20468,164217,143749,No
BMSCE,Robotics and Automation Engineering,KCET,2023,72531,94281,14746,27296,208854,181558,No
AIT,Artificial Intelligence and Data Science,KCET,2023,81038,69582,19272,19886,189778,169892,No
VemanaIT,Computer Science and Engineering,COMEDK,2024,173916,82163,16537,24019,296635,272616,No
AITM,Aerospace Engineering,KCET,2024,51127,77856,18020,11110,158113,147003,No
AECMandya,Aerospace Engineering,COMEDK,2023,197475,60669,8317,22013,288474,266461,No
NCET,Artificial Intelligence and Data Science,COMEDK,2023,183394,88425,12711,15692,300222,284530,Yes
GIT,Aerospace Engineering,COMEDK,2024,180053,65450,10665,21609,277777,256168,No
SJBCE,Information Science and Engineering,KCET,2023,74723,69004,9160,11656,164543,152887,Yes
DSATM,Artificial Intelligence and Data Science,KCET,2023,74505,68069,17845,12820,173239,160419,No
GMIT,Electronics and Communication Engineering,KCET,2023,53721,79510,11856,17649,162736,145087,Yes
RIT,Electrical and Electronics Engineering,KCET,2024,82963,85578,18072,12263,198876,186613,Yes
BNMIT,Data Science,COMEDK,2023,185471,89134,10211,12366,297182,284816,Yes
AECMandya,Information Science and Engineering,KCET,2024,62666,70708,18963,13608,165945,152337,Yes
RVUNIV,Electrical and Electronics Engineering,COMEDK,2023,214523,70972,9203,20973,315671,294698,Yes
SJBIT,Artificial Intelligence and Data Science,KCET,2023,71327,66315,13424,15246,166312,151066,No
UVCE,Information Science and Engineering,KCET,2023,84506,88937,15252,26335,215030,188695,No
HKBK,Aerospace Engineering,KCET,2023,73853,67012,9288,27879,178032,150153,Yes
SJBIT,Computer Science and Engineering,KCET,2024,60310,66510,12024,25072,163916,138844,No
AIT,Chemical Engineering,KCET,2023,57658,63129,9234,24143,154164,130021,No
KLSGIT,Artificial Intelligence and Data Science,COMEDK,2023,161576,88416,9039,28120,287151,259031,No
MSRIT,Chemical Engineering,KCET,2024,54700,79723,15264,10868,160555,149687,Yes
NCET,Aerospace Engineering,KCET,2023,75094,64984,15731,22235,178044,155809,Yes
HKBK,Biotechnology,KCET,2024,67690,65213,10879,28922,172704,143782,Yes
GIT,Aerospace Engineering,COMEDK,2024,189622,93770,10112,24315,317819,293504,No
DSATM,Electronics and Communication Engineering,KCET,2024,56962,92470,18267,11616,179315,167699,No
KLEIT,Data Science,COMEDK,2023,211752,74207,17313,24399,327671,303272,Yes
JNNCE,Mechanical Engineering,COMEDK,2024,167913,92846,8007,29901,298667,268766,No
NHCE,Electronics and Communication Engineering,COMEDK,2023,172246,64904,12982,18526,268658,250132,No
GIT,Data Science,KCET,2024,59241,75309,14571,13404,162525,149121,No
NIE,Information Science and Engineering,COMEDK,2023,180012,91323,15067,12771,299173,286402,No
DSCE,Mechanical Engineering,COMEDK,2023,220678,88666,17254,11855,338453,326598,No
DrAIT,Mechanical Engineering,KCET,2023,73557,89321,8177,25616,196671,171055,No
VIT,Chemical Engineering,COMEDK,2024,249318,69498,14138,10989,343943,332954,No
ACU,Mechanical Engineering,KCET,2023,76053,77978,17975,26315,198321,172006,No
NIE,Aerospace Engineering,KCET,2023,75884,70364,10053,11308,167609,156301,No
BMSCE,Civil Engineering,COMEDK,2023,190633,61320,9786,27262,289001,261739,No
AIT,Electrical and Electronics Engineering,COMEDK,2024,239825,77917,10515,24355,352612,328257,Yes
SDMIT,Artificial Intelligence and Data Science,KCET,2023,69662,86352,10065,29953,196032,166079,Yes
SCEM,Civil Engineering,KCET,2024,80122,86201,19878,25953,212154,186201,Yes
VVCE,Robotics and Automation Engineering,KCET,2024,59644,80985,17472,28179,186280,158101,No
SJBCE,Civil Engineering,KCET,2023,79816,66290,12346,24194,182646,158452,Yes
JIT,Aerospace Engineering,KCET,2024,54081,69246,8525,19451,151303,131852,Yes
REVA,Mechanical Engineering,KCET,2024,62289,64000,13173,12117,151579,139462,No
KLEIT,Electrical and Electronics Engineering,COMEDK,2023,239710,86363,9451,13574,349098,335524,No
EastPoint,Artificial Intelligence and Data Science,COMEDK,2023,234986,79718,10413,14166,339283,325117,No
KSIT,Mechanical Engineering,COMEDK,2023,185783,86415,14373,15367,301938,286571,Yes
VemanaIT,Robotics and Automation Engineering,COMEDK,2023,189452,89707,17126,10473,306758,296285,Yes
MVJCE,Information Science and Engineering,KCET,2023,63856,66015,10717,19959,160547,140588,Yes
RVCE,Chemical Engineering,KCET,2024,81945,92268,18124,14233,206570,192337,Yes
CITGubbi,Artificial Intelligence and Data Science,COMEDK,2024,235140,81868,14089,22125,353222,331097,No
VemanaIT,Chemical Engineering,COMEDK,2024,160483,80811,12493,14792,268579,253787,Yes
SDMCET,Electronics and Communication Engineering,KCET,2023,59244,80186,15591,22250,177271,155021,Yes
PESCE,Information Science and Engineering,KCET,2023,50044,79938,15717,18571,164270,145699,No
VIT,Electronics and Communication Engineering,KCET,2023,57252,90240,16771,28585,192848,164263,Yes
RIT,Electrical and Electronics Engineering,KCET,2024,71593,75374,15595,20916,183478,162562,Yes
AIT,Artificial Intelligence and Data Science,COMEDK,2023,193273,92521,18178,19760,323732,303972,Yes
NHCE,Electrical and Electronics Engineering,COMEDK,2023,202452,61189,10457,29620,303718,274098,No
RAIT,Chemical Engineering,KCET,2024,74164,62841,11186,11511,159702,148191,No
SJBIT,Computer Science and Engineering,COMEDK,2023,218135,67891,18307,24156,328489,304333,No
SDMIT,Information Science and Engineering,COMEDK,2023,238599,63687,9541,19881,331708,311827,Yes
KLEIT,Civil Engineering,COMEDK,2023,216975,84763,19578,24268,345584,321316,No
NMIT,Mechanical Engineering,COMEDK,2024,187659,78534,19494,14923,300610,285687,No
SCEM,Computer Science and Engineering,KCET,2024,72497,74178,15488,25366,187529,162163,No
DSCE,Robotics and Automation Engineering,COMEDK,2023,224247,75199,13413,21849,334708,312859,Yes
UVCE,Robotics and Automation Engineering,COMEDK,2024,175312,63157,14448,10623,263540,252917,No
KSIT,Computer Science and Engineering,COMEDK,2024,174059,73803,10210,25427,283499,258072,Yes
YKCE,Mechanical Engineering,KCET,2023,50357,94854,8260,29201,182672,153471,No
DSATM,Data Science,COMEDK,2024,191144,89012,8051,24644,312851,288207,Yes
VemanaIT,Aerospace Engineering,COMEDK,2024,215711,92641,10545,28164,347061,318897,No
UVCE,Electronics and Communication Engineering,COMEDK,2024,178083,70714,10515,17604,276916,259312,No
BIT,Aerospace Engineering,COMEDK,2024,203314,65745,15062,27091,311212,284121,No
GMIT,Chemical Engineering,KCET,2024,75959,79289,12225,10827,178300,167473,No
NMIT,Electronics and Communication Engineering,COMEDK,2023,218164,63896,12612,10824,305496,294672,Yes
REVA,Aerospace Engineering,COMEDK,2024,162878,93926,10522,26689,294015,267326,No
VSM,Artificial Intelligence and Data Science,COMEDK,2023,249596,94584,9364,29066,382610,353544,No
MSRIT,Mechanical Engineering,COMEDK,2023,199222,88736,16958,19772,324688,304916,Yes
VVIT,Information Science and Engineering,KCET,2024,76745,75520,9194,11318,172777,161459,No
NMIT,Mechanical Engineering,COMEDK,2024,185101,81768,18524,17205,302598,285393,No
AITM,Mechanical Engineering,KCET,2024,62544,78493,13900,18912,173849,154937,No
YKCE,Electronics and Communication Engineering,COMEDK,2023,230354,71795,16480,18409,337038,318629,Yes
SITM,Biotechnology,COMEDK,2023,182892,92570,13003,19303,307768,288465,No
VSM,Biotechnology,KCET,2023,66169,63701,9103,22267,161240,138973,Yes
JIT,Computer Science and Engineering,KCET,2024,57596,67332,18902,21441,165271,143830,Yes
SJBIT,Biotechnology,COMEDK,2024,169305,72361,18348,22132,282146,260014,No
JSSSTU,Data Science,COMEDK,2023,239163,67136,8451,12035,326785,314750,No
JIT,Biotechnology,KCET,2024,83209,84035,19132,23306,209682,186376,No
SJBIT,Electrical and Electronics Engineering,KCET,2024,69345,82182,10360,15488,177375,161887,No
VVCE,Biotechnology,COMEDK,2024,170446,65360,11924,29304,277034,247730,No
SJBIT,Electrical and Electronics Engineering,KCET,2024,54188,80461,16817,26976,178442,151466,No
RNSIT,Electronics and Communication Engineering,KCET,2023,63100,64331,19631,19170,166232,147062,Yes
RAIT,Computer Science and Engineering,KCET,2023,55025,67936,19826,15327,158114,142787,Yes
NIE,Electrical and Electronics Engineering,KCET,2023,60299,67622,15445,18498,161864,143366,No
JSSSTU,Robotics and Automation Engineering,KCET,2023,60043,78491,12686,13633,164853,151220,No
SCEM,Computer Science and Engineering,KCET,2024,62710,73646,19131,18136,173623,155487,Yes
REVA,Data Science,KCET,2024,57901,80977,15995,21325,176198,154873,No
VVCE,Artificial Intelligence and Data Science,COMEDK,2024,248363,86502,19799,15017,369681,354664,Yes
RVUNIV,Chemical Engineering,COMEDK,2024,171615,80340,17969,12401,282325,269924,Yes
NHCE,Mechanical Engineering,COMEDK,2024,172444,67238,16621,15792,272095,256303,Yes
YKCE,Robotics and Automation Engineering,COMEDK,2024,239962,70794,19656,29171,359583,330412,Yes
SJBIT,Electronics and Communication Engineering,COMEDK,2024,247361,85248,17622,24738,374969,350231,Yes
GMIT,Electronics and Communication Engineering,KCET,2024,65658,76857,11271,27923,181709,153786,Yes
VVIT,Artificial Intelligence and Data Science,COMEDK,2024,181684,93490,9111,27844,312129,284285,No
EastPoint,Mechanical Engineering,KCET,2024,84876,73794,15881,22111,196662,174551,No
VIT,Aerospace Engineering,KCET,2023,67436,84276,19360,17249,188321,171072,No
AITM,Data Science,COMEDK,2024,198698,74855,18893,15645,308091,292446,No
CITGubbi,Mechanical Engineering,KCET,2024,70671,62348,19337,24874,177230,152356,Yes
RAIT,Biotechnology,COMEDK,2024,220112,87338,16690,10573,334713,324140,No
PESCE,Data Science,KCET,2023,74688,73231,12948,17753,178620,160867,Yes
RAIT,Electrical and Electronics Engineering,COMEDK,2023,178860,83377,18413,24245,304895,280650,No
GMIT,Biotechnology,COMEDK,2024,167724,88281,17555,29510,303070,273560,No
JIT,Electronics and Communication Engineering,KCET,2023,73844,82930,14423,14166,185363,171197,No
DBIT,Civil Engineering,KCET,2024,62918,83961,15498,18224,180601,162377,Yes
NIE,Electronics and Communication Engineering,COMEDK,2024,191202,75224,16295,26270,308991,282721,Yes
RIT,Computer Science and Engineering,COMEDK,2024,194149,85141,11145,26316,316751,290435,Yes
VSM,Data Science,KCET,2023,56904,61202,17013,11322,146441,135119,No
MVJCE,Biotechnology,KCET,2023,64112,64385,15227,10989,154713,143724,No
REVA,Robotics and Automation Engineering,COMEDK,2023,170406,65597,16921,14673,267597,252924,Yes
CITGubbi,Civil Engineering,KCET,2023,73639,94320,19334,25393,212686,187293,Yes
DrAIT,Biotechnology,KCET,2023,71055,87561,17624,13942,190182,176240,Yes
BMSIT,Chemical Engineering,COMEDK,2023,232197,68654,13052,24852,338755,313903,Yes
VVCE,Aerospace Engineering,KCET,2023,52206,66810,10236,10149,139401,129252,No
DSCE,Electrical and Electronics Engineering,KCET,2023,63606,61871,19663,26909,172049,145140,Yes
JNNCE,Electronics and Communication Engineering,KCET,2024,67965,71182,19284,23966,182397,158431,No
BITM,Chemical Engineering,COMEDK,2023,181595,92307,16923,25425,316250,290825,Yes
YKCE,Robotics and Automation Engineering,KCET,2023,80831,91612,13298,14450,200191,185741,Yes
NIE,Aerospace Engineering,KCET,2024,51383,60863,17716,23273,153235,129962,No
KLSGIT,Mechanical Engineering,COMEDK,2024,220880,79733,11628,21316,333557,312241,Yes
AIT,Biotechnology,KCET,2023,76532,71200,15881,28792,192405,163613,No
UVCE,Chemical Engineering,COMEDK,2023,210183,81099,19481,12896,323659,310763,No
AIT,Biotechnology,COMEDK,2024,178729,76489,12648,27260,295126,267866,Yes
JNNCE,Data Science,KCET,2024,80604,71382,13814,11050,176850,165800,No
VVCE,Information Science and Engineering,COMEDK,2024,215507,94302,11590,25174,346573,321399,No
VVCE,Chemical Engineering,COMEDK,2024,229235,92508,16188,19760,357691,337931,No
HKBK,Mechanical Engineering,COMEDK,2024,189988,87754,18465,24515,320722,296207,No
SITM,Electronics and Communication Engineering,KCET,2023,76492,82343,11059,21175,191069,169894,Yes
RIT,Computer Science and Engineering,COMEDK,2023,213973,75881,16820,22311,328985,306674,Yes
JIT,Information Science and Engineering,KCET,2023,63292,90647,9239,13298,176476,163178,No
ACU,Artificial Intelligence and Data Science,COMEDK,2024,217567,79154,11201,18628,326550,307922,Yes
MVJCE,Aerospace Engineering,KCET,2023,69808,90935,12843,20410,193996,173586,Yes
BMIT,Robotics and Automation Engineering,KCET,2024,68193,72035,17849,23643,181720,158077,No
MSRUAS,Aerospace Engineering,KCET,2023,80845,67333,8689,11560,168427,156867,Yes
DSCE,Chemical Engineering,COMEDK,2023,231191,62813,9624,22696,326324,303628,No
BIT,Data Science,KCET,2024,83116,75802,14779,14350,188047,173697,Yes
DBIT,Robotics and Automation Engineering,KCET,2024,59230,85333,18950,27137,190650,163513,Yes
DSCE,Artificial Intelligence and Data Science,COMEDK,2024,160937,60512,13693,29649,264791,235142,No
NMIT,Civil Engineering,KCET,2023,75806,67414,8551,13470,165241,151771,No
VVCE,Information Science and Engineering,COMEDK,2023,186059,93783,13830,28696,322368,293672,Yes
SITM,Biotechnology,COMEDK,2024,204261,88091,17752,26007,336111,310104,Yes
SJBCE,Electrical and Electronics Engineering,KCET,2024,57390,80629,16940,28945,183904,154959,Yes
CMRIT,Electronics and Communication Engineering,KCET,2024,66811,90619,16458,19732,193620,173888,No
NIE,Biotechnology,KCET,2023,65589,74713,10870,19412,170584,151172,No
GMIT,Data Science,KCET,2024,67266,86805,16794,28197,199062,170865,No
NMIT,Mechanical Engineering,COMEDK,2023,168773,70263,14086,25837,278959,253122,No
RVCE,Mechanical Engineering,KCET,2023,76966,84863,18017,18777,198623,179846,No
DrAIT,Biotechnology,KCET,2024,65694,63022,9152,24755,162623,137868,No
JSSSTU,Aerospace Engineering,COMEDK,2023,244396,76882,15061,13765,350104,336339,No
MVJCE,Biotechnology,COMEDK,2023,202350,93895,17911,22426,336582,314156,Yes
NMIT,Biotechnology,COMEDK,2024,213838,62331,11715,13735,301619,287884,Yes
SIT,Information Science and Engineering,COMEDK,2024,235596,75367,18991,28128,358082,329954,No
NMIT,Information Science and Engineering,KCET,2024,79782,86582,8124,14170,188658,174488,No
AECMandya,Biotechnology,COMEDK,2023,231510,83531,10610,16387,342038,325651,Yes
KLEIT,Robotics and Automation Engineering,COMEDK,2024,166156,81294,15467,27448,290365,262917,Yes
BITM,Civil Engineering,KCET,2023,61898,60876,16842,27533,167149,139616,No
BMIT,Mechanical Engineering,COMEDK,2024,166855,67511,16683,17460,268509,251049,No
RVUNIV,Robotics and Automation Engineering,COMEDK,2023,203076,94584,10518,20013,328191,308178,Yes
GIT,Chemical Engineering,COMEDK,2023,197468,63643,10453,27995,299559,271564,Yes
ACU,Electronics and Communication Engineering,COMEDK,2023,219674,85408,15568,24677,345327,320650,No
JSSSTU,Artificial Intelligence and Data Science,COMEDK,2024,177505,89230,19361,22806,308902,286096,Yes
MSRUAS,Aerospace Engineering,COMEDK,2023,169229,83941,16361,12131,281662,269531,No
JIT,Information Science and Engineering,COMEDK,2023,240212,93584,16066,21323,371185,349862,Yes
MVJCE,Electrical and Electronics Engineering,KCET,2024,54159,93911,18168,29214,195452,166238,No
AEC,Civil Engineering,COMEDK,2023,227157,84958,14296,17569,343980,326411,No
VVCE,Chemical Engineering,KCET,2023,72424,61878,10851,20766,165919,145153,No
UVCE,Artificial Intelligence and Data Science,KCET,2023,84447,92952,11054,17714,206167,188453,No
MVJCE,Electrical and Electronics Engineering,COMEDK,2024,209641,80049,17671,28443,335804,307361,No
JSSSTU,Data Science,COMEDK,2023,210262,69760,13653,17775,311450,293675,No
CMRIT,Mechanical Engineering,KCET,2024,75743,94962,13588,19271,203564,184293,Yes
SJBCE,Biotechnology,COMEDK,2023,191741,64653,13233,27460,297087,269627,No
PESCE,Aerospace Engineering,COMEDK,2023,184284,86628,17186,28138,316236,288098,Yes
BITM,Artificial Intelligence and Data Science,KCET,2024,81033,72748,17495,28573,199849,171276,Yes
SITM,Computer Science and Engineering,KCET,2023,65404,60373,8785,21266,155828,134562,Yes
MSRUAS,Aerospace Engineering,KCET,2023,57817,66519,15523,10617,150476,139859,Yes
RVUNIV,Information Science and Engineering,KCET,2023,67276,86458,12215,20584,186533,165949,Yes
VVIT,Civil Engineering,KCET,2024,55755,84072,9660,19011,168498,149487,No
KLSGIT,Electrical and Electronics Engineering,COMEDK,2023,232933,72875,17376,24791,347975,323184,No
JSSSTU,Computer Science and Engineering,KCET,2024,77489,84027,18908,15466,195890,180424,No
BNMIT,Electronics and Communication Engineering,COMEDK,2024,238803,78362,15014,16224,348403,332179,Yes
DBIT,Information Science and Engineering,KCET,2023,71245,78386,16949,13640,180220,166580,No
SJBIT,Aerospace Engineering,KCET,2024,57692,60663,13132,19444,150931,131487,No
DBIT,Robotics and Automation Engineering,KCET,2024,83011,91876,17271,17324,209482,192158,Yes
MVJCE,Robotics and Automation Engineering,KCET,2023,82032,71817,17710,29109,200668,171559,Yes
DrAIT,Data Science,COMEDK,2024,230408,89119,12913,29246,361686,332440,Yes
ACU,Data Science,KCET,2023,61986,62162,17977,18498,160623,142125,Yes
PRES,Electronics and Communication Engineering,KCET,2023,54020,60424,8280,16040,138764,122724,Yes
JIT,Civil Engineering,KCET,2024,77951,60117,15739,11287,165094,153807,Yes
MVJCE,Electronics and Communication Engineering,COMEDK,2023,238785,77493,10336,26585,353199,326614,Yes
YKCE,Civil Engineering,KCET,2023,62687,63438,16445,29127,171697,142570,No
EastPoint,Aerospace Engineering,KCET,2023,58034,92970,16427,17164,184595,167431,No
MVJCE,Electrical and Electronics Engineering,KCET,2024,80090,61249,10366,11017,162722,151705,No
VSM,Robotics and Automation Engineering,KCET,2024,82039,63196,10761,15281,171277,155996,Yes
BNMIT,Artificial Intelligence and Data Science,KCET,2023,56319,68728,14433,11275,150755,139480,Yes
VemanaIT,Aerospace Engineering,COMEDK,2024,178447,78924,9359,10981,277711,266730,Yes
MVJCE,Chemical Engineering,KCET,2023,77158,60263,15102,25209,177732,152523,No
MVJCE,Electronics and Communication Engineering,KCET,2024,81908,75801,13681,26905,198295,171390,No
KSIT,Biotechnology,KCET,2023,73275,66789,17767,16023,173854,157831,Yes
RIT,Electrical and Electronics Engineering,COMEDK,2023,226413,92728,12504,11359,343004,331645,Yes
KLSGIT,Biotechnology,COMEDK,2024,170189,94653,14869,19569,299280,279711,No
SDMCET,Mechanical Engineering,COMEDK,2023,160375,86097,9765,16115,272352,256237,Yes
RIT,Chemical Engineering,COMEDK,2024,212507,67798,10259,16428,306992,290564,No
PESU,Civil Engineering,KCET,2024,69027,77136,18100,10772,175035,164263,Yes
SJBIT,Computer Science and Engineering,COMEDK,2023,163435,64062,17222,11989,256708,244719,No
ACU,Biotechnology,COMEDK,2023,181545,74511,19933,22000,297989,275989,No
VVCE,Chemical Engineering,KCET,2023,68680,69104,8090,24732,170606,145874,Yes
GIT,Information Science and Engineering,KCET,2024,63997,81280,10548,16997,172822,155825,Yes
AIT,Electrical and Electronics Engineering,KCET,2024,51678,86986,14511,12421,165596,153175,Yes
DSATM,Electrical and Electronics Engineering,COMEDK,2024,197387,62352,8015,15640,283394,267754,No
GIT,Electrical and Electronics Engineering,KCET,2024,58404,92172,12927,22933,186436,163503,Yes
RIT,Robotics and Automation Engineering,KCET,2023,77416,92097,12312,16146,197971,181825,No
UVCE,Information Science and Engineering,COMEDK,2024,206359,81439,19907,19498,327203,307705,No
BMSCE,Civil Engineering,COMEDK,2024,160016,76508,18073,28188,282785,254597,Yes
PRES,Electronics and Communication Engineering,COMEDK,2024,195348,87269,14242,21703,318562,296859,Yes
MSRUAS,Mechanical Engineering,KCET,2024,68127,92465,12816,17143,190551,173408,Yes
VVCE,Mechanical Engineering,COMEDK,2023,231255,60287,12069,12926,316537,303611,Yes
RAIT,Computer Science and Engineering,KCET,2024,56892,82258,14947,12262,166359,154097,Yes
MSRIT,Civil Engineering,COMEDK,2023,222019,68770,11823,16503,319115,302612,Yes
AIT,Chemical Engineering,KCET,2024,51385,73695,10197,19829,155106,135277,Yes
NHCE,Electrical and Electronics Engineering,KCET,2023,78603,88600,16951,27390,211544,184154,No
BMSIT,Biotechnology,COMEDK,2024,199718,92653,13728,11327,317426,306099,No
MVJCE,Robotics and Automation Engineering,KCET,2023,57187,92872,12475,24852,187386,162534,Yes
VemanaIT,Information Science and Engineering,KCET,2024,57069,77288,12175,23516,170048,146532,No
SDMCET,Electrical and Electronics Engineering,KCET,2024,76630,62686,16440,23264,179020,155756,Yes
SJBCE,Information Science and Engineering,KCET,2023,64578,91167,12177,10885,178807,167922,Yes
JSSSTU,Computer Science and Engineering,KCET,2024,57161,81549,17565,28944,185219,156275,No
ACU,Information Science and Engineering,KCET,2024,63134,77111,9598,17622,167465,149843,Yes
KLSGIT,Electronics and Communication Engineering,KCET,2023,79330,81632,9012,28370,198344,169974,No
YKCE,Electrical and Electronics Engineering,COMEDK,2023,230332,76480,11082,23033,340927,317894,Yes
RIT,Chemical Engineering,KCET,2024,65876,65576,18559,14498,164509,150011,Yes
AEC,Mechanical Engineering,KCET,2024,60976,84618,9764,14484,169842,155358,No
BNMIT,Electronics and Communication Engineering,COMEDK,2024,229654,93126,16155,20986,359921,338935,No
YKCE,Mechanical Engineering,KCET,2024,68707,82800,18020,16226,185753,169527,No
JSSSTU,Computer Science and Engineering,KCET,2023,74562,81523,16007,10184,182276,172092,No
HKBK,Data Science,KCET,2023,64513,65005,14491,13093,157102,144009,Yes
DBIT,Artificial Intelligence and Data Science,KCET,2023,76615,70326,13876,21394,182211,160817,No
UVCE,Electrical and Electronics Engineering,COMEDK,2024,184250,80323,19540,13099,297212,284113,Yes
VemanaIT,Civil Engineering,KCET,2024,51794,70182,16008,10073,148057,137984,Yes
RVUNIV,Aerospace Engineering,COMEDK,2024,218856,65198,11952,26807,322813,296006,No
PESCE,Computer Science and Engineering,COMEDK,2023,220323,91370,14929,26944,353566,326622,No
DBIT,Chemical Engineering,COMEDK,2024,227548,78621,9390,19351,334910,315559,No
PESU,Aerospace Engineering,COMEDK,2023,183573,89167,11300,22985,307025,284040,Yes
AIT,Biotechnology,KCET,2023,79246,78428,18556,16714,192944,176230,No
DrAIT,Robotics and Automation Engineering,KCET,2023,72220,89450,19523,11241,192434,181193,No
AITM,Chemical Engineering,KCET,2023,61520,81880,13119,29275,185794,156519,No
VVCE,Robotics and Automation Engineering,KCET,2024,61588,67897,8603,26060,164148,138088,No
SCEM,Electrical and Electronics Engineering,COMEDK,2024,242702,66299,9801,17190,335992,318802,No
BIT,Electrical and Electronics Engineering,COMEDK,2024,196842,64276,12200,11661,284979,273318,No
VSM,Data Science,COMEDK,2023,247760,85247,16147,16892,366046,349154,Yes
CITGubbi,Data Science,COMEDK,2024,206802,89630,18027,19595,334054,314459,Yes
HKBK,Computer Science and Engineering,COMEDK,2023,228945,60489,9192,26050,324676,298626,No
HKBK,Aerospace Engineering,KCET,2024,59114,80516,15396,20669,175695,155026,Yes
RNSIT,Robotics and Automation Engineering,COMEDK,2023,231918,89401,10153,13530,345002,331472,No
RIT,Artificial Intelligence and Data Science,COMEDK,2023,234296,82809,12266,26469,355840,329371,No
AECMandya,Civil Engineering,KCET,2024,50531,63400,16232,24997,155160,130163,No
BMIT,Electronics and Communication Engineering,KCET,2024,54738,91601,11448,21143,178930,157787,Yes
ACU,Civil Engineering,COMEDK,2023,176790,66608,17218,15889,276505,260616,No
JNNCE,Artificial Intelligence and Data Science,COMEDK,2023,226747,66326,14612,17464,325149,307685,No
RAIT,Electronics and Communication Engineering,KCET,2024,51770,86341,10059,21237,169407,148170,No
PESCE,Data Science,KCET,2024,63986,83027,10333,21238,178584,157346,Yes
UVCE,Information Science and Engineering,COMEDK,2023,178983,86914,12289,19173,297359,278186,No
AECMandya,Mechanical Engineering,COMEDK,2023,167205,77531,11933,12696,269365,256669,Yes
YKCE,Artificial Intelligence and Data Science,COMEDK,2024,214720,92215,17729,16996,341660,324664,Yes
GIT,Electronics and Communication Engineering,KCET,2023,79016,82019,13338,17556,191929,174373,Yes
MSRIT,Data Science,COMEDK,2023,204243,70542,18570,22831,316186,293355,Yes
UVCE,Biotechnology,COMEDK,2024,179762,93780,17621,26977,318140,291163,Yes
NCET,Electrical and Electronics Engineering,COMEDK,2024,247173,90136,17931,27395,382635,355240,No
CMRIT,Chemical Engineering,KCET,2023,51590,71772,10523,16438,150323,133885,Yes
BMSCE,Biotechnology,KCET,2024,62028,88375,15334,21847,187584,165737,Yes
SIT,Artificial Intelligence and Data Science,COMEDK,2023,195898,66032,15971,11922,289823,277901,Yes
YKCE,Electrical and Electronics Engineering,KCET,2024,82359,61828,15021,19058,178266,159208,Yes
RNSIT,Artificial Intelligence and Data Science,KCET,2024,64520,80465,13709,16293,174987,158694,No
AITM,Data Science,COMEDK,2023,195591,61068,19321,22849,298829,275980,Yes
DSATM,Electrical and Electronics Engineering,KCET,2023,62504,65334,17423,22671,167932,145261,No
SCEM,Computer Science and Engineering,COMEDK,2024,213907,92889,8378,26112,341286,315174,No
YKCE,Biotechnology,KCET,2024,58966,67143,10616,21909,158634,136725,No
MSRIT,Computer Science and Engineering,COMEDK,2023,228916,82144,10446,18990,340496,321506,Yes
BMSIT,Aerospace Engineering,COMEDK,2023,190482,69696,9916,27888,297982,270094,No
GIT,Electronics and Communication Engineering,COMEDK,2023,179844,77048,11966,13816,282674,268858,Yes
SJBCE,Electrical and Electronics Engineering,COMEDK,2024,209095,66782,13764,24134,313775,289641,No
NMIT,Aerospace Engineering,KCET,2024,51691,62116,10069,10445,134321,123876,No
REVA,Electronics and Communication Engineering,COMEDK,2024,198157,72335,10712,20639,301843,281204,Yes
BIT,Biotechnology,KCET,2024,75955,88873,14538,22679,202045,179366,No
AEC,Robotics and Automation Engineering,KCET,2023,73258,84288,17645,26730,201921,175191,Yes
AEC,Data Science,KCET,2024,62684,64782,15756,13294,156516,143222,Yes
REVA,Electrical and Electronics Engineering,KCET,2023,61322,64252,11797,24970,162341,137371,Yes
DBIT,Biotechnology,KCET,2023,65967,79547,17426,29287,192227,162940,No
NCET,Aerospace Engineering,COMEDK,2023,174654,64257,17282,10872,267065,256193,Yes
SDMCET,Mechanical Engineering,COMEDK,2024,248932,70768,14624,21701,356025,334324,No
MSRUAS,Biotechnology,KCET,2023,56376,85072,16851,13232,171531,158299,Yes
AEC,Robotics and Automation Engineering,COMEDK,2023,177084,61780,9074,28452,276390,247938,Yes
VIT,Electronics and Communication Engineering,COMEDK,2024,163466,90906,13893,18813,287078,268265,No
GMIT,Electrical and Electronics Engineering,KCET,2023,51454,72141,10420,25732,159747,134015,Yes
CMRIT,Aerospace Engineering,KCET,2023,82319,71487,9666,24598,188070,163472,No
VVCE,Electronics and Communication Engineering,KCET,2023,77139,65517,15006,29505,187167,157662,No
AITM,Robotics and Automation Engineering,COMEDK,2024,204743,63748,18459,18142,305092,286950,Yes
NCET,Information Science and Engineering,COMEDK,2023,187960,79921,13998,28731,310610,281879,Yes
AEC,Aerospace Engineering,KCET,2023,81953,90943,17894,25750,216540,190790,No
RNSIT,Information Science and Engineering,KCET,2024,50618,66912,12424,26472,156426,129954,Yes
JIT,Aerospace Engineering,KCET,2023,82974,86463,8459,27378,205274,177896,Yes
AITM,Computer Science and Engineering,COMEDK,2023,209911,80773,12605,20994,324283,303289,Yes
RAIT,Data Science,COMEDK,2024,162355,73005,13847,27004,276211,249207,Yes
DrAIT,Data Science,KCET,2023,76330,94917,9211,21404,201862,180458,Yes
VVIT,Robotics and Automation Engineering,COMEDK,2023,246879,72668,8073,18206,345826,327620,Yes
SIT,Aerospace Engineering,KCET,2024,73262,88087,16691,14868,192908,178040,No
AIT,Robotics and Automation Engineering,KCET,2023,58531,85519,17238,12072,173360,161288,No
NMIT,Computer Science and Engineering,KCET,2024,68177,75698,18242,11022,173139,162117,Yes
NIE,Electronics and Communication Engineering,COMEDK,2023,177908,73016,16075,29364,296363,266999,Yes
NHCE,Mechanical Engineering,KCET,2024,78388,76417,17657,22948,195410,172462,Yes
JSSSTU,Aerospace Engineering,KCET,2023,80400,85240,17203,29820,212663,182843,No
AIT,Biotechnology,COMEDK,2023,243000,69789,9312,18233,340334,322101,Yes
NHCE,Electronics and Communication Engineering,KCET,2023,55940,79650,19489,10700,165779,155079,No
BMIT,Robotics and Automation Engineering,KCET,2024,66533,85142,17801,13899,183375,169476,No
MVJCE,Chemical Engineering,KCET,2023,56320,61748,11953,25189,155210,130021,Yes
NIE,Biotechnology,COMEDK,2023,240935,87605,11960,20709,361209,340500,No
REVA,Electrical and Electronics Engineering,COMEDK,2024,216043,63724,11315,25804,316886,291082,Yes
JNNCE,Data Science,KCET,2023,81550,67296,12788,20860,182494,161634,No
DSATM,Biotechnology,COMEDK,2023,208418,64699,17417,23240,313774,290534,No
NIE,Biotechnology,KCET,2024,77190,73549,16832,16490,184061,167571,No
BNMIT,Chemical Engineering,KCET,2023,50279,67775,8282,29679,156015,126336,Yes
BIT,Information Science and Engineering,COMEDK,2023,248126,82431,11172,11810,353539,341729,No
BITM,Mechanical Engineering,KCET,2023,70010,81532,17398,22345,191285,168940,No
SCEM,Biotechnology,KCET,2024,60087,87755,12857,13215,173914,160699,No
MSRIT,Chemical Engineering,KCET,2023,59903,70101,9515,18971,158490,139519,No
UVCE,Electronics and Communication Engineering,COMEDK,2023,203403,77143,15768,15732,312046,296314,No
AECMandya,Electrical and Electronics Engineering,KCET,2023,70878,77451,8862,14966,172157,157191,No
SJBCE,Civil Engineering,KCET,2024,64290,89061,12952,19074,185377,166303,No
MVJCE,Artificial Intelligence and Data Science,KCET,2023,70968,71879,19637,22204,184688,162484,Yes
EastPoint,Data Science,COMEDK,2023,235213,69892,18594,26103,349802,323699,Yes
GMIT,Robotics and Automation Engineering,KCET,2023,65700,82834,19421,10136,178091,167955,Yes
GMIT,Biotechnology,COMEDK,2024,196878,63245,9774,19722,289619,269897,Yes
AEC,Civil Engineering,KCET,2023,50423,89089,12344,28375,180231,151856,Yes
RNSIT,Robotics and Automation Engineering,COMEDK,2024,219095,84658,19216,12545,335514,322969,No
PESCE,Information Science and Engineering,COMEDK,2024,194314,69034,17366,21420,302134,280714,Yes
GIT,Computer Science and Engineering,KCET,2023,50316,73592,12906,23256,160070,136814,No
MVJCE,Information Science and Engineering,KCET,2023,57077,66264,17134,10814,151289,140475,Yes
CMRIT,Robotics and Automation Engineering,COMEDK,2023,244131,94326,15448,22058,375963,353905,Yes
REVA,Computer Science and Engineering,KCET,2023,83720,75240,11112,27814,197886,170072,No
BITM,Biotechnology,COMEDK,2024,190307,84702,19633,20222,314864,294642,Yes
BMSIT,Aerospace Engineering,COMEDK,2023,162623,83900,15039,15766,277328,261562,Yes
AIT,Computer Science and Engineering,COMEDK,2023,240694,91016,17746,16089,365545,349456,Yes
BMSCE,Data Science,KCET,2023,76114,64775,9665,28651,179205,150554,Yes
ACU,Biotechnology,COMEDK,2023,181868,80720,19019,20215,301822,281607,Yes
SITM,Computer Science and Engineering,COMEDK,2024,241525,83939,16055,12184,353703,341519,No
GMIT,Aerospace Engineering,COMEDK,2024,218505,67597,10835,23259,320196,296937,Yes
DSCE,Biotechnology,COMEDK,2023,194223,73631,14728,24702,307284,282582,No
AECMandya,Aerospace Engineering,COMEDK,2024,171593,72123,8419,25855,277990,252135,No
SIT,Information Science and Engineering,KCET,2024,53641,70695,8395,28738,161469,132731,No
RNSIT,Robotics and Automation Engineering,COMEDK,2024,193255,74881,15981,29801,313918,284117,No
BMIT,Electronics and Communication Engineering,KCET,2023,54557,92112,15077,19907,181653,161746,No
GIT,Aerospace Engineering,KCET,2024,81333,62600,9633,13710,167276,153566,Yes
SJBCE,Electrical and Electronics Engineering,COMEDK,2024,172841,94644,17496,25581,310562,284981,Yes
PRES,Aerospace Engineering,KCET,2023,71463,78008,11010,26612,187093,160481,No
AEC,Information Science and Engineering,COMEDK,2024,241141,77403,17563,27365,363472,336107,No
NCET,Robotics and Automation Engineering,COMEDK,2023,160077,76536,14910,20810,272333,251523,No
GIT,Electronics and Communication Engineering,KCET,2023,63047,63435,11267,23333,161082,137749,Yes
GIT,Data Science,COMEDK,2023,184488,86721,15949,21058,308216,287158,No
RIT,Mechanical Engineering,COMEDK,2024,243536,91870,9317,27848,372571,344723,Yes
MSRIT,Data Science,KCET,2024,83266,73187,19668,14494,190615,176121,Yes
JNNCE,Civil Engineering,KCET,2023,78782,62195,8997,17400,167374,149974,No
VIT,Aerospace Engineering,KCET,2023,51416,69564,16191,25680,162851,137171,No
DSATM,Artificial Intelligence and Data Science,COMEDK,2024,249940,71924,16823,14476,353163,338687,No
NMIT,Chemical Engineering,COMEDK,2024,198276,94114,17485,26706,336581,309875,Yes
PESU,Information Science and Engineering,COMEDK,2023,198843,87893,11605,12246,310587,298341,No
JNNCE,Chemical Engineering,KCET,2023,62592,69745,9534,15216,157087,141871,No
RVCE,Electronics and Communication Engineering,COMEDK,2024,246775,77974,18985,10556,354290,343734,Yes
BITM,Biotechnology,KCET,2024,82850,64329,11739,17162,176080,158918,Yes
MVJCE,Computer Science and Engineering,KCET,2023,76386,67467,16007,13957,173817,159860,Yes
JIT,Civil Engineering,KCET,2024,61159,77898,9244,16791,165092,148301,No
SDMCET,Electronics and Communication Engineering,KCET,2023,65890,90744,13374,16289,186297,170008,Yes
VVCE,Mechanical Engineering,KCET,2024,82089,73473,10921,22614,189097,166483,No
DSCE,Aerospace Engineering,KCET,2024,80622,70536,12384,27466,191008,163542,Yes
JSSSTU,Mechanical Engineering,COMEDK,2023,196243,81530,16197,13418,307388,293970,No
MSRIT,Electrical and Electronics Engineering,KCET,2023,69282,69753,9245,23830,172110,148280,No
NIE,Electrical and Electronics Engineering,COMEDK,2023,165941,88907,14183,17435,286466,269031,No
SDMCET,Data Science,COMEDK,2024,204138,66687,14409,21178,306412,285234,No
MSRUAS,Information Science and Engineering,KCET,2024,77072,68499,11652,15055,172278,157223,No
PESU,Information Science and Engineering,COMEDK,2024,211645,84621,15647,19348,331261,311913,Yes
KLSGIT,Robotics and Automation Engineering,KCET,2024,60956,91851,9041,11273,173121,161848,Yes
ACU,Robotics and Automation Engineering,COMEDK,2024,210148,73873,17219,21214,322454,301240,Yes
SDMIT,Information Science and Engineering,COMEDK,2024,199710,83670,19459,27576,330415,302839,Yes
BMSCE,Chemical Engineering,KCET,2024,71399,72513,14057,23329,181298,157969,Yes
BNMIT,Electrical and Electronics Engineering,COMEDK,2023,241325,70728,11230,20389,343672,323283,No
DBIT,Robotics and Automation Engineering,KCET,2024,70832,65249,9688,23565,169334,145769,No
MSRIT,Chemical Engineering,KCET,2023,80319,93366,8179,20520,202384,181864,Yes
NMIT,Artificial Intelligence and Data Science,KCET,2023,55108,81006,12051,20018,168183,148165,Yes
UVCE,Data Science,COMEDK,2023,165361,68539,19562,24733,278195,253462,Yes
AECMandya,Artificial Intelligence and Data Science,KCET,2023,72018,83181,8297,26409,189905,163496,No
DBIT,Chemical Engineering,KCET,2023,60639,60993,17158,12426,151216,138790,Yes
AECMandya,Civil Engineering,COMEDK,2023,210747,84501,14044,21084,330376,309292,No
SIT,Electrical and Electronics Engineering,COMEDK,2023,236168,79118,9771,10951,336008,325057,No
BIT,Aerospace Engineering,KCET,2023,81032,69460,8603,17132,176227,159095,Yes
GIT,Biotechnology,KCET,2023,73897,64566,18747,21634,178844,157210,No
SJBCE,Civil Engineering,COMEDK,2023,208416,80999,19541,10518,319474,308956,No
DSCE,Chemical Engineering,KCET,2024,73761,86217,11613,18226,189817,171591,Yes
REVA,Biotechnology,COMEDK,2024,241131,68175,12347,16382,338035,321653,Yes
BNMIT,Electronics and Communication Engineering,KCET,2023,71778,91242,16838,24857,204715,179858,No
SCEM,Civil Engineering,COMEDK,2023,231472,73134,8094,12251,324951,312700,Yes
AECMandya,Biotechnology,KCET,2023,69112,89063,12764,10011,180950,170939,Yes
MSRIT,Biotechnology,KCET,2024,65293,76268,9011,24857,175429,150572,No
NCET,Information Science and Engineering,KCET,2024,66159,77733,12896,10296,167084,156788,Yes
NCET,Computer Science and Engineering,KCET,2024,51910,92577,17837,22156,184480,162324,No
CITGubbi,Electronics and Communication Engineering,COMEDK,2023,206346,60904,12157,26758,306165,279407,No
NMIT,Civil Engineering,KCET,2023,81001,85249,17599,24583,208432,183849,Yes
VVCE,Biotechnology,COMEDK,2023,194724,77209,18616,21668,312217,290549,Yes
HKBK,Aerospace Engineering,COMEDK,2023,235411,68339,12505,29495,345750,316255,No
SCEM,Artificial Intelligence and Data Science,COMEDK,2024,208972,86789,19197,17677,332635,314958,Yes
SIT,Information Science and Engineering,KCET,2023,65155,66177,11000,22580,164912,142332,Yes
NCET,Mechanical Engineering,KCET,2023,58932,61169,9299,20862,150262,129400,Yes
AITM,Biotechnology,KCET,2024,82384,71509,15047,28350,197290,168940,No
JSSSTU,Artificial Intelligence and Data Science,COMEDK,2023,230755,74875,17239,29766,352635,322869,Yes
DSATM,Computer Science and Engineering,COMEDK,2024,205923,91882,16688,27885,342378,314493,No
BNMIT,Electronics and Communication Engineering,COMEDK,2023,188949,78358,15829,21863,304999,283136,Yes
VIT,Chemical Engineering,KCET,2023,54452,71672,19262,11165,156551,145386,Yes
VSM,Computer Science and Engineering,KCET,2023,64103,85507,9677,25799,185086,159287,Yes
MSRUAS,Data Science,COMEDK,2024,222418,70194,17694,28765,339071,310306,No
KLSGIT,Mechanical Engineering,COMEDK,2023,235752,91644,14623,18360,360379,342019,Yes
KLEIT,Computer Science and Engineering,COMEDK,2023,211039,86291,17999,17534,332863,315329,Yes
VVCE,Chemical Engineering,KCET,2024,51739,68635,9421,28741,158536,129795,Yes
DrAIT,Mechanical Engineering,KCET,2024,62672,94904,8397,23901,189874,165973,No
SJBCE,Data Science,COMEDK,2024,192367,94465,12652,28024,327508,299484,Yes
SIT,Electrical and Electronics Engineering,KCET,2024,82409,66500,14407,14328,177644,163316,Yes
BMIT,Robotics and Automation Engineering,COMEDK,2024,179003,60915,10493,26049,276460,250411,No
YKCE,Electronics and Communication Engineering,COMEDK,2024,215158,93072,16704,16935,341869,324934,Yes
DSCE,Artificial Intelligence and Data Science,KCET,2024,63134,93340,15681,24804,196959,172155,Yes
DSCE,Information Science and Engineering,COMEDK,2024,190224,93177,13793,13565,310759,297194,No
DSATM,Mechanical Engineering,KCET,2023,78176,87566,15642,15956,197340,181384,Yes
DBIT,Civil Engineering,COMEDK,2024,188065,61231,13995,24136,287427,263291,Yes
AITM,Biotechnology,COMEDK,2023,218062,90255,11682,24602,344601,319999,Yes
VVIT,Computer Science and Engineering,KCET,2023,82823,93973,14033,23260,214089,190829,Yes
PESU,Data Science,KCET,2024,54451,83750,19380,20060,177641,157581,Yes
UVCE,Computer Science and Engineering,KCET,2023,70230,82706,12239,23013,188188,165175,No
VVCE,Robotics and Automation Engineering,KCET,2024,69990,87415,9663,18165,185233,167068,Yes
NHCE,Information Science and Engineering,COMEDK,2024,191684,90585,8188,29465,319922,290457,No
DrAIT,Chemical Engineering,KCET,2024,60786,77024,16323,17934,172067,154133,No
RNSIT,Artificial Intelligence and Data Science,COMEDK,2023,233121,64844,18232,10274,326471,316197,No
AITM,Electrical and Electronics Engineering,KCET,2023,75380,69402,9175,29618,183575,153957,No
RAIT,Mechanical Engineering,COMEDK,2024,164864,69476,13930,10508,258778,248270,No
MVJCE,Mechanical Engineering,COMEDK,2023,188852,60366,18076,20529,287823,267294,No
SJBCE,Biotechnology,KCET,2023,54184,80469,19004,14995,168652,153657,Yes
SIT,Civil Engineering,KCET,2023,61745,61050,16517,18726,158038,139312,Yes
RVCE,Electrical and Electronics Engineering,KCET,2023,70911,73337,18089,16415,178752,162337,No
BNMIT,Biotechnology,KCET,2024,58642,87937,19855,23134,189568,166434,Yes
DrAIT,Information Science and Engineering,COMEDK,2024,212924,87619,9866,26299,336708,310409,Yes
KLSGIT,Mechanical Engineering,COMEDK,2024,239173,89242,14591,23306,366312,343006,No
PRES,Chemical Engineering,COMEDK,2023,162796,74469,10574,13506,261345,247839,No
DSATM,Biotechnology,KCET,2023,78249,63009,18326,23563,183147,159584,No
JIT,Information Science and Engineering,KCET,2024,73615,76712,9752,17904,177983,160079,Yes
DBIT,Electrical and Electronics Engineering,KCET,2024,70242,64460,10660,13749,159111,145362,Yes
REVA,Civil Engineering,COMEDK,2024,214109,89982,11534,19700,335325,315625,Yes
DSATM,Data Science,KCET,2024,53994,81855,8568,29360,173777,144417,Yes
UVCE,Civil Engineering,KCET,2023,74485,91014,8033,28441,201973,173532,No
VIT,Biotechnology,KCET,2023,56036,75279,18895,20385,170595,150210,Yes
DSCE,Computer Science and Engineering,COMEDK,2024,168420,79333,16772,17552,282077,264525,No
UVCE,Civil Engineering,COMEDK,2023,168859,78545,11682,19870,278956,259086,Yes
EastPoint,Information Science and Engineering,COMEDK,2023,238897,73941,18257,16038,347133,331095,Yes
UVCE,Electronics and Communication Engineering,KCET,2024,82398,80936,9322,15794,188450,172656,No
BIT,Biotechnology,KCET,2023,76471,63917,16266,29178,185832,156654,No
AEC,Robotics and Automation Engineering,KCET,2024,72886,74744,11284,24748,183662,158914,No
AECMandya,Data Science,COMEDK,2024,170572,92572,12690,10346,286180,275834,No
BNMIT,Electrical and Electronics Engineering,KCET,2023,79389,61636,18139,18194,177358,159164,Yes
DBIT,Civil Engineering,COMEDK,2024,217849,93889,13379,24921,350038,325117,Yes
BIT,Mechanical Engineering,KCET,2024,71233,75182,10887,22372,179674,157302,No
SDMCET,Civil Engineering,KCET,2024,51303,82458,15328,27585,176674,149089,Yes
GMIT,Computer Science and Engineering,COMEDK,2023,179994,90748,16629,15760,303131,287371,No
BMIT,Mechanical Engineering,KCET,2023,69798,69188,13256,10920,163162,152242,Yes
NCET,Chemical Engineering,KCET,2023,55051,66401,17154,16772,155378,138606,Yes
BMSIT,Aerospace Engineering,KCET,2023,54051,91348,13911,17700,177010,159310,No
KLSGIT,Biotechnology,KCET,2023,65102,84640,13722,23911,187375,163464,Yes
REVA,Civil Engineering,COMEDK,2023,219745,84854,14069,16806,335474,318668,No
CMRIT,Electrical and Electronics Engineering,COMEDK,2023,178162,78644,17849,12833,287488,274655,No
AIT,Computer Science and Engineering,KCET,2024,62098,64661,9169,20713,156641,135928,Yes
EastPoint,Computer Science and Engineering,KCET,2024,53665,65375,10782,15378,145200,129822,No
KSIT,Aerospace Engineering,COMEDK,2024,231313,78134,14821,16168,340436,324268,No
HKBK,Electronics and Communication Engineering,KCET,2023,61209,73738,16018,21844,172809,150965,Yes
DrAIT,Mechanical Engineering,COMEDK,2023,200900,85658,8430,19932,314920,294988,No
RAIT,Electrical and Electronics Engineering,KCET,2024,74439,87700,11078,15893,189110,173217,No
PESCE,Electrical and Electronics Engineering,COMEDK,2024,207711,91853,11324,22792,333680,310888,Yes
EastPoint,Aerospace Engineering,KCET,2024,72943,60503,18246,12533,164225,151692,No
SJBIT,Electrical and Electronics Engineering,KCET,2024,81285,60175,16165,20592,178217,157625,No
AEC,Chemical Engineering,KCET,2023,71344,82951,11843,20306,186444,166138,No
NHCE,Artificial Intelligence and Data Science,COMEDK,2023,173535,72196,17892,19117,282740,263623,No
DSATM,Computer Science and Engineering,COMEDK,2023,232813,63773,15385,19460,331431,311971,No
KLEIT,Electrical and Electronics Engineering,KCET,2023,58943,82076,14849,25243,181111,155868,Yes
AIT,Electronics and Communication Engineering,COMEDK,2024,160950,79780,15206,28828,284764,255936,No
PRES,Robotics and Automation Engineering,KCET,2023,69499,92424,19374,16619,197916,181297,Yes
KLSGIT,Aerospace Engineering,KCET,2024,67182,92462,17695,18193,195532,177339,Yes
DBIT,Information Science and Engineering,COMEDK,2024,232850,65549,15851,22923,337173,314250,No
REVA,Electrical and Electronics Engineering,KCET,2023,58057,79699,9768,24768,172292,147524,Yes
HKBK,Electrical and Electronics Engineering,COMEDK,2024,167520,63262,8968,19604,259354,239750,Yes
PESCE,Civil Engineering,COMEDK,2024,191557,89247,12845,24086,317735,293649,No
SDMCET,Biotechnology,KCET,2024,82822,75753,13672,25779,198026,172247,No
NCET,Civil Engineering,KCET,2024,65694,86100,13888,27485,193167,165682,No
SCEM,Aerospace Engineering,KCET,2023,61607,73314,11469,22591,168981,146390,No
SCEM,Electrical and Electronics Engineering,COMEDK,2023,207395,74634,18250,18954,319233,300279,No
SDMCET,Robotics and Automation Engineering,KCET,2024,70131,84506,15377,18622,188636,170014,Yes
HKBK,Civil Engineering,KCET,2024,74557,61688,15227,26590,178062,151472,Yes
AECMandya,Electronics and Communication Engineering,COMEDK,2023,188606,73442,16405,18044,296497,278453,Yes
MSRIT,Electronics and Communication Engineering,KCET,2023,82214,65074,11290,29407,187985,158578,No
VIT,Information Science and Engineering,KCET,2023,70799,77153,19263,11013,178228,167215,Yes
BMSIT,Computer Science and Engineering,KCET,2024,69376,90363,12137,11544,183420,171876,Yes
NIE,Electronics and Communication Engineering,COMEDK,2024,246703,88391,18897,21580,375571,353991,No
NCET,Computer Science and Engineering,KCET,2024,76504,81006,8433,12290,178233,165943,No
YKCE,Civil Engineering,COMEDK,2024,218097,68474,15518,27208,329297,302089,Yes
NCET,Biotechnology,KCET,2024,80347,86224,10134,10116,186821,176705,Yes
NCET,Chemical Engineering,KCET,2024,57144,62310,17663,26240,163357,137117,No
PESU,Information Science and Engineering,KCET,2024,79133,66928,13303,11429,170793,159364,Yes
RVCE,Information Science and Engineering,KCET,2024,84098,78768,9260,21537,193663,172126,No
YKCE,Electrical and Electronics Engineering,COMEDK,2024,223835,85361,17966,13475,340637,327162,No
DSCE,Mechanical Engineering,KCET,2023,71120,94222,15502,23295,204139,180844,Yes
SDMIT,Robotics and Automation Engineering,KCET,2024,78373,76218,16946,11207,182744,171537,Yes
PRES,Electrical and Electronics Engineering,KCET,2024,57835,86333,14506,11251,169925,158674,No
JSSSTU,Electrical and Electronics Engineering,COMEDK,2024,186399,65460,10450,21544,283853,262309,Yes
SJBIT,Electronics and Communication Engineering,KCET,2024,50440,65549,9788,22075,147852,125777,Yes
UVCE,Artificial Intelligence and Data Science,KCET,2023,80817,94241,10389,29164,214611,185447,No
VSM,Aerospace Engineering,COMEDK,2024,186462,92052,16602,13374,308490,295116,No
BMSIT,Data Science,COMEDK,2024,230960,77662,15024,29671,353317,323646,Yes
AITM,Aerospace Engineering,KCET,2023,54123,85495,10966,23060,173644,150584,No
YKCE,Computer Science and Engineering,COMEDK,2024,199071,62610,10610,15144,287435,272291,No
BIT,Aerospace Engineering,COMEDK,2024,180553,87717,19559,23249,311078,287829,Yes
NMIT,Biotechnology,KCET,2023,70171,87865,14180,18115,190331,172216,Yes
SDMIT,Electronics and Communication Engineering,COMEDK,2023,200086,90721,19795,19881,330483,310602,Yes
YKCE,Civil Engineering,KCET,2023,55012,73659,13950,11629,154250,142621,No
GIT,Electrical and Electronics Engineering,COMEDK,2023,203695,72027,12616,20136,308474,288338,Yes
BMSIT,Electrical and Electronics Engineering,COMEDK,2024,204065,73196,18226,20945,316432,295487,No
DrAIT,Aerospace Engineering,KCET,2024,75844,64500,13449,26801,180594,153793,No
RNSIT,Mechanical Engineering,KCET,2024,59355,92408,19321,21084,192168,171084,Yes
VSM,Mechanical Engineering,KCET,2024,67033,61361,12262,19320,159976,140656,No
YKCE,Chemical Engineering,COMEDK,2023,239727,69061,19767,20696,349251,328555,Yes
BITM,Biotechnology,KCET,2023,74260,61052,10705,24226,170243,146017,Yes
RNSIT,Aerospace Engineering,COMEDK,2023,200462,82516,15943,29320,328241,298921,No
SIT,Aerospace Engineering,KCET,2023,65833,79765,16016,27751,189365,161614,Yes
SCEM,Biotechnology,COMEDK,2023,210425,73868,13501,21353,319147,297794,No
SDMCET,Electronics and Communication Engineering,KCET,2024,77743,85281,14729,24952,202705,177753,Yes
SITM,Electronics and Communication Engineering,KCET,2023,79126,92540,16508,19711,207885,188174,No
AITM,Civil Engineering,COMEDK,2024,208984,60520,17569,26691,313764,287073,No
AIT,Information Science and Engineering,KCET,2023,80725,61639,14772,16264,173400,157136,No
KLSGIT,Information Science and Engineering,COMEDK,2023,228426,69307,17232,12913,327878,314965,No
KLSGIT,Computer Science and Engineering,COMEDK,2023,249935,83729,16570,13515,363749,350234,No
DSATM,Computer Science and Engineering,COMEDK,2023,175447,65325,15122,23529,279423,255894,Yes
BIT,Mechanical Engineering,KCET,2023,74996,84847,19698,21242,200783,179541,Yes
AITM,Mechanical Engineering,COMEDK,2024,236967,76504,16614,16649,346734,330085,No
VemanaIT,Artificial Intelligence and Data Science,KCET,2024,55814,72438,11615,20269,160136,139867,Yes
BITM,Information Science and Engineering,KCET,2024,69769,71985,17302,13558,172614,159056,No
BMSIT,Biotechnology,KCET,2024,66285,71586,19626,13110,170607,157497,No
SJBIT,Data Science,COMEDK,2023,245363,71848,12168,24893,354272,329379,Yes
RVCE,Information Science and Engineering,KCET,2024,77562,77287,12536,11136,178521,167385,No
MSRIT,Computer Science and Engineering,KCET,2023,84788,78752,15128,18497,197165,178668,No
BMIT,Electronics and Communication Engineering,COMEDK,2023,239157,66135,8455,20862,334609,313747,No
NMIT,Aerospace Engineering,KCET,2023,72762,89076,11422,21115,194375,173260,Yes
SJBCE,Civil Engineering,KCET,2024,68399,87855,18890,21230,196374,175144,No
MSRIT,Civil Engineering,KCET,2024,62294,80252,11551,11383,165480,154097,No
VSM,Chemical Engineering,COMEDK,2023,177165,63731,15469,17283,273648,256365,Yes
VVIT,Mechanical Engineering,COMEDK,2024,177731,93708,11193,27325,309957,282632,No
VVCE,Electronics and Communication Engineering,COMEDK,2024,205140,64298,10123,28182,307743,279561,No
MSRUAS,Chemical Engineering,COMEDK,2024,208814,72179,13605,25579,320177,294598,Yes
SJBCE,Artificial Intelligence and Data Science,KCET,2023,64815,80636,11783,26955,184189,157234,No
MVJCE,Information Science and Engineering,COMEDK,2024,165282,67469,8283,19563,260597,241034,Yes
MSRUAS,Computer Science and Engineering,COMEDK,2024,203995,92350,17933,22374,336652,314278,Yes
JIT,Artificial Intelligence and Data Science,COMEDK,2024,174928,73567,19734,14863,283092,268229,No
BMSIT,Mechanical Engineering,KCET,2023,80622,65403,18666,27922,192613,164691,Yes
SITM,Data Science,KCET,2024,72393,88324,17587,17065,195369,178304,Yes
PRES,Electrical and Electronics Engineering,COMEDK,2023,235623,91274,11960,27604,366461,338857,Yes
SITM,Aerospace Engineering,COMEDK,2024,246338,67313,10819,21474,345944,324470,Yes
MSRUAS,Biotechnology,KCET,2024,61139,61538,16100,19552,158329,138777,Yes
DSCE,Computer Science and Engineering,KCET,2024,52023,79832,8765,22098,162718,140620,Yes
MSRUAS,Computer Science and Engineering,KCET,2023,67520,65808,13467,29463,176258,146795,Yes
RNSIT,Civil Engineering,COMEDK,2023,237906,76479,11373,20632,346390,325758,Yes
BMSCE,Chemical Engineering,COMEDK,2024,209253,75123,18562,10148,313086,302938,Yes
AITM,Data Science,COMEDK,2024,182990,89560,15447,10456,298453,287997,No
VVIT,Aerospace Engineering,KCET,2024,70211,62874,12113,13561,158759,145198,Yes
KLEIT,Robotics and Automation Engineering,KCET,2024,52393,79122,18170,21732,171417,149685,No
DSATM,Civil Engineering,KCET,2023,56453,66525,18851,14897,156726,141829,Yes
SCEM,Electronics and Communication Engineering,COMEDK,2024,238431,76270,15186,20680,350567,329887,No
BNMIT,Civil Engineering,KCET,2024,73529,78117,18968,20247,190861,170614,No
SJBCE,Information Science and Engineering,COMEDK,2023,240734,91102,17279,16417,365532,349115,Yes
SCEM,Electronics and Communication Engineering,COMEDK,2024,229951,66345,15133,13181,324610,311429,No
RIT,Civil Engineering,COMEDK,2024,223521,70165,10819,26920,331425,304505,No
RIT,Chemical Engineering,KCET,2024,83263,61314,13405,10636,168618,157982,Yes
RVCE,Robotics and Automation Engineering,COMEDK,2024,244843,85565,18325,15302,364035,348733,No
AEC,Robotics and Automation Engineering,KCET,2024,57598,67963,8791,18349,152701,134352,No
CITGubbi,Artificial Intelligence and Data Science,KCET,2024,77307,81696,14324,18529,191856,173327,No
AECMandya,Artificial Intelligence and Data Science,KCET,2024,69761,80368,16448,23516,190093,166577,No
AEC,Computer Science and Engineering,KCET,2024,50458,64978,15050,13060,143546,130486,Yes
UVCE,Artificial Intelligence and Data Science,KCET,2024,77778,66725,10709,23532,178744,155212,No
KSIT,Aerospace Engineering,COMEDK,2023,228231,62042,11506,14381,316160,301779,Yes
CMRIT,Aerospace Engineering,KCET,2023,51698,84633,17704,15662,169697,154035,No
SJBIT,Civil Engineering,KCET,2023,58352,90314,9404,12792,170862,158070,No
BIT,Biotechnology,KCET,2024,84255,80871,13078,23828,202032,178204,Yes
PESU,Information Science and Engineering,KCET,2023,53159,65473,18503,27281,164416,137135,Yes
AIT,Information Science and Engineering,COMEDK,2023,175072,82757,9028,17167,284024,266857,No
EastPoint,Information Science and Engineering,COMEDK,2024,231686,65679,8833,15967,322165,306198,Yes
BNMIT,Chemical Engineering,COMEDK,2023,169106,68578,11251,22446,271381,248935,No
JSSSTU,Civil Engineering,COMEDK,2023,227781,66368,8537,10251,312937,302686,No
KSIT,Computer Science and Engineering,KCET,2023,52864,82399,10033,26266,171562,145296,No
SIT,Biotechnology,KCET,2024,61133,73390,14590,18947,168060,149113,No
DBIT,Electrical and Electronics Engineering,KCET,2023,83703,77555,19894,13813,194965,181152,No
KSIT,Civil Engineering,KCET,2024,81031,74329,8202,26067,189629,163562,No
NCET,Electronics and Communication Engineering,KCET,2024,58949,60848,17405,11664,148866,137202,Yes
CMRIT,Information Science and Engineering,COMEDK,2024,184699,93460,16361,27345,321865,294520,No
DSATM,Aerospace Engineering,COMEDK,2024,246842,69967,19772,18376,354957,336581,No
RNSIT,Civil Engineering,KCET,2023,79946,94100,13044,11172,198262,187090,Yes
MSRUAS,Robotics and Automation Engineering,KCET,2024,66798,61368,17830,25326,171322,145996,No
SDMCET,Artificial Intelligence and Data Science,KCET,2023,56802,61486,8833,21344,148465,127121,No
RNSIT,Data Science,COMEDK,2023,173908,67365,19926,25647,286846,261199,Yes
CITGubbi,Robotics and Automation Engineering,COMEDK,2023,168254,63668,12981,27563,272466,244903,No
SIT,Robotics and Automation Engineering,KCET,2024,54292,76450,13882,25526,170150,144624,No
VVIT,Electronics and Communication Engineering,KCET,2023,68929,64791,12590,11340,157650,146310,No
HKBK,Data Science,KCET,2023,53348,85835,15934,11683,166800,155117,No
SDMCET,Electrical and Electronics Engineering,COMEDK,2023,168691,66855,8192,23796,267534,243738,Yes
HKBK,Civil Engineering,KCET,2024,68588,63509,9413,12354,153864,141510,No
VVIT,Aerospace Engineering,COMEDK,2024,205679,93769,19731,29620,348799,319179,Yes
BNMIT,Biotechnology,COMEDK,2024,172267,91855,8048,18694,290864,272170,No
NHCE,Robotics and Automation Engineering,COMEDK,2023,241007,61074,17030,21459,340570,319111,Yes
VIT,Information Science and Engineering,KCET,2023,78524,63041,9034,18597,169196,150599,Yes
JNNCE,Electrical and Electronics Engineering,KCET,2024,57278,84842,8912,21313,172345,151032,Yes
SDMCET,Chemical Engineering,COMEDK,2024,208880,71855,18693,13697,313125,299428,Yes
PESCE,Artificial Intelligence and Data Science,KCET,2023,54838,74129,9571,21255,159793,138538,Yes
NIE,Aerospace Engineering,KCET,2024,84579,82167,17011,29090,212847,183757,No
DSATM,Computer Science and Engineering,KCET,2024,65650,76896,18652,12437,173635,161198,No
AITM,Civil Engineering,KCET,2024,64786,83190,18402,18196,184574,166378,No
DSCE,Information Science and Engineering,COMEDK,2023,193435,63413,13145,24177,294170,269993,No
AEC,Artificial Intelligence and Data Science,COMEDK,2024,163186,66753,8244,21843,260026,238183,No
NHCE,Robotics and Automation Engineering,KCET,2024,71146,72355,13351,26514,183366,156852,No
EastPoint,Information Science and Engineering,COMEDK,2024,174338,70890,13647,16406,275281,258875,Yes
JSSSTU,Robotics and Automation Engineering,COMEDK,2023,218581,67027,9189,15776,310573,294797,No
AITM,Electronics and Communication Engineering,KCET,2024,84883,88772,10207,17475,201337,183862,No
JNNCE,Mechanical Engineering,KCET,2023,67884,77824,15611,12176,173495,161319,No
SJBIT,Artificial Intelligence and Data Science,COMEDK,2024,197388,83814,15455,21002,317659,296657,Yes
AEC,Electrical and Electronics Engineering,KCET,2023,79044,82699,9984,15212,186939,171727,Yes
SDMCET,Robotics and Automation Engineering,KCET,2023,59125,91712,10194,25835,186866,161031,No
DSATM,Data Science,COMEDK,2023,190860,90272,14425,12303,307860,295557,No
BMIT,Mechanical Engineering,COMEDK,2023,175310,93997,16951,21996,308254,286258,No
CITGubbi,Computer Science and Engineering,COMEDK,2024,196244,68938,18750,13746,297678,283932,Yes
VIT,Robotics and Automation Engineering,COMEDK,2024,185403,88884,12098,20380,306765,286385,No
BMSCE,Computer Science and Engineering,COMEDK,2024,209317,76567,11357,14237,311478,297241,Yes
CMRIT,Information Science and Engineering,KCET,2024,84305,92318,9685,24556,210864,186308,No
PRES,Civil Engineering,KCET,2024,62631,61234,14480,15544,153889,138345,Yes
AIT,Electrical and Electronics Engineering,COMEDK,2023,180837,69660,8496,18359,277352,258993,Yes
AEC,Artificial Intelligence and Data Science,COMEDK,2024,243430,74004,12317,13682,343433,329751,Yes
BIT,Electronics and Communication Engineering,KCET,2024,61966,63949,9429,21290,156634,135344,No
BMSIT,Electronics and Communication Engineering,COMEDK,2023,245159,84406,12967,14990,357522,342532,No
GIT,Mechanical Engineering,KCET,2023,61062,83896,12531,24356,181845,157489,No
PESCE,Civil Engineering,COMEDK,2023,207594,91270,8398,23202,330464,307262,Yes
RNSIT,Data Science,COMEDK,2024,173681,84903,12147,25774,296505,270731,Yes
PESU,Civil Engineering,KCET,2023,72505,65399,15948,25264,179116,153852,No
SCEM,Electronics and Communication Engineering,KCET,2023,63532,93643,8983,16361,182519,166158,No
PESU,Data Science,COMEDK,2023,221875,71297,16271,18690,328133,309443,Yes
NCET,Aerospace Engineering,KCET,2024,82290,65687,12044,29652,189673,160021,Yes
AITM,Mechanical Engineering,COMEDK,2023,248477,93351,14601,24164,380593,356429,No
PESCE,Chemical Engineering,KCET,2024,83457,77176,17305,14984,192922,177938,Yes
BMSIT,Civil Engineering,COMEDK,2023,179548,86210,14816,24156,304730,280574,Yes
SDMIT,Mechanical Engineering,KCET,2023,75997,90338,10044,11484,187863,176379,Yes
RVUNIV,Mechanical Engineering,KCET,2024,73326,70823,17420,24138,185707,161569,No
RIT,Civil Engineering,COMEDK,2024,166234,72008,14777,17493,270512,253019,No
BMSCE,Aerospace Engineering,KCET,2024,53134,69410,11139,21553,155236,133683,Yes
CITGubbi,Electronics and Communication Engineering,KCET,2024,83710,77870,17655,25576,204811,179235,Yes
SDMCET,Artificial Intelligence and Data Science,COMEDK,2023,228262,77298,12105,18000,335665,317665,No
AITM,Biotechnology,COMEDK,2024,213603,93084,18910,11199,336796,325597,Yes
NHCE,Mechanical Engineering,COMEDK,2023,207687,93330,8568,16310,325895,309585,Yes
AIT,Civil Engineering,KCET,2023,58581,75527,18049,15947,168104,152157,No
AECMandya,Artificial Intelligence and Data Science,COMEDK,2023,243785,79417,14911,15816,353929,338113,No
BMSIT,Information Science and Engineering,KCET,2023,62766,87410,10300,17093,177569,160476,Yes
KSIT,Artificial Intelligence and Data Science,COMEDK,2023,182203,86675,9928,26216,305022,278806,No
SIT,Electronics and Communication Engineering,KCET,2023,79652,62308,9734,29644,181338,151694,No
MVJCE,Chemical Engineering,COMEDK,2023,183937,81679,9833,25884,301333,275449,Yes
SJBIT,Mechanical Engineering,KCET,2023,70775,74078,18117,13531,176501,162970,Yes
REVA,Chemical Engineering,KCET,2024,60293,78919,8647,15855,163714,147859,Yes
HKBK,Computer Science and Engineering,KCET,2024,83510,86212,15674,13527,198923,185396,No
JSSSTU,Chemical Engineering,KCET,2023,68383,75717,8059,26838,178997,152159,No
AEC,Electronics and Communication Engineering,COMEDK,2023,171790,71994,11521,22554,277859,255305,No
NIE,Computer Science and Engineering,COMEDK,2023,180729,64527,11163,28342,284761,256419,No
VIT,Information Science and Engineering,COMEDK,2023,180969,65120,11307,18524,275920,257396,No
NHCE,Information Science and Engineering,KCET,2023,70037,68833,10520,21071,170461,149390,Yes
MVJCE,Electrical and Electronics Engineering,KCET,2024,51349,93489,14329,12345,171512,159167,No
KSIT,Electronics and Communication Engineering,COMEDK,2024,219702,64511,12595,17320,314128,296808,No
JIT,Computer Science and Engineering,KCET,2023,80665,66092,13014,28823,188594,159771,Yes
PRES,Robotics and Automation Engineering,KCET,2023,83463,60950,17572,29685,191670,161985,Yes
RNSIT,Chemical Engineering,KCET,2023,83545,82708,8601,28739,203593,174854,No
EastPoint,Computer Science and Engineering,COMEDK,2024,236818,89207,18338,19727,364090,344363,Yes
HKBK,Electrical and Electronics Engineering,COMEDK,2024,219574,68671,12757,14721,315723,301002,Yes
VSM,Artificial Intelligence and Data Science,COMEDK,2024,190664,68614,15580,23045,297903,274858,Yes
BMSIT,Chemical Engineering,COMEDK,2024,246831,71137,14041,13068,345077,332009,No
DrAIT,Electrical and Electronics Engineering,KCET,2023,74751,77075,19415,24481,195722,171241,No
VVCE,Chemical Engineering,COMEDK,2023,202072,63022,13442,17454,295990,278536,Yes
DBIT,Electrical and Electronics Engineering,KCET,2023,68834,75479,12206,18871,175390,156519,Yes
DBIT,Electrical and Electronics Engineering,COMEDK,2023,236884,78712,15634,10900,342130,331230,No
DrAIT,Aerospace Engineering,KCET,2024,78688,72660,12287,16845,180480,163635,Yes
PESCE,Data Science,COMEDK,2024,189658,94861,8099,20283,312901,292618,Yes
JIT,Biotechnology,KCET,2023,72614,91149,11019,25361,200143,174782,Yes
SDMIT,Chemical Engineering,KCET,2024,65034,85173,15091,11717,177015,165298,No
SDMCET,Chemical Engineering,KCET,2023,74120,87955,9378,10262,181715,171453,Yes
SJBCE,Electrical and Electronics Engineering,COMEDK,2023,185165,72291,14776,20231,292463,272232,Yes
RNSIT,Robotics and Automation Engineering,COMEDK,2023,229976,63314,13475,21456,328221,306765,Yes
AEC,Artificial Intelligence and Data Science,COMEDK,2023,223481,73779,10958,14666,322884,308218,No
DBIT,Chemical Engineering,KCET,2023,63491,60539,8866,17900,150796,132896,Yes
YKCE,Mechanical Engineering,KCET,2023,84477,74355,16894,10377,186103,175726,No
PESCE,Biotechnology,KCET,2023,74985,87982,11155,21082,195204,174122,No
YKCE,Computer Science and Engineering,COMEDK,2023,248699,67556,10681,10187,337123,326936,Yes
MSRUAS,Electronics and Communication Engineering,COMEDK,2024,203243,71999,16140,18621,310003,291382,Yes
UVCE,Biotechnology,KCET,2024,74409,86990,16753,21146,199298,178152,No
AIT,Mechanical Engineering,KCET,2024,76638,78293,17047,22968,194946,171978,Yes
SJBCE,Electronics and Communication Engineering,COMEDK,2023,176360,79340,8567,19722,283989,264267,Yes
VIT,Computer Science and Engineering,KCET,2023,56793,75770,17629,23213,173405,150192,No
VVCE,Biotechnology,COMEDK,2023,175143,87227,13371,14390,290131,275741,No
BIT,Chemical Engineering,COMEDK,2024,194630,77553,18962,15855,307000,291145,No
SJBCE,Electrical and Electronics Engineering,KCET,2023,79898,71035,19541,21650,192124,170474,Yes
RAIT,Computer Science and Engineering,COMEDK,2024,194862,61458,9656,14199,280175,265976,No
RAIT,Robotics and Automation Engineering,COMEDK,2023,160911,62874,9057,22640,255482,232842,No
ACU,Mechanical Engineering,KCET,2024,60315,81392,10148,27253,179108,151855,No
PESCE,Artificial Intelligence and Data Science,KCET,2024,58776,76272,11560,29572,176180,146608,No
JNNCE,Civil Engineering,KCET,2023,63571,87482,14101,18455,183609,165154,No
JSSSTU,Mechanical Engineering,KCET,2024,58650,81554,18211,25946,184361,158415,Yes
NCET,Robotics and Automation Engineering,KCET,2024,63931,93240,9892,29881,196944,167063,No
GMIT,Data Science,COMEDK,2024,248262,82378,19094,13599,363333,349734,No
HKBK,Computer Science and Engineering,KCET,2023,57602,68168,9548,19833,155151,135318,Yes
RVCE,Aerospace Engineering,COMEDK,2024,187077,70404,16349,24308,298138,273830,No
REVA,Chemical Engineering,COMEDK,2023,248671,60088,11588,28122,348469,320347,No
AEC,Mechanical Engineering,KCET,2023,83555,61679,8612,16424,170270,153846,Yes
RVCE,Mechanical Engineering,COMEDK,2023,184280,78804,14878,25771,303733,277962,No
RAIT,Aerospace Engineering,KCET,2023,68786,73679,9841,17301,169607,152306,No
CITGubbi,Robotics and Automation Engineering,COMEDK,2024,184862,65249,13475,23486,287072,263586,Yes
HKBK,Biotechnology,COMEDK,2024,192600,62355,14479,28476,297910,269434,No
RAIT,Artificial Intelligence and Data Science,KCET,2023,66624,64197,18665,26365,175851,149486,Yes
HKBK,Robotics and Automation Engineering,KCET,2024,66652,90055,8902,11461,177070,165609,Yes
REVA,Robotics and Automation Engineering,COMEDK,2023,211127,77101,16210,21869,326307,304438,Yes
SITM,Biotechnology,KCET,2023,65075,62099,16312,18633,162119,143486,No
PESCE,Artificial Intelligence and Data Science,KCET,2023,78520,80424,9797,17618,186359,168741,Yes
PESCE,Computer Science and Engineering,COMEDK,2023,168278,70787,14267,24723,278055,253332,No
AITM,Civil Engineering,COMEDK,2024,209658,89122,17876,29517,346173,316656,No
YKCE,Data Science,KCET,2024,76499,86447,13895,28784,205625,176841,No
BMSIT,Chemical Engineering,KCET,2024,62703,74450,8893,14146,160192,146046,Yes
CITGubbi,Electronics and Communication Engineering,COMEDK,2023,244014,92659,12229,14267,363169,348902,No
SCEM,Information Science and Engineering,COMEDK,2024,207376,64380,19333,13600,304689,291089,No
KLSGIT,Civil Engineering,KCET,2024,55594,64190,14937,23564,158285,134721,Yes
NMIT,Robotics and Automation Engineering,KCET,2023,83671,90370,15384,17836,207261,189425,Yes
CMRIT,Computer Science and Engineering,COMEDK,2023,169498,94331,16497,22991,303317,280326,Yes
NMIT,Civil Engineering,KCET,2024,72099,88072,9234,25542,194947,169405,No
RVCE,Biotechnology,COMEDK,2024,217134,88150,13422,11676,330382,318706,No
EastPoint,Data Science,KCET,2024,77964,79889,8374,16299,182526,166227,Yes
NCET,Civil Engineering,KCET,2023,81323,63242,13333,22539,180437,157898,No
AIT,Data Science,KCET,2024,56944,78357,19928,17844,173073,155229,No
AIT,Chemical Engineering,KCET,2023,74268,63563,16141,10504,164476,153972,Yes
REVA,Biotechnology,KCET,2024,79163,66703,17605,28453,191924,163471,Yes
BITM,Chemical Engineering,KCET,2024,71480,94556,16036,27167,209239,182072,Yes
VVIT,Information Science and Engineering,KCET,2023,83321,84418,16666,10145,194550,184405,Yes
AEC,Chemical Engineering,COMEDK,2023,222040,70774,18409,26544,337767,311223,Yes
YKCE,Electrical and Electronics Engineering,COMEDK,2023,212420,86460,9572,17430,325882,308452,No
RVCE,Information Science and Engineering,KCET,2024,60677,86440,18858,24960,190935,165975,Yes
PRES,Robotics and Automation Engineering,COMEDK,2024,231212,79889,8881,10913,330895,319982,Yes
SIT,Data Science,KCET,2024,71557,87401,18043,16797,193798,177001,Yes
RNSIT,Biotechnology,KCET,2023,56613,86005,14095,23872,180585,156713,Yes
RIT,Artificial Intelligence and Data Science,COMEDK,2024,220254,75750,10661,22639,329304,306665,Yes
JSSSTU,Information Science and Engineering,COMEDK,2023,242327,89505,17272,17918,367022,349104,Yes
BITM,Robotics and Automation Engineering,KCET,2023,61648,93632,19174,19382,193836,174454,No
REVA,Electronics and Communication Engineering,KCET,2023,62622,77998,14029,29050,183699,154649,Yes
VIT,Information Science and Engineering,COMEDK,2023,184994,76468,10259,11869,283590,271721,Yes
SITM,Computer Science and Engineering,COMEDK,2023,232336,91540,19296,22111,365283,343172,Yes
SITM,Data Science,COMEDK,2024,160646,93599,17806,16032,288083,272051,No
KLSGIT,Data Science,COMEDK,2023,186222,70451,18588,17956,293217,275261,No
PESU,Electrical and Electronics Engineering,KCET,2024,58354,71375,15744,11163,156636,145473,No
BMSIT,Robotics and Automation Engineering,KCET,2024,79019,71438,13855,19923,184235,164312,Yes
PRES,Electrical and Electronics Engineering,COMEDK,2023,185063,61035,8159,16469,270726,254257,Yes
BNMIT,Computer Science and Engineering,KCET,2024,51490,67489,19522,24582,163083,138501,Yes
VIT,Biotechnology,KCET,2024,80666,81581,18123,28722,209092,180370,No
BMSIT,Electrical and Electronics Engineering,KCET,2023,80671,76048,14619,29168,200506,171338,No
RVCE,Mechanical Engineering,KCET,2023,63404,69181,13663,11361,157609,146248,Yes
AECMandya,Mechanical Engineering,COMEDK,2024,222342,61409,8075,13129,304955,291826,No
CITGubbi,Biotechnology,KCET,2023,84886,69892,8982,28360,192120,163760,No
GIT,Robotics and Automation Engineering,KCET,2024,62288,83827,8760,11772,166647,154875,Yes
AITM,Electronics and Communication Engineering,KCET,2023,59900,87424,17713,27161,192198,165037,No
ACU,Chemical Engineering,KCET,2023,79229,65956,15550,24691,185426,160735,Yes
AEC,Electronics and Communication Engineering,KCET,2023,61673,60049,9987,12284,143993,131709,No
SJBIT,Mechanical Engineering,COMEDK,2024,167906,70049,19014,23467,280436,256969,No
CITGubbi,Information Science and Engineering,KCET,2024,52277,90627,18200,14066,175170,161104,No
BMSIT,Electrical and Electronics Engineering,COMEDK,2023,202942,90287,10365,29578,333172,303594,No
VemanaIT,Information Science and Engineering,COMEDK,2023,228714,94893,12283,18845,354735,335890,No
EastPoint,Aerospace Engineering,KCET,2024,50405,82894,9687,21707,164693,142986,Yes
SJBIT,Electrical and Electronics Engineering,KCET,2023,50177,81173,13958,10841,156149,145308,Yes
RIT,Mechanical Engineering,COMEDK,2023,249520,92248,18978,22061,382807,360746,Yes
BMSIT,Information Science and Engineering,KCET,2023,72605,90526,13408,11624,188163,176539,No
HKBK,Computer Science and Engineering,KCET,2023,61317,62966,13289,14002,151574,137572,Yes
SDMCET,Electronics and Communication Engineering,COMEDK,2023,213699,77209,9543,16913,317364,300451,Yes
AITM,Civil Engineering,COMEDK,2023,205981,69594,9826,26035,311436,285401,Yes
PESU,Computer Science and Engineering,COMEDK,2023,235560,86225,16732,13959,352476,338517,No
VIT,Artificial Intelligence and Data Science,KCET,2023,64065,74872,17462,27779,184178,156399,No
AEC,Computer Science and Engineering,KCET,2023,66880,89200,13939,11014,181033,170019,No
RVUNIV,Information Science and Engineering,KCET,2023,57367,78041,9345,10532,155285,144753,Yes
DBIT,Robotics and Automation Engineering,COMEDK,2023,234879,81855,13693,25623,356050,330427,Yes
AIT,Robotics and Automation Engineering,KCET,2024,64346,73571,13325,27329,178571,151242,Yes
CMRIT,Electronics and Communication Engineering,COMEDK,2024,227478,67322,10762,18264,323826,305562,No
DSCE,Mechanical Engineering,KCET,2024,69783,84541,11310,28403,194037,165634,Yes
AITM,Data Science,KCET,2023,61739,92355,11349,28130,193573,165443,No
BNMIT,Chemical Engineering,COMEDK,2024,187070,75505,17685,11837,292097,280260,Yes
RVUNIV,Chemical Engineering,KCET,2023,73437,75710,10995,10409,170551,160142,Yes
NHCE,Data Science,KCET,2024,76944,84405,15181,16203,192733,176530,Yes
KLSGIT,Chemical Engineering,COMEDK,2024,171632,90104,15180,29697,306613,276916,No
DBIT,Mechanical Engineering,COMEDK,2023,200451,62477,10660,23496,297084,273588,Yes
SITM,Civil Engineering,COMEDK,2024,203507,83061,16959,10335,313862,303527,Yes
PRES,Electrical and Electronics Engineering,COMEDK,2024,184551,81133,15428,19488,300600,281112,Yes
KSIT,Mechanical Engineering,KCET,2023,62987,92985,19776,28582,204330,175748,Yes
JSSSTU,Data Science,KCET,2023,51619,71948,9961,13363,146891,133528,No
AECMandya,Mechanical Engineering,KCET,2024,69494,94936,12982,24489,201901,177412,No
SCEM,Civil Engineering,COMEDK,2023,186421,88736,13236,22410,310803,288393,Yes
SDMCET,Mechanical Engineering,KCET,2023,69822,90161,16850,29618,206451,176833,No
CMRIT,Civil Engineering,COMEDK,2023,163757,76963,10667,18667,270054,251387,Yes
NCET,Chemical Engineering,COMEDK,2024,167519,82968,8588,12744,271819,259075,Yes
RVCE,Computer Science and Engineering,COMEDK,2023,224225,81178,8899,25427,339729,314302,Yes
SIT,Electronics and Communication Engineering,COMEDK,2024,172648,62600,9582,22459,267289,244830,No
JIT,Computer Science and Engineering,KCET,2023,77306,90007,11041,26437,204791,178354,Yes
PESU,Chemical Engineering,COMEDK,2023,240356,67442,11002,25459,344259,318800,No
DBIT,Electronics and Communication Engineering,KCET,2024,73024,85477,19340,29608,207449,177841,No
NIE,Mechanical Engineering,KCET,2024,69353,74800,13397,27914,185464,157550,Yes
SDMIT,Civil Engineering,COMEDK,2024,233043,92300,11251,24898,361492,336594,No
JIT,Biotechnology,KCET,2024,76126,73189,16005,19862,185182,165320,No
REVA,Data Science,COMEDK,2023,213718,60959,19151,22906,316734,293828,Yes
AECMandya,Electrical and Electronics Engineering,KCET,2023,72579,91156,15805,18757,198297,179540,No
KSIT,Aerospace Engineering,KCET,2023,54101,69970,18939,24004,167014,143010,Yes
PESU,Electronics and Communication Engineering,COMEDK,2024,240235,74511,9227,24200,348173,323973,Yes
BITM,Aerospace Engineering,KCET,2023,53494,74183,12615,11871,152163,140292,Yes
EastPoint,Computer Science and Engineering,COMEDK,2023,178035,83145,16133,21950,299263,277313,No
AECMandya,Data Science,COMEDK,2023,238416,63316,13232,20580,335544,314964,No
DrAIT,Computer Science and Engineering,KCET,2023,80541,86346,13483,25672,206042,180370,No
BMIT,Data Science,KCET,2023,50419,82787,17565,28949,179720,150771,No
KLSGIT,Civil Engineering,COMEDK,2024,229450,85143,18295,18762,351650,332888,Yes
BMSCE,Information Science and Engineering,COMEDK,2024,224452,65233,15966,21387,327038,305651,Yes
PESU,Data Science,KCET,2023,60967,90765,16714,25543,193989,168446,No
BMSIT,Civil Engineering,KCET,2024,84739,73567,14882,15225,188413,173188,Yes
BMSCE,Electrical and Electronics Engineering,KCET,2023,79623,82696,17799,14137,194255,180118,No
DSCE,Information Science and Engineering,KCET,2024,54310,86997,18196,27581,187084,159503,No
HKBK,Robotics and Automation Engineering,KCET,2024,64500,86061,10018,20846,181425,160579,Yes
GIT,Information Science and Engineering,KCET,2023,57204,67723,9658,20666,155251,134585,Yes
NIE,Robotics and Automation Engineering,COMEDK,2024,173164,73846,15414,25658,288082,262424,No
BMSCE,Data Science,KCET,2023,51582,87697,17976,15796,173051,157255,No
DSATM,Electrical and Electronics Engineering,COMEDK,2023,170529,65609,9510,25593,271241,245648,No
SITM,Electrical and Electronics Engineering,KCET,2024,81197,63885,19241,23277,187600,164323,No
SJBCE,Civil Engineering,COMEDK,2023,173733,65324,12278,28207,279542,251335,No
VSM,Aerospace Engineering,KCET,2023,72912,73825,10800,18661,176198,157537,Yes
VVCE,Biotechnology,KCET,2024,81908,93441,14332,12242,201923,189681,No
EastPoint,Biotechnology,KCET,2023,50642,69357,10696,22262,152957,130695,Yes
NHCE,Computer Science and Engineering,COMEDK,2023,207389,69966,10352,25256,312963,287707,No
PESCE,Mechanical Engineering,COMEDK,2023,233445,85828,13910,12951,346134,333183,Yes
HKBK,Electrical and Electronics Engineering,KCET,2023,70005,93554,13930,21185,198674,177489,No
PESU,Electrical and Electronics Engineering,KCET,2023,84431,66047,14481,20715,185674,164959,Yes
BMSIT,Information Science and Engineering,KCET,2024,78279,71446,9938,24914,184577,159663,Yes
SCEM,Artificial Intelligence and Data Science,COMEDK,2024,215854,71904,16246,22757,326761,304004,Yes
PESU,Information Science and Engineering,COMEDK,2024,231155,68596,12773,20495,333019,312524,Yes
SCEM,Electrical and Electronics Engineering,KCET,2024,61170,73174,9646,13778,157768,143990,Yes
MSRUAS,Electronics and Communication Engineering,KCET,2024,70138,79071,13584,24019,186812,162793,No
GMIT,Electronics and Communication Engineering,COMEDK,2023,207694,76100,12887,29480,326161,296681,No
PESU,Chemical Engineering,COMEDK,2024,162233,64748,19716,18953,265650,246697,No
VVCE,Information Science and Engineering,KCET,2024,76868,91787,14665,13767,197087,183320,Yes
RVCE,Aerospace Engineering,KCET,2023,52057,64470,19155,17609,153291,135682,Yes
AITM,Electrical and Electronics Engineering,KCET,2024,71582,67017,9727,17878,166204,148326,Yes
GMIT,Biotechnology,COMEDK,2024,178274,78794,18253,29864,305185,275321,No
BMSCE,Computer Science and Engineering,KCET,2023,59801,88164,16097,16021,180083,164062,No
AIT,Mechanical Engineering,COMEDK,2023,221242,63400,16934,19916,321492,301576,No
RAIT,Artificial Intelligence and Data Science,KCET,2024,63050,73032,13755,18219,168056,149837,No
AECMandya,Robotics and Automation Engineering,COMEDK,2023,173642,81300,17940,28057,300939,272882,Yes
RIT,Civil Engineering,COMEDK,2023,238555,84794,13602,10333,347284,336951,Yes
AIT,Civil Engineering,KCET,2023,56226,63594,8381,17019,145220,128201,No
BMSIT,Artificial Intelligence and Data Science,KCET,2023,52006,70013,9652,24637,156308,131671,No
GMIT,Artificial Intelligence and Data Science,KCET,2024,83700,62939,9563,15716,171918,156202,Yes
ACU,Computer Science and Engineering,COMEDK,2023,165157,87429,15024,23307,290917,267610,Yes
EastPoint,Biotechnology,KCET,2024,54221,88375,8929,11101,162626,151525,Yes
GIT,Mechanical Engineering,COMEDK,2024,206307,83371,19012,28714,337404,308690,No
PESU,Electrical and Electronics Engineering,KCET,2023,77469,61197,11114,21819,171599,149780,No
PESU,Civil Engineering,KCET,2023,65310,83665,19497,15647,184119,168472,No
AEC,Aerospace Engineering,COMEDK,2023,173085,68247,17026,11439,269797,258358,No
JIT,Aerospace Engineering,KCET,2023,54703,67474,16980,13539,152696,139157,No
SIT,Electrical and Electronics Engineering,COMEDK,2024,188026,94221,14153,29835,326235,296400,Yes
DSCE,Aerospace Engineering,KCET,2023,74686,61612,16725,20578,173601,153023,No
YKCE,Mechanical Engineering,KCET,2024,64441,91685,8286,24358,188770,164412,No
BNMIT,Biotechnology,KCET,2024,79965,92877,16655,17930,207427,189497,No
JIT,Data Science,COMEDK,2023,174331,93952,15347,20091,303721,283630,No
JNNCE,Biotechnology,KCET,2024,52772,71634,18430,24871,167707,142836,Yes
PRES,Electronics and Communication Engineering,KCET,2023,71472,76294,17736,10166,175668,165502,Yes
RVCE,Chemical Engineering,COMEDK,2024,188808,66394,11964,18461,285627,267166,Yes
ACU,Artificial Intelligence and Data Science,KCET,2023,77647,81991,17096,19785,196519,176734,No
AIT,Aerospace Engineering,COMEDK,2023,174534,77407,16116,27874,295931,268057,Yes
GIT,Electrical and Electronics Engineering,COMEDK,2024,174326,65064,18472,28815,286677,257862,Yes
RNSIT,Civil Engineering,KCET,2024,70648,65332,8817,13853,158650,144797,No
NCET,Electrical and Electronics Engineering,COMEDK,2024,239786,80439,15895,14362,350482,336120,No
VVCE,Aerospace Engineering,COMEDK,2024,188963,66761,13207,10238,279169,268931,No
DSATM,Electronics and Communication Engineering,KCET,2024,80926,65401,13733,17453,177513,160060,Yes
NCET,Electrical and Electronics Engineering,COMEDK,2024,229338,79716,16049,19730,344833,325103,Yes
JSSSTU,Biotechnology,KCET,2023,72062,79512,16075,15772,183421,167649,Yes
SJBIT,Chemical Engineering,COMEDK,2023,219838,88289,9275,27750,345152,317402,No
SJBCE,Information Science and Engineering,COMEDK,2023,227533,94533,11911,12059,346036,333977,Yes
PESU,Robotics and Automation Engineering,COMEDK,2024,165880,73081,14567,16355,269883,253528,No
SDMCET,Data Science,KCET,2023,63175,94485,16599,26079,200338,174259,Yes
BITM,Computer Science and Engineering,KCET,2023,77938,83521,12499,19443,193401,173958,Yes
RIT,Biotechnology,KCET,2024,80922,84443,16145,14602,196112,181510,No
AEC,Mechanical Engineering,COMEDK,2024,188905,93231,12616,27888,322640,294752,No
REVA,Artificial Intelligence and Data Science,COMEDK,2024,180626,77208,19401,25927,303162,277235,No
KSIT,Artificial Intelligence and Data Science,KCET,2024,59784,84128,18897,22641,185450,162809,Yes
VVCE,Electronics and Communication Engineering,COMEDK,2023,169697,89728,11292,19326,290043,270717,No
GIT,Biotechnology,KCET,2023,73154,63051,14369,26687,177261,150574,No
NMIT,Information Science and Engineering,COMEDK,2023,249771,93865,9996,19166,372798,353632,No
MSRIT,Information Science and Engineering,KCET,2023,83967,60692,18308,11150,174117,162967,Yes
DSATM,Information Science and Engineering,COMEDK,2024,177960,88249,19312,20255,305776,285521,No
MSRIT,Electrical and Electronics Engineering,KCET,2023,84584,67443,16731,26007,194765,168758,Yes
VSM,Electronics and Communication Engineering,COMEDK,2024,176710,62502,8447,25386,273045,247659,No
ACU,Data Science,KCET,2023,70898,92335,12158,13156,188547,175391,Yes
SCEM,Aerospace Engineering,COMEDK,2023,179331,92196,15917,25164,312608,287444,Yes
NHCE,Computer Science and Engineering,KCET,2024,59733,73983,13088,18168,164972,146804,No
VemanaIT,Information Science and Engineering,KCET,2024,52707,93111,16990,19144,181952,162808,Yes
NCET,Biotechnology,COMEDK,2023,240581,77858,15496,18224,352159,333935,No
VVCE,Mechanical Engineering,KCET,2023,75300,65386,10099,13890,164675,150785,No
RNSIT,Artificial Intelligence and Data Science,KCET,2024,80409,89507,16214,29182,215312,186130,Yes
MSRUAS,Civil Engineering,COMEDK,2024,246201,71925,14300,28563,360989,332426,Yes
AIT,Mechanical Engineering,COMEDK,2023,220454,78885,9102,20277,328718,308441,Yes
BITM,Aerospace Engineering,COMEDK,2024,225157,63354,15237,24356,328104,303748,Yes
MVJCE,Data Science,KCET,2023,64402,90315,13039,15619,183375,167756,No
AEC,Biotechnology,KCET,2024,56855,81611,11140,18431,168037,149606,Yes
VVIT,Aerospace Engineering,KCET,2024,55063,75174,8493,22979,161709,138730,Yes
AEC,Computer Science and Engineering,KCET,2023,78438,86572,13878,19177,198065,178888,No
HKBK,Robotics and Automation Engineering,COMEDK,2023,235563,70393,14170,23109,343235,320126,No
PESCE,Mechanical Engineering,COMEDK,2023,189929,92912,16858,24369,324068,299699,Yes
AECMandya,Information Science and Engineering,KCET,2024,52129,64580,10564,13131,140404,127273,Yes
SITM,Electrical and Electronics Engineering,KCET,2023,66953,75337,13922,25874,182086,156212,Yes
VVCE,Biotechnology,KCET,2023,61606,72350,17329,15833,167118,151285,No
NHCE,Artificial Intelligence and Data Science,COMEDK,2024,178373,75261,10661,28589,292884,264295,No
AIT,Artificial Intelligence and Data Science,KCET,2023,54623,76479,9576,29872,170550,140678,No
VSM,Mechanical Engineering,KCET,2023,84593,73970,13869,25268,197700,172432,No
VVCE,Computer Science and Engineering,KCET,2024,63857,67697,8302,27985,167841,139856,Yes
GMIT,Electronics and Communication Engineering,COMEDK,2024,220443,85505,9922,21225,337095,315870,No
UVCE,Electronics and Communication Engineering,COMEDK,2023,249027,70794,17550,27372,364743,337371,Yes
SJBIT,Artificial Intelligence and Data Science,KCET,2023,74654,91374,14300,23858,204186,180328,No
VIT,Biotechnology,KCET,2024,64137,70731,16555,13609,165032,151423,Yes
GIT,Aerospace Engineering,COMEDK,2023,176247,91115,17606,25368,310336,284968,Yes
SITM,Robotics and Automation Engineering,COMEDK,2023,208093,92614,9155,23065,332927,309862,No
VemanaIT,Electrical and Electronics Engineering,COMEDK,2024,194734,90412,19124,27029,331299,304270,No
AIT,Aerospace Engineering,KCET,2023,75398,60713,13729,24015,173855,149840,Yes
SDMIT,Data Science,COMEDK,2024,239056,88983,17208,18281,363528,345247,Yes
REVA,Chemical Engineering,COMEDK,2023,248766,65145,14166,26566,354643,328077,No
MSRIT,Artificial Intelligence and Data Science,COMEDK,2023,248403,76843,18362,13484,357092,343608,No
PESCE,Aerospace Engineering,KCET,2023,82270,87161,8203,20365,197999,177634,No
BITM,Information Science and Engineering,KCET,2023,76990,60093,19869,23221,180173,156952,Yes
VVCE,Mechanical Engineering,COMEDK,2024,184078,65184,10278,23095,282635,259540,No
VemanaIT,Electronics and Communication Engineering,KCET,2024,68297,89824,17734,10030,185885,175855,No
SJBIT,Data Science,COMEDK,2024,248707,87960,18143,22944,377754,354810,No
AECMandya,Biotechnology,COMEDK,2023,169271,87140,16475,18866,291752,272886,No
BIT,Computer Science and Engineering,KCET,2024,56337,79655,14230,16083,166305,150222,Yes
SDMCET,Biotechnology,COMEDK,2024,182506,63919,18335,10627,275387,264760,No
NMIT,Mechanical Engineering,KCET,2024,66546,67360,16902,19185,169993,150808,Yes
KSIT,Aerospace Engineering,COMEDK,2024,229865,83329,9933,20705,343832,323127,No
PESCE,Information Science and Engineering,KCET,2024,52315,93117,8058,29651,183141,153490,Yes
SDMIT,Robotics and Automation Engineering,KCET,2023,79994,83509,14832,14109,192444,178335,No
SIT,Mechanical Engineering,KCET,2024,68352,78731,11928,19051,178062,159011,Yes
VIT,Mechanical Engineering,KCET,2023,54985,83496,10901,14359,163741,149382,Yes
DSATM,Civil Engineering,COMEDK,2023,195227,80207,10566,22091,308091,286000,Yes
NIE,Robotics and Automation Engineering,KCET,2023,68304,73673,9460,19868,171305,151437,No
AEC,Information Science and Engineering,COMEDK,2024,195349,65239,19281,10447,290316,279869,Yes
VIT,Data Science,KCET,2024,58637,73774,14616,16632,163659,147027,Yes
AECMandya,Robotics and Automation Engineering,KCET,2024,54303,64896,12440,23335,154974,131639,No
VVIT,Chemical Engineering,COMEDK,2024,174203,72737,10397,22905,280242,257337,Yes
VVCE,Robotics and Automation Engineering,COMEDK,2023,243255,86189,13462,15040,357946,342906,Yes
EastPoint,Computer Science and Engineering,KCET,2023,73222,78300,14855,16788,183165,166377,Yes
JSSSTU,Aerospace Engineering,COMEDK,2023,189800,70120,14834,12419,287173,274754,Yes
PESU,Computer Science and Engineering,KCET,2023,60264,63508,10030,12562,146364,133802,No
YKCE,Civil Engineering,KCET,2024,73056,74224,8073,23163,178516,155353,Yes
DSATM,Artificial Intelligence and Data Science,KCET,2023,79598,81404,15578,17764,194344,176580,Yes
RVCE,Information Science and Engineering,KCET,2023,65772,60373,10553,18056,154754,136698,No
RIT,Biotechnology,KCET,2023,68954,87812,19863,23881,200510,176629,No
BITM,Civil Engineering,COMEDK,2024,211796,62031,19304,18745,311876,293131,No
DSATM,Data Science,COMEDK,2023,211546,86383,17253,23776,338958,315182,No
PESU,Biotechnology,KCET,2023,83451,82572,18978,28798,213799,185001,Yes
DrAIT,Data Science,COMEDK,2024,235622,87225,16634,20200,359681,339481,No
SJBIT,Electronics and Communication Engineering,KCET,2023,57407,82693,19307,16453,175860,159407,No
VIT,Computer Science and Engineering,COMEDK,2024,212611,94667,15927,23144,346349,323205,No
CITGubbi,Data Science,KCET,2024,60642,77138,9951,18190,165921,147731,Yes
UVCE,Biotechnology,COMEDK,2023,190085,74800,17825,11143,293853,282710,Yes
DSCE,Electrical and Electronics Engineering,COMEDK,2024,184019,92384,8399,13026,297828,284802,Yes
VemanaIT,Artificial Intelligence and Data Science,COMEDK,2024,228324,65641,12628,14521,321114,306593,Yes
SDMCET,Data Science,KCET,2024,70444,90990,9483,17771,188688,170917,No
NMIT,Chemical Engineering,COMEDK,2024,207671,62918,17225,19425,307239,287814,No
AIT,Electrical and Electronics Engineering,COMEDK,2023,210207,66926,17840,11072,306045,294973,Yes
CMRIT,Chemical Engineering,COMEDK,2024,237172,77332,13363,19461,347328,327867,Yes
VemanaIT,Robotics and Automation Engineering,COMEDK,2023,161578,94387,19456,21102,296523,275421,No
MSRIT,Biotechnology,KCET,2024,52255,79574,19797,24103,175729,151626,No
BNMIT,Electronics and Communication Engineering,COMEDK,2024,249286,71455,18921,24033,363695,339662,Yes
VIT,Information Science and Engineering,COMEDK,2023,227386,84011,11091,10596,333084,322488,No
NIE,Mechanical Engineering,COMEDK,2023,242051,70074,10285,15805,338215,322410,Yes
PRES,Mechanical Engineering,COMEDK,2023,183248,75095,8854,21631,288828,267197,No
SIT,Chemical Engineering,KCET,2024,61819,76358,19374,18469,176020,157551,Yes
RVUNIV,Computer Science and Engineering,COMEDK,2023,248067,78164,12507,16553,355291,338738,No
REVA,Electrical and Electronics Engineering,KCET,2024,55317,81816,18931,18187,174251,156064,Yes
BIT,Computer Science and Engineering,KCET,2024,71808,94803,12054,26401,205066,178665,No
AITM,Information Science and Engineering,COMEDK,2024,206399,62155,12539,27152,308245,281093,Yes
NCET,Information Science and Engineering,COMEDK,2023,166400,82286,19774,22863,291323,268460,No
SIT,Electronics and Communication Engineering,COMEDK,2024,166890,60279,8882,22358,258409,236051,Yes
KSIT,Data Science,KCET,2024,77964,69417,9833,20100,177314,157214,Yes
GIT,Information Science and Engineering,KCET,2023,76626,86786,19170,14344,196926,182582,No
PRES,Biotechnology,COMEDK,2023,239756,91965,8270,21878,361869,339991,Yes
VVCE,Aerospace Engineering,COMEDK,2024,209743,79458,13255,26891,329347,302456,No
JSSSTU,Civil Engineering,COMEDK,2023,212898,89840,18069,23821,344628,320807,Yes
BIT,Electrical and Electronics Engineering,KCET,2024,52616,89786,13981,14384,170767,156383,No
CITGubbi,Electronics and Communication Engineering,COMEDK,2024,169413,75945,18029,26018,289405,263387,No
PESU,Biotechnology,COMEDK,2023,173960,90778,17127,14198,296063,281865,Yes
DBIT,Artificial Intelligence and Data Science,COMEDK,2024,240119,94549,14495,21560,370723,349163,No
DSCE,Electrical and Electronics Engineering,KCET,2024,83244,71212,11508,15028,180992,165964,No
KLEIT,Electrical and Electronics Engineering,COMEDK,2023,239171,86975,16419,15697,358262,342565,No
RAIT,Information Science and Engineering,COMEDK,2024,240628,82762,13980,22078,359448,337370,No
BITM,Computer Science and Engineering,COMEDK,2024,239314,88491,16879,28065,372749,344684,No
REVA,Electrical and Electronics Engineering,COMEDK,2024,186928,84701,13405,17615,302649,285034,Yes
HKBK,Civil Engineering,COMEDK,2024,164272,83990,11514,16793,276569,259776,Yes
UVCE,Robotics and Automation Engineering,KCET,2023,64856,91376,10981,22940,190153,167213,No
RAIT,Aerospace Engineering,COMEDK,2024,166045,84714,17923,26766,295448,268682,No
RNSIT,Data Science,KCET,2023,55140,80746,10280,14692,160858,146166,Yes
RAIT,Data Science,KCET,2024,77796,93076,9260,24866,204998,180132,Yes
JIT,Aerospace Engineering,COMEDK,2024,213716,79734,15109,18117,326676,308559,Yes
HKBK,Chemical Engineering,COMEDK,2024,231587,87762,8851,11010,339210,328200,Yes
MSRIT,Electrical and Electronics Engineering,COMEDK,2024,219024,77261,9033,26800,332118,305318,No
DBIT,Computer Science and Engineering,COMEDK,2023,196080,76143,16662,20468,309353,288885,Yes
SITM,Electrical and Electronics Engineering,COMEDK,2024,215174,94168,17991,13776,341109,327333,Yes
EastPoint,Mechanical Engineering,COMEDK,2023,224978,70306,9595,16550,321429,304879,No
RIT,Civil Engineering,KCET,2024,58692,72735,8238,21321,160986,139665,Yes
VVCE,Electrical and Electronics Engineering,KCET,2023,78317,72438,8693,21118,180566,159448,No
CMRIT,Mechanical Engineering,COMEDK,2024,222249,79087,13013,17176,331525,314349,Yes
KLEIT,Biotechnology,COMEDK,2024,225979,66287,9380,22897,324543,301646,No
JSSSTU,Electrical and Electronics Engineering,KCET,2023,66343,73978,12959,28059,181339,153280,Yes
REVA,Information Science and Engineering,KCET,2023,75140,78671,13828,25013,192652,167639,Yes
GIT,Biotechnology,COMEDK,2023,171855,79947,16067,18966,286835,267869,No
PRES,Computer Science and Engineering,COMEDK,2024,232011,74425,9261,12648,328345,315697,Yes
VIT,Robotics and Automation Engineering,KCET,2023,68452,60905,13323,26628,169308,142680,No
VVIT,Data Science,KCET,2024,60825,70981,19840,21487,173133,151646,No
ACU,Electrical and Electronics Engineering,KCET,2024,80685,79894,8072,16731,185382,168651,Yes
ACU,Electronics and Communication Engineering,KCET,2024,68584,86432,13885,11277,180178,168901,Yes
RVUNIV,Biotechnology,KCET,2024,80131,67185,10473,16064,173853,157789,Yes
PESU,Aerospace Engineering,KCET,2024,68221,63871,13292,21017,166401,145384,Yes
SDMCET,Artificial Intelligence and Data Science,KCET,2024,77802,82888,16345,27399,204434,177035,Yes
SIT,Information Science and Engineering,KCET,2024,69336,82905,19522,29697,201460,171763,No
GMIT,Aerospace Engineering,COMEDK,2023,228516,90891,19750,10692,349849,339157,No
VIT,Aerospace Engineering,COMEDK,2023,163262,72487,15335,25964,277048,251084,No
KSIT,Electronics and Communication Engineering,KCET,2024,53945,73935,16149,23898,167927,144029,Yes
CITGubbi,Computer Science and Engineering,KCET,2024,53586,86421,12057,10717,162781,152064,Yes
JSSSTU,Chemical Engineering,KCET,2023,73039,93827,12481,14721,194068,179347,No
SITM,Mechanical Engineering,KCET,2024,76083,63441,16951,11530,168005,156475,Yes
GMIT,Information Science and Engineering,COMEDK,2023,199172,94153,10945,15557,319827,304270,Yes
SIT,Chemical Engineering,KCET,2024,79659,78951,18287,11808,188705,176897,No
NMIT,Biotechnology,KCET,2023,50828,60337,14599,13124,138888,125764,No
DBIT,Electrical and Electronics Engineering,COMEDK,2023,180516,75367,19835,10613,286331,275718,Yes
SJBCE,Data Science,KCET,2023,77710,79185,14514,17725,189134,171409,Yes
AITM,Data Science,COMEDK,2024,230266,64868,10063,28640,333837,305197,No
NCET,Chemical Engineering,KCET,2024,83984,90022,12088,14844,200938,186094,No
RVCE,Electrical and Electronics Engineering,KCET,2023,53396,67301,14835,20460,155992,135532,Yes
PESCE,Computer Science and Engineering,COMEDK,2024,245127,84053,16176,14830,360186,345356,Yes
AEC,Electronics and Communication Engineering,COMEDK,2023,248393,64903,9818,13250,336364,323114,Yes
GMIT,Electrical and Electronics Engineering,COMEDK,2024,200864,77263,13502,20523,312152,291629,Yes
EastPoint,Electronics and Communication Engineering,COMEDK,2024,187591,92513,11138,22372,313614,291242,No
MSRUAS,Electronics and Communication Engineering,COMEDK,2024,205752,71659,11189,19329,307929,288600,No
BMSCE,Artificial Intelligence and Data Science,COMEDK,2024,187464,72379,11878,18663,290384,271721,Yes
KLEIT,Aerospace Engineering,KCET,2023,64973,74809,11179,25889,176850,150961,Yes
BIT,Information Science and Engineering,COMEDK,2024,213001,78472,11575,19494,322542,303048,No
VIT,Computer Science and Engineering,COMEDK,2023,246512,88285,16459,17307,368563,351256,No
VVCE,Electronics and Communication Engineering,COMEDK,2023,195933,72028,9600,16428,293989,277561,Yes
RVCE,Electrical and Electronics Engineering,KCET,2024,59930,72416,9406,14212,155964,141752,No
RVUNIV,Mechanical Engineering,COMEDK,2023,226350,61238,13542,11398,312528,301130,No
RIT,Chemical Engineering,KCET,2024,75688,76888,9493,24148,186217,162069,Yes
NMIT,Aerospace Engineering,COMEDK,2024,217411,80434,15709,20859,334413,313554,No
KLSGIT,Artificial Intelligence and Data Science,COMEDK,2024,204790,68086,16869,11503,301248,289745,Yes
EastPoint,Mechanical Engineering,KCET,2023,74750,71067,10441,26009,182267,156258,Yes
GIT,Civil Engineering,KCET,2023,56145,92170,19510,26109,193934,167825,No
REVA,Data Science,COMEDK,2023,182424,93808,11136,19505,306873,287368,No
NIE,Computer Science and Engineering,KCET,2024,80045,84704,12888,26368,204005,177637,Yes
CMRIT,Civil Engineering,COMEDK,2024,179482,68734,17026,19479,284721,265242,Yes
DSCE,Data Science,KCET,2023,54680,69702,15321,27488,167191,139703,Yes
MVJCE,Information Science and Engineering,COMEDK,2023,241839,67599,8960,23552,341950,318398,Yes
DBIT,Artificial Intelligence and Data Science,KCET,2024,81506,66614,9222,26679,184021,157342,Yes
JNNCE,Biotechnology,KCET,2024,50675,61153,10292,23898,146018,122120,Yes
BIT,Artificial Intelligence and Data Science,KCET,2024,75628,65542,16046,17017,174233,157216,No
AIT,Civil Engineering,KCET,2024,83396,84450,10634,24243,202723,178480,Yes
YKCE,Data Science,COMEDK,2023,239656,72459,8564,16045,336724,320679,No
DSATM,Computer Science and Engineering,KCET,2024,73175,73212,17278,24983,188648,163665,No
BMSIT,Computer Science and Engineering,COMEDK,2024,201041,68735,12346,28853,310975,282122,No
PRES,Mechanical Engineering,KCET,2023,79779,92878,15040,21708,209405,187697,Yes
MSRUAS,Electronics and Communication Engineering,KCET,2024,75550,84763,8349,14159,182821,168662,Yes
SCEM,Data Science,KCET,2023,54256,74740,8859,26358,164213,137855,Yes
RIT,Information Science and Engineering,KCET,2023,68030,61913,8696,27805,166444,138639,Yes
CMRIT,Information Science and Engineering,COMEDK,2023,214917,68591,13773,15513,312794,297281,Yes
RIT,Computer Science and Engineering,COMEDK,2024,167688,63274,9124,24337,264423,240086,No
SIT,Artificial Intelligence and Data Science,COMEDK,2024,240811,63535,16554,17544,338444,320900,Yes
NCET,Aerospace Engineering,COMEDK,2023,242127,69458,16592,12717,340894,328177,Yes
JNNCE,Robotics and Automation Engineering,COMEDK,2024,187348,81553,14783,13915,297599,283684,No
NMIT,Chemical Engineering,COMEDK,2023,177578,61393,18673,22298,279942,257644,No
NIE,Biotechnology,KCET,2023,77490,91105,19301,21507,209403,187896,No
PESU,Chemical Engineering,KCET,2024,60955,71218,13408,24975,170556,145581,Yes
PESU,Electrical and Electronics Engineering,KCET,2024,66633,66180,16489,26880,176182,149302,Yes
SJBCE,Chemical Engineering,COMEDK,2024,166415,81812,11764,20980,280971,259991,No
BNMIT,Aerospace Engineering,KCET,2024,68521,63876,11557,17529,161483,143954,No
SDMIT,Data Science,KCET,2023,56993,76166,11685,27405,172249,144844,Yes
RNSIT,Electrical and Electronics Engineering,COMEDK,2023,247010,67196,16072,11020,341298,330278,No
JSSSTU,Robotics and Automation Engineering,COMEDK,2023,217623,65645,11621,25507,320396,294889,Yes
MVJCE,Artificial Intelligence and Data Science,KCET,2024,57501,90082,8123,12120,167826,155706,No
CITGubbi,Chemical Engineering,COMEDK,2023,226564,84791,16721,14337,342413,328076,No
PESCE,Data Science,KCET,2024,69249,69874,11628,12699,163450,150751,Yes
PESCE,Robotics and Automation Engineering,KCET,2023,71374,84640,14542,18097,188653,170556,Yes
KLSGIT,Civil Engineering,COMEDK,2024,219191,86858,13268,11450,330767,319317,No
PESU,Data Science,COMEDK,2023,202701,61270,15324,26225,305520,279295,No
BMSCE,Artificial Intelligence and Data Science,KCET,2024,58532,88009,18915,23165,188621,165456,No
KLSGIT,Mechanical Engineering,KCET,2024,61282,89401,15111,12156,177950,165794,Yes
VIT,Information Science and Engineering,KCET,2024,69362,74113,11965,15653,171093,155440,No
NHCE,Artificial Intelligence and Data Science,KCET,2024,59320,93817,13200,26468,192805,166337,No
MVJCE,Computer Science and Engineering,KCET,2024,84146,74019,10337,21510,190012,168502,Yes
KSIT,Computer Science and Engineering,KCET,2024,77407,77280,19661,20610,194958,174348,No
KLEIT,Biotechnology,KCET,2024,78141,60707,9953,22346,171147,148801,Yes
BMSIT,Artificial Intelligence and Data Science,KCET,2024,53674,78165,9560,11776,153175,141399,Yes
BIT,Artificial Intelligence and Data Science,COMEDK,2023,178986,79020,16246,25500,299752,274252,Yes
PESU,Computer Science and Engineering,COMEDK,2024,205541,80653,10192,15432,311818,296386,Yes
SJBIT,Artificial Intelligence and Data Science,KCET,2023,62496,90719,18885,12108,184208,172100,No
HKBK,Artificial Intelligence and Data Science,KCET,2024,80334,73941,15059,21433,190767,169334,No
AIT,Robotics and Automation Engineering,KCET,2023,67268,80115,18216,10024,175623,165599,No
BIT,Computer Science and Engineering,KCET,2023,63330,78083,18894,16451,176758,160307,No
ACU,Information Science and Engineering,COMEDK,2023,208007,94410,12077,25984,340478,314494,No
JIT,Data Science,KCET,2023,67209,75538,9552,14423,166722,152299,Yes
JSSSTU,Mechanical Engineering,KCET,2024,73848,67056,15615,25858,182377,156519,Yes
SITM,Artificial Intelligence and Data Science,KCET,2023,66531,79520,18569,11162,175782,164620,No
PESCE,Artificial Intelligence and Data Science,KCET,2024,63711,86975,8737,24019,183442,159423,Yes
ACU,Chemical Engineering,COMEDK,2024,176590,72845,14363,19187,282985,263798,Yes
SCEM,Mechanical Engineering,COMEDK,2023,167078,71962,18961,14427,272428,258001,No
BMSIT,Electrical and Electronics Engineering,KCET,2023,61478,64378,15364,29147,170367,141220,No
AECMandya,Civil Engineering,COMEDK,2023,249691,85288,13420,29564,377963,348399,Yes
MVJCE,Data Science,COMEDK,2024,212278,65404,8439,14446,300567,286121,No
DBIT,Civil Engineering,COMEDK,2023,227935,69995,19857,14880,332667,317787,Yes
MVJCE,Artificial Intelligence and Data Science,COMEDK,2024,188862,80068,8509,18709,296148,277439,Yes
CMRIT,Information Science and Engineering,COMEDK,2024,184882,84865,8103,11394,289244,277850,Yes
SIT,Aerospace Engineering,COMEDK,2023,202876,61102,19631,19305,302914,283609,No
BMIT,Mechanical Engineering,KCET,2023,57609,77175,17776,25292,177852,152560,Yes
GMIT,Electrical and Electronics Engineering,KCET,2024,71700,75145,11285,20725,178855,158130,No
UVCE,Biotechnology,KCET,2023,82474,83621,16503,27229,209827,182598,Yes
CMRIT,Computer Science and Engineering,COMEDK,2023,232604,76154,19914,17238,345910,328672,No
KLEIT,Biotechnology,COMEDK,2024,214876,87569,17019,27635,347099,319464,Yes
BIT,Computer Science and Engineering,KCET,2024,61491,75352,9032,11771,157646,145875,Yes
REVA,Robotics and Automation Engineering,KCET,2023,76715,79224,19612,19153,194704,175551,No
SCEM,Computer Science and Engineering,KCET,2024,74098,68208,19859,10183,172348,162165,Yes
ACU,Data Science,KCET,2023,75807,87255,18880,18851,200793,181942,Yes
SCEM,Robotics and Automation Engineering,COMEDK,2024,240347,65886,16266,10463,332962,322499,Yes
PRES,Biotechnology,KCET,2024,62861,86432,14324,23786,187403,163617,No
DrAIT,Electrical and Electronics Engineering,COMEDK,2023,192417,66849,9099,25990,294355,268365,No
SCEM,Biotechnology,KCET,2024,80682,77212,15906,20927,194727,173800,Yes
DSATM,Artificial Intelligence and Data Science,KCET,2024,50675,94119,16703,11561,173058,161497,No
RVUNIV,Chemical Engineering,COMEDK,2024,197046,82950,17537,15064,312597,297533,Yes
SDMIT,Chemical Engineering,KCET,2023,83572,68634,12144,25534,189884,164350,No
VVCE,Electrical and Electronics Engineering,COMEDK,2024,175518,73681,8598,27630,285427,257797,No
RNSIT,Mechanical Engineering,COMEDK,2024,184199,84858,16069,16094,301220,285126,No
RAIT,Electronics and Communication Engineering,COMEDK,2024,237909,94273,11985,10716,354883,344167,No
BNMIT,Computer Science and Engineering,COMEDK,2024,192314,84985,8397,19101,304797,285696,No
JNNCE,Mechanical Engineering,KCET,2024,55629,83229,10415,16750,166023,149273,Yes
DSATM,Biotechnology,COMEDK,2023,184039,88199,16826,12948,302012,289064,Yes
ACU,Computer Science and Engineering,KCET,2023,77692,90709,10827,18991,198219,179228,No
PESCE,Mechanical Engineering,COMEDK,2023,222856,83536,9477,29775,345644,315869,No
MVJCE,Aerospace Engineering,KCET,2023,55140,74594,10994,28537,169265,140728,Yes
SDMCET,Aerospace Engineering,KCET,2024,73059,85171,14683,27675,200588,172913,No
BNMIT,Data Science,KCET,2023,82031,69299,19572,26051,196953,170902,Yes
JNNCE,Information Science and Engineering,COMEDK,2023,231130,84526,13611,26558,355825,329267,Yes
SCEM,Robotics and Automation Engineering,COMEDK,2023,160943,71084,19101,17407,268535,251128,No
RAIT,Computer Science and Engineering,COMEDK,2024,187567,65708,14159,29754,297188,267434,Yes
SIT,Artificial Intelligence and Data Science,COMEDK,2024,217466,92339,9664,29417,348886,319469,No
MVJCE,Biotechnology,KCET,2023,80615,68947,9729,10402,169693,159291,No
JSSSTU,Aerospace Engineering,COMEDK,2024,209441,65335,10885,16627,302288,285661,Yes
AECMandya,Artificial Intelligence and Data Science,KCET,2023,54655,75471,19462,14277,163865,149588,No
VVCE,Electrical and Electronics Engineering,KCET,2023,66176,86688,15425,25726,194015,168289,Yes
PESCE,Electronics and Communication Engineering,COMEDK,2023,185259,63740,14544,21902,285445,263543,No
VVCE,Mechanical Engineering,COMEDK,2023,226988,94115,9105,15776,345984,330208,Yes
NIE,Mechanical Engineering,KCET,2023,61979,85696,19979,20234,187888,167654,Yes
AITM,Robotics and Automation Engineering,KCET,2024,76191,61276,14268,13048,164783,151735,No
PESCE,Electrical and Electronics Engineering,KCET,2024,69304,63405,15009,20394,168112,147718,Yes
SJBIT,Computer Science and Engineering,KCET,2023,60663,68992,19005,18951,167611,148660,Yes
JSSSTU,Computer Science and Engineering,KCET,2024,50157,83230,10255,23752,167394,143642,Yes
CMRIT,Electronics and Communication Engineering,COMEDK,2023,163619,92944,17054,20750,294367,273617,No
MSRIT,Data Science,KCET,2023,65933,61620,19371,26452,173376,146924,Yes
VVCE,Data Science,COMEDK,2024,200007,70686,14675,26403,311771,285368,Yes
CMRIT,Information Science and Engineering,COMEDK,2023,181362,66157,15398,22491,285408,262917,Yes
KSIT,Data Science,COMEDK,2023,181035,79149,10675,25911,296770,270859,Yes
VVIT,Robotics and Automation Engineering,KCET,2023,72402,84736,15948,11155,184241,173086,No
SITM,Electronics and Communication Engineering,COMEDK,2023,223859,74578,8115,25582,332134,306552,Yes
RVUNIV,Electrical and Electronics Engineering,COMEDK,2023,199775,81193,18827,27381,327176,299795,No
KLEIT,Biotechnology,COMEDK,2023,166741,84525,8916,15527,275709,260182,No
VVCE,Chemical Engineering,KCET,2023,82881,94952,16688,12859,207380,194521,No
PESCE,Aerospace Engineering,KCET,2023,83992,82023,9972,11924,187911,175987,No
AIT,Electronics and Communication Engineering,KCET,2023,70217,87493,12317,17845,187872,170027,No
RVUNIV,Artificial Intelligence and Data Science,KCET,2023,64263,76465,10369,28504,179601,151097,No
DrAIT,Aerospace Engineering,COMEDK,2023,197666,64401,15322,27496,304885,277389,No
NIE,Data Science,KCET,2024,73558,89496,14780,20863,198697,177834,Yes
BMSIT,Data Science,COMEDK,2024,200212,67896,11210,10772,290090,279318,Yes
AITM,Chemical Engineering,COMEDK,2024,197373,65817,19239,29339,311768,282429,No
BIT,Electronics and Communication Engineering,KCET,2023,73144,65914,16356,21018,176432,155414,Yes
SITM,Aerospace Engineering,COMEDK,2024,191046,86831,18495,27203,323575,296372,No
RNSIT,Mechanical Engineering,COMEDK,2024,221291,63234,8241,18603,311369,292766,Yes
JSSSTU,Electrical and Electronics Engineering,COMEDK,2024,192735,86765,15325,23681,318506,294825,No
RVUNIV,Robotics and Automation Engineering,COMEDK,2023,193070,93134,12523,28802,327529,298727,Yes
AECMandya,Computer Science and Engineering,COMEDK,2023,232783,80219,11748,17263,342013,324750,Yes
BMSCE,Electronics and Communication Engineering,KCET,2024,84902,73900,13129,29252,201183,171931,Yes
SDMCET,Electronics and Communication Engineering,KCET,2024,66479,78124,18788,18661,182052,163391,No
CITGubbi,Computer Science and Engineering,KCET,2024,79812,84038,11497,28802,204149,175347,No
NIE,Biotechnology,KCET,2024,61072,75804,19991,20320,177187,156867,No
DrAIT,Information Science and Engineering,KCET,2023,67408,68848,18113,15932,170301,154369,Yes
RVCE,Information Science and Engineering,COMEDK,2023,233127,77079,15561,11040,336807,325767,No
MSRIT,Robotics and Automation Engineering,KCET,2024,61304,78372,8577,27782,176035,148253,Yes
NHCE,Electrical and Electronics Engineering,KCET,2024,62662,69979,16611,22286,171538,149252,No
SJBIT,Civil Engineering,KCET,2024,50938,86121,14868,12487,164414,151927,No
DSCE,Mechanical Engineering,KCET,2024,80588,82332,14003,11429,188352,176923,Yes
NHCE,Computer Science and Engineering,COMEDK,2023,249604,70216,11967,19967,351754,331787,Yes
SITM,Artificial Intelligence and Data Science,COMEDK,2024,183268,76749,12882,21831,294730,272899,Yes
DrAIT,Electronics and Communication Engineering,COMEDK,2023,161928,71067,14957,16563,264515,247952,Yes
MSRUAS,Chemical Engineering,KCET,2024,66274,69661,16607,16721,169263,152542,Yes
VIT,Computer Science and Engineering,COMEDK,2023,163440,84196,18746,20786,287168,266382,No
VemanaIT,Chemical Engineering,COMEDK,2024,193829,73656,10727,17436,295648,278212,Yes
EastPoint,Data Science,KCET,2024,52795,77461,13203,29351,172810,143459,Yes
SJBIT,Civil Engineering,KCET,2023,58231,72077,9075,27801,167184,139383,Yes
JSSSTU,Data Science,COMEDK,2024,238325,94344,8512,15692,356873,341181,No
AECMandya,Artificial Intelligence and Data Science,COMEDK,2024,235090,78860,17354,17200,348504,331304,No
AITM,Chemical Engineering,KCET,2024,81481,72677,12502,21630,188290,166660,Yes
SIT,Artificial Intelligence and Data Science,KCET,2023,77860,70761,16656,12642,177919,165277,Yes
REVA,Data Science,KCET,2023,50510,61421,16737,22042,150710,128668,Yes
DSCE,Electronics and Communication Engineering,KCET,2023,62937,67656,15080,22837,168510,145673,Yes
REVA,Computer Science and Engineering,KCET,2024,80226,72835,15482,26886,195429,168543,Yes
PRES,Civil Engineering,COMEDK,2023,174108,76453,10491,16619,277671,261052,No
UVCE,Biotechnology,KCET,2023,56405,68666,12880,21175,159126,137951,Yes
VVCE,Civil Engineering,COMEDK,2024,226121,70572,10327,10105,317125,307020,Yes
GMIT,Information Science and Engineering,KCET,2024,67959,78368,11605,23701,181633,157932,No
KLEIT,Civil Engineering,COMEDK,2023,244431,81213,10459,11731,347834,336103,No
MSRUAS,Biotechnology,COMEDK,2024,200750,79618,10835,26200,317403,291203,No
BIT,Mechanical Engineering,KCET,2024,65455,81653,17550,14799,179457,164658,Yes
SJBIT,Information Science and Engineering,COMEDK,2023,228418,65976,16413,17522,328329,310807,No
NCET,Biotechnology,KCET,2024,77771,91491,12895,12698,194855,182157,No
VVCE,Electrical and Electronics Engineering,COMEDK,2023,220130,91154,17221,21376,349881,328505,Yes
NMIT,Data Science,KCET,2024,79434,75212,18052,22522,195220,172698,Yes
REVA,Mechanical Engineering,COMEDK,2023,234021,61978,8211,27212,331422,304210,Yes
EastPoint,Artificial Intelligence and Data Science,KCET,2024,83056,78940,8685,11073,181754,170681,Yes
CITGubbi,Chemical Engineering,COMEDK,2023,166203,89662,16789,19388,292042,272654,Yes
PRES,Biotechnology,COMEDK,2023,197197,91574,12667,20399,321837,301438,Yes
JIT,Mechanical Engineering,COMEDK,2024,249938,80543,8633,27791,366905,339114,Yes
VemanaIT,Data Science,COMEDK,2023,196460,93350,15762,24920,330492,305572,Yes
MSRIT,Data Science,COMEDK,2023,167988,79257,10102,12749,270096,257347,No
SJBIT,Chemical Engineering,KCET,2023,67153,83198,18049,10583,178983,168400,No
VemanaIT,Civil Engineering,COMEDK,2023,217828,75749,14907,29512,337996,308484,No
PRES,Artificial Intelligence and Data Science,KCET,2023,61478,88654,13919,13413,177464,164051,Yes
AEC,Chemical Engineering,COMEDK,2023,180746,87227,8497,22630,299100,276470,No
VemanaIT,Data Science,KCET,2023,81737,81365,8131,23557,194790,171233,Yes
SDMCET,Robotics and Automation Engineering,COMEDK,2023,214934,63507,16647,17500,312588,295088,No
SCEM,Civil Engineering,COMEDK,2024,182389,71383,11418,20559,285749,265190,No
VSM,Computer Science and Engineering,KCET,2023,50706,85529,17440,21520,175195,153675,Yes
GMIT,Civil Engineering,KCET,2024,77174,88237,19747,28529,213687,185158,Yes
REVA,Robotics and Automation Engineering,COMEDK,2023,165497,93605,15209,20681,294992,274311,Yes
MVJCE,Mechanical Engineering,KCET,2024,71686,79911,11191,12305,175093,162788,Yes
SCEM,Chemical Engineering,KCET,2023,51530,78404,15696,22561,168191,145630,No
BNMIT,Biotechnology,KCET,2024,69776,70098,8181,29162,177217,148055,Yes
REVA,Information Science and Engineering,KCET,2024,76153,64334,10429,23587,174503,150916,No
KLEIT,Civil Engineering,KCET,2023,55108,80215,11910,13246,160479,147233,Yes
BITM,Electrical and Electronics Engineering,KCET,2023,50161,64069,12424,17070,143724,126654,No
HKBK,Aerospace Engineering,KCET,2023,82919,91794,17946,16592,209251,192659,Yes
JSSSTU,Electronics and Communication Engineering,COMEDK,2024,242408,72845,11774,10305,337332,327027,No
YKCE,Electronics and Communication Engineering,KCET,2023,58180,67121,10753,21881,157935,136054,Yes
AEC,Data Science,COMEDK,2024,160077,66783,19708,25822,272390,246568,No
NMIT,Civil Engineering,COMEDK,2023,179966,90800,16362,16164,303292,287128,No
CMRIT,Chemical Engineering,COMEDK,2023,214004,65691,8825,22265,310785,288520,No
CMRIT,Computer Science and Engineering,COMEDK,2023,227983,86761,8991,27109,350844,323735,Yes
VemanaIT,Aerospace Engineering,KCET,2024,83032,64431,17773,29163,194399,165236,No
PRES,Biotechnology,KCET,2024,61372,64341,17414,17739,160866,143127,Yes
SITM,Artificial Intelligence and Data Science,KCET,2024,83460,82054,12291,27568,205373,177805,No
BITM,Civil Engineering,COMEDK,2023,175557,83789,13025,28833,301204,272371,No
SJBIT,Robotics and Automation Engineering,COMEDK,2024,187990,94132,12862,10869,305853,294984,Yes
SDMCET,Chemical Engineering,KCET,2024,78033,61059,16476,25567,181135,155568,No
RVUNIV,Data Science,COMEDK,2024,200795,81913,17869,15138,315715,300577,No
AIT,Mechanical Engineering,KCET,2023,69956,71906,12026,24939,178827,153888,No
JSSSTU,Civil Engineering,COMEDK,2024,243281,84213,9327,23690,360511,336821,Yes
DBIT,Data Science,COMEDK,2024,221986,86293,17685,24108,350072,325964,Yes
NHCE,Electrical and Electronics Engineering,KCET,2024,51018,85260,9088,25978,171344,145366,No
NIE,Mechanical Engineering,COMEDK,2024,211868,75976,19235,17394,324473,307079,Yes
VVIT,Civil Engineering,COMEDK,2024,194045,73620,15645,13504,296814,283310,No
VVIT,Civil Engineering,COMEDK,2023,169227,75040,19458,26848,290573,263725,Yes
RAIT,Robotics and Automation Engineering,KCET,2023,71585,86487,13330,22929,194331,171402,No
VSM,Civil Engineering,KCET,2024,81244,84741,13090,13548,192623,179075,Yes
CITGubbi,Civil Engineering,KCET,2024,82430,87901,11646,20837,202814,181977,No
DrAIT,Chemical Engineering,KCET,2024,84879,63331,19584,13370,181164,167794,No
SJBCE,Robotics and Automation Engineering,KCET,2023,80317,78161,17442,29838,205758,175920,No
SIT,Data Science,KCET,2023,58087,62180,13134,13226,146627,133401,Yes
VemanaIT,Mechanical Engineering,KCET,2024,53740,82403,15012,28044,179199,151155,No
KLEIT,Data Science,COMEDK,2024,198307,90558,12353,11180,312398,301218,No
AEC,Biotechnology,COMEDK,2023,167634,73908,11393,18338,271273,252935,Yes
SJBCE,Civil Engineering,KCET,2023,55881,90725,8413,25763,180782,155019,No
VIT,Computer Science and Engineering,KCET,2023,52539,62554,19876,14289,149258,134969,Yes
JSSSTU,Aerospace Engineering,KCET,2024,64363,79144,8452,24541,176500,151959,No
SITM,Aerospace Engineering,COMEDK,2024,229576,79058,17197,22535,348366,325831,Yes
GMIT,Mechanical Engineering,KCET,2023,68350,76586,12922,12652,170510,157858,Yes
VIT,Mechanical Engineering,KCET,2023,77101,88548,19343,25625,210617,184992,No
DSATM,Biotechnology,COMEDK,2023,247977,74624,15084,13260,350945,337685,No
BMSIT,Computer Science and Engineering,KCET,2023,60644,91262,15497,28236,195639,167403,No
JIT,Artificial Intelligence and Data Science,KCET,2024,82052,74673,18700,18138,193563,175425,Yes
KLEIT,Electrical and Electronics Engineering,COMEDK,2024,216631,70950,17632,23993,329206,305213,Yes
MSRUAS,Robotics and Automation Engineering,KCET,2023,72096,86149,19628,27822,205695,177873,Yes
SCEM,Electrical and Electronics Engineering,KCET,2024,83086,91305,18662,13867,206920,193053,Yes
VIT,Robotics and Automation Engineering,KCET,2024,52786,64238,9370,27006,153400,126394,Yes
NMIT,Robotics and Automation Engineering,KCET,2024,71951,74834,14842,12053,173680,161627,No
RIT,Electronics and Communication Engineering,KCET,2024,77310,94753,12964,17017,202044,185027,No
JSSSTU,Artificial Intelligence and Data Science,COMEDK,2023,244269,69795,9179,10966,334209,323243,No
SDMIT,Computer Science and Engineering,KCET,2023,56602,91169,13862,11361,172994,161633,Yes
JNNCE,Mechanical Engineering,COMEDK,2023,248964,67305,13176,23408,352853,329445,Yes
REVA,Electronics and Communication Engineering,COMEDK,2024,214359,81803,11039,19865,327066,307201,No
KSIT,Civil Engineering,KCET,2024,51543,62543,15882,15665,145633,129968,Yes
NIE,Mechanical Engineering,COMEDK,2023,180451,88152,18011,19354,305968,286614,Yes
MVJCE,Electronics and Communication Engineering,COMEDK,2024,216473,89078,10737,26784,343072,316288,Yes
BMIT,Computer Science and Engineering,COMEDK,2023,203765,86727,18816,19806,329114,309308,Yes
BITM,Computer Science and Engineering,COMEDK,2024,186405,72566,12704,12727,284402,271675,No
PRES,Chemical Engineering,KCET,2023,72732,94518,10861,13147,191258,178111,No
RNSIT,Civil Engineering,COMEDK,2024,246641,61837,11389,29519,349386,319867,No
BMSCE,Artificial Intelligence and Data Science,KCET,2023,64172,73432,9290,25710,172604,146894,No
RVUNIV,Electronics and Communication Engineering,COMEDK,2023,221277,79420,12617,23190,336504,313314,No
AITM,Electrical and Electronics Engineering,COMEDK,2023,205132,86470,11077,21326,324005,302679,Yes
DBIT,Computer Science and Engineering,COMEDK,2023,168492,82141,15555,28712,294900,266188,No
AEC,Civil Engineering,KCET,2024,68068,88125,19716,16983,192892,175909,Yes
REVA,Electrical and Electronics Engineering,KCET,2023,64735,92827,9359,19000,185921,166921,No
DrAIT,Electrical and Electronics Engineering,COMEDK,2023,176781,94429,9180,15938,296328,280390,No
RVUNIV,Electronics and Communication Engineering,COMEDK,2023,173565,88507,12371,22592,297035,274443,No
JSSSTU,Biotechnology,KCET,2023,79425,61457,9036,26044,175962,149918,No
RAIT,Computer Science and Engineering,COMEDK,2023,199895,60716,10260,21972,292843,270871,Yes
PESU,Electrical and Electronics Engineering,KCET,2023,67590,94681,12832,20592,195695,175103,Yes
CITGubbi,Biotechnology,COMEDK,2023,177837,91041,12082,26753,307713,280960,Yes
SIT,Computer Science and Engineering,KCET,2023,72281,73550,15984,16069,177884,161815,No
NIE,Electrical and Electronics Engineering,COMEDK,2024,202458,64913,17637,28362,313370,285008,Yes
SIT,Robotics and Automation Engineering,KCET,2023,76111,70032,13854,14139,174136,159997,No
AEC,Civil Engineering,COMEDK,2024,234493,84943,14313,23874,357623,333749,No
VIT,Electrical and Electronics Engineering,KCET,2024,69333,71735,9510,10400,160978,150578,No
SJBCE,Civil Engineering,COMEDK,2024,231574,69957,8645,29953,340129,310176,No
SIT,Mechanical Engineering,COMEDK,2024,168246,89100,18544,16169,292059,275890,Yes
BNMIT,Mechanical Engineering,KCET,2023,55666,67841,15787,27274,166568,139294,Yes
RNSIT,Electrical and Electronics Engineering,COMEDK,2023,236033,71615,12373,19596,339617,320021,Yes
VSM,Electrical and Electronics Engineering,KCET,2023,64045,69220,8505,22815,164585,141770,No
KLEIT,Robotics and Automation Engineering,KCET,2024,54385,72326,9265,25807,161783,135976,No
MVJCE,Aerospace Engineering,KCET,2023,60755,74301,10682,19114,164852,145738,No
SJBIT,Information Science and Engineering,COMEDK,2024,229737,80329,17907,18515,346488,327973,Yes
JNNCE,Electrical and Electronics Engineering,COMEDK,2024,170755,86204,8150,26031,291140,265109,No
RIT,Mechanical Engineering,COMEDK,2024,200579,86569,13285,25203,325636,300433,No
SJBCE,Data Science,KCET,2023,60021,63932,14786,19127,157866,138739,No
NHCE,Data Science,KCET,2024,52259,85822,12505,28838,179424,150586,Yes
BMSCE,Electrical and Electronics Engineering,KCET,2023,70060,67174,15725,10400,163359,152959,No
YKCE,Data Science,COMEDK,2023,212168,63823,16771,23502,316264,292762,No
CMRIT,Electronics and Communication Engineering,KCET,2024,75832,62001,9718,29674,177225,147551,No
VemanaIT,Robotics and Automation Engineering,KCET,2023,64837,62059,17139,29623,173658,144035,No
KLSGIT,Information Science and Engineering,COMEDK,2023,196420,74109,18626,27087,316242,289155,No
KSIT,Computer Science and Engineering,KCET,2023,82132,78076,19921,14057,194186,180129,Yes
PESU,Data Science,KCET,2023,57944,74614,17154,21630,171342,149712,No
NIE,Information Science and Engineering,KCET,2023,61943,83384,18751,13594,177672,164078,No
BMIT,Computer Science and Engineering,KCET,2024,82874,64869,17368,13025,178136,165111,No
KLEIT,Computer Science and Engineering,KCET,2024,70519,61031,13757,23857,169164,145307,Yes
BMSCE,Data Science,COMEDK,2023,183017,73240,19102,20796,296155,275359,No
YKCE,Aerospace Engineering,COMEDK,2024,200801,63307,10166,14393,288667,274274,Yes
KLSGIT,Artificial Intelligence and Data Science,COMEDK,2024,223978,81786,18287,11404,335455,324051,No
MSRIT,Data Science,COMEDK,2024,247328,88273,12188,23660,371449,347789,Yes
DrAIT,Artificial Intelligence and Data Science,COMEDK,2023,221223,90128,11558,15705,338614,322909,No
AECMandya,Electronics and Communication Engineering,COMEDK,2024,234650,62995,18018,21344,337007,315663,Yes
RIT,Artificial Intelligence and Data Science,COMEDK,2023,176356,66778,15220,15871,274225,258354,No
AITM,Electrical and Electronics Engineering,COMEDK,2024,162490,62438,18300,24896,268124,243228,Yes
JIT,Data Science,COMEDK,2024,208193,77434,19621,22974,328222,305248,Yes
NIE,Electronics and Communication Engineering,COMEDK,2023,238325,71981,8319,29843,348468,318625,No
AIT,Robotics and Automation Engineering,COMEDK,2024,217003,64789,14304,23236,319332,296096,No
CMRIT,Electronics and Communication Engineering,COMEDK,2023,218673,75332,12366,27458,333829,306371,Yes
AEC,Artificial Intelligence and Data Science,KCET,2023,84405,87367,17120,27839,216731,188892,Yes
CITGubbi,Electronics and Communication Engineering,COMEDK,2024,202987,75404,19652,27116,325159,298043,No
GIT,Computer Science and Engineering,COMEDK,2024,221223,64417,12711,12525,310876,298351,No
KLEIT,Information Science and Engineering,COMEDK,2024,235277,71101,9092,22158,337628,315470,Yes
RAIT,Electronics and Communication Engineering,KCET,2024,61237,85028,14649,22501,183415,160914,Yes
GIT,Data Science,COMEDK,2024,242005,87481,14024,17665,361175,343510,No
SJBCE,Mechanical Engineering,COMEDK,2024,198990,77367,18600,15608,310565,294957,Yes
HKBK,Aerospace Engineering,COMEDK,2024,221267,68595,8741,13467,312070,298603,Yes
BIT,Biotechnology,COMEDK,2024,187121,63770,9585,10184,270660,260476,No
AECMandya,Biotechnology,COMEDK,2024,210427,80341,9309,23540,323617,300077,Yes
GIT,Civil Engineering,COMEDK,2023,243379,76763,16533,15440,352115,336675,Yes
HKBK,Electrical and Electronics Engineering,COMEDK,2023,176869,84100,9769,18142,288880,270738,Yes
DrAIT,Biotechnology,COMEDK,2024,228444,75741,12197,25546,341928,316382,Yes
NHCE,Biotechnology,KCET,2023,82434,68654,17375,11592,180055,168463,No
RVCE,Mechanical Engineering,KCET,2024,67529,84646,12001,19372,183548,164176,No
AECMandya,Computer Science and Engineering,KCET,2023,72392,81394,15695,17706,187187,169481,No
NHCE,Computer Science and Engineering,KCET,2023,65103,87905,18099,13619,184726,171107,No
KLEIT,Civil Engineering,COMEDK,2023,233984,78462,8738,13531,334715,321184,Yes
KSIT,Mechanical Engineering,KCET,2023,77581,60175,14734,17312,169802,152490,Yes
VVCE,Mechanical Engineering,COMEDK,2024,224954,81745,11147,26629,344475,317846,No
MSRIT,Artificial Intelligence and Data Science,COMEDK,2023,194650,64676,8474,24836,292636,267800,Yes
DrAIT,Electronics and Communication Engineering,COMEDK,2023,181632,66013,12477,11244,271366,260122,Yes
JIT,Computer Science and Engineering,KCET,2024,72918,87065,14966,27323,202272,174949,Yes
RAIT,Electronics and Communication Engineering,COMEDK,2023,198667,73683,12754,19616,304720,285104,Yes
GIT,Information Science and Engineering,COMEDK,2023,166867,76614,14315,15507,273303,257796,No
EastPoint,Data Science,KCET,2023,70402,68940,10057,21990,171389,149399,No
RAIT,Aerospace Engineering,COMEDK,2023,199161,67115,8040,17434,291750,274316,No
BMSIT,Artificial Intelligence and Data Science,KCET,2023,69866,94525,8708,28301,201400,173099,Yes
NIE,Chemical Engineering,COMEDK,2023,212479,68770,18666,20380,320295,299915,No
BMIT,Robotics and Automation Engineering,COMEDK,2023,246890,82091,19263,12453,360697,348244,No
SJBIT,Electronics and Communication Engineering,COMEDK,2023,192949,75599,19029,18227,305804,287577,Yes
BMSIT,Data Science,KCET,2024,52059,80714,8096,25166,166035,140869,Yes
SIT,Aerospace Engineering,COMEDK,2024,164825,84161,12063,19851,280900,261049,Yes
VSM,Electrical and Electronics Engineering,COMEDK,2024,160105,84618,11819,14349,270891,256542,Yes
HKBK,Electronics and Communication Engineering,COMEDK,2024,164360,86034,14212,17623,282229,264606,No
SDMIT,Mechanical Engineering,KCET,2023,84693,72799,19501,12144,189137,176993,No
BITM,Aerospace Engineering,COMEDK,2024,200840,66444,11202,26607,305093,278486,Yes
JIT,Electrical and Electronics Engineering,KCET,2024,68222,84469,10348,25080,188119,163039,Yes
RVUNIV,Electrical and Electronics Engineering,COMEDK,2024,173378,86216,19695,24298,303587,279289,Yes
YKCE,Mechanical Engineering,COMEDK,2023,240903,63968,10681,27774,343326,315552,No
DrAIT,Civil Engineering,COMEDK,2023,220559,78991,13470,21931,334951,313020,Yes
VIT,Information Science and Engineering,KCET,2023,71626,70981,12353,26095,181055,154960,No
BIT,Robotics and Automation Engineering,COMEDK,2024,179835,75233,9933,23152,288153,265001,Yes
HKBK,Biotechnology,COMEDK,2023,224729,70361,8266,20009,323365,303356,No
PESCE,Robotics and Automation Engineering,COMEDK,2023,237245,85005,18695,19348,360293,340945,No
JNNCE,Data Science,COMEDK,2024,231215,69154,14341,12474,327184,314710,No
DrAIT,Civil Engineering,COMEDK,2023,239456,84644,19219,16348,359667,343319,No
AIT,Data Science,KCET,2023,81739,94123,10769,11150,197781,186631,Yes
BIT,Mechanical Engineering,COMEDK,2023,221093,70277,16642,18392,326404,308012,No
HKBK,Computer Science and Engineering,COMEDK,2024,203549,75572,19270,15177,313568,298391,No
CITGubbi,Chemical Engineering,KCET,2024,78841,85279,9788,17468,191376,173908,No
AITM,Computer Science and Engineering,KCET,2023,57964,65803,15626,23559,162952,139393,Yes
DBIT,Robotics and Automation Engineering,COMEDK,2024,175338,61835,10971,14532,262676,248144,No
NCET,Aerospace Engineering,KCET,2023,74565,87771,11175,19654,193165,173511,No
YKCE,Chemical Engineering,KCET,2023,74293,77685,14034,20349,186361,166012,No
REVA,Data Science,KCET,2024,51716,93668,19207,10675,175266,164591,Yes
SJBCE,Electronics and Communication Engineering,COMEDK,2024,185006,77078,9939,26333,298356,272023,No
EastPoint,Electronics and Communication Engineering,KCET,2024,84571,63963,18644,18159,185337,167178,No
SJBCE,Electronics and Communication Engineering,KCET,2024,64829,68468,16231,22913,172441,149528,No
DBIT,Electrical and Electronics Engineering,KCET,2023,76903,92801,19485,24004,213193,189189,No
KSIT,Computer Science and Engineering,KCET,2023,63614,78081,10773,21247,173715,152468,Yes
CITGubbi,Biotechnology,COMEDK,2023,247193,78854,8164,21366,355577,334211,No
JSSSTU,Civil Engineering,COMEDK,2024,232583,76037,15269,20179,344068,323889,No
RVCE,Computer Science and Engineering,COMEDK,2024,217132,74684,19396,14165,325377,311212,No
CITGubbi,Electrical and Electronics Engineering,COMEDK,2023,172685,78967,14156,24462,290270,265808,Yes
NHCE,Electronics and Communication Engineering,KCET,2023,64808,92141,10649,21841,189439,167598,No
SITM,Aerospace Engineering,COMEDK,2023,243128,78864,11740,20683,354415,333732,Yes
PESCE,Data Science,KCET,2024,75134,85353,14449,15828,190764,174936,No
DBIT,Artificial Intelligence and Data Science,KCET,2024,70888,69458,16167,29679,186192,156513,No
DrAIT,Civil Engineering,KCET,2024,82611,76483,18674,29551,207319,177768,No
PESU,Artificial Intelligence and Data Science,KCET,2024,76769,85619,8809,10544,181741,171197,No
VSM,Chemical Engineering,COMEDK,2023,172890,80994,13453,25985,293322,267337,Yes
GMIT,Electronics and Communication Engineering,COMEDK,2024,245000,64106,8349,20630,338085,317455,Yes
NHCE,Computer Science and Engineering,COMEDK,2024,208143,67242,9282,24476,309143,284667,Yes
MSRIT,Data Science,KCET,2024,53782,69720,19087,28285,170874,142589,Yes
JIT,Mechanical Engineering,COMEDK,2024,160133,61577,18240,12827,252777,239950,No
DrAIT,Chemical Engineering,KCET,2024,65915,87078,15321,26425,194739,168314,Yes
RNSIT,Aerospace Engineering,COMEDK,2024,162946,66711,10852,29520,270029,240509,No
NIE,Mechanical Engineering,KCET,2023,63654,82280,10139,29214,185287,156073,Yes
GIT,Information Science and Engineering,KCET,2023,73297,68890,9853,26416,178456,152040,Yes
MVJCE,Data Science,COMEDK,2023,185186,81292,13712,18790,298980,280190,No
KLSGIT,Data Science,KCET,2023,70529,71536,17610,11862,171537,159675,No
BMSIT,Electronics and Communication Engineering,KCET,2024,56518,94307,11578,10532,172935,162403,No
SITM,Aerospace Engineering,COMEDK,2024,199472,67189,9930,23510,300101,276591,No
SCEM,Chemical Engineering,KCET,2023,68193,73790,10522,14556,167061,152505,No
MSRUAS,Computer Science and Engineering,KCET,2024,63103,76714,15104,24665,179586,154921,No
CITGubbi,Mechanical Engineering,COMEDK,2023,188320,60286,16375,26635,291616,264981,Yes
RVUNIV,Computer Science and Engineering,KCET,2024,72144,81726,14731,18439,187040,168601,Yes
AEC,Information Science and Engineering,COMEDK,2024,166163,91283,8200,17189,282835,265646,Yes
VSM,Biotechnology,COMEDK,2024,204374,64386,18000,14307,301067,286760,Yes
RVUNIV,Biotechnology,COMEDK,2024,212529,83506,14533,18942,329510,310568,No
EastPoint,Aerospace Engineering,KCET,2024,63925,87797,18017,17491,187230,169739,No
VVCE,Computer Science and Engineering,COMEDK,2024,239374,76604,11547,18842,346367,327525,No
VemanaIT,Biotechnology,KCET,2024,69556,88394,8063,25880,191893,166013,Yes
NHCE,Robotics and Automation Engineering,KCET,2023,60286,87141,12142,25898,185467,159569,Yes
PESU,Aerospace Engineering,COMEDK,2024,211468,63996,13904,25776,315144,289368,Yes
AEC,Civil Engineering,KCET,2024,76441,84855,9787,23294,194377,171083,Yes
SITM,Chemical Engineering,COMEDK,2024,194455,78476,8769,26547,308247,281700,No
MSRUAS,Mechanical Engineering,COMEDK,2023,165918,75211,18397,18471,277997,259526,No
RVUNIV,Artificial Intelligence and Data Science,COMEDK,2023,163836,69178,18254,23043,274311,251268,Yes
SDMCET,Biotechnology,COMEDK,2023,197445,62934,8366,29288,298033,268745,Yes
KLSGIT,Robotics and Automation Engineering,COMEDK,2024,224582,93865,11869,17173,347489,330316,Yes
NCET,Civil Engineering,KCET,2023,56910,82054,14678,13092,166734,153642,Yes
VSM,Information Science and Engineering,COMEDK,2024,168838,72495,13090,19745,274168,254423,Yes
PESCE,Electrical and Electronics Engineering,KCET,2024,60127,64221,18001,15988,158337,142349,No
YKCE,Artificial Intelligence and Data Science,COMEDK,2024,237488,77492,9059,12431,336470,324039,Yes
REVA,Mechanical Engineering,COMEDK,2024,247123,93340,19638,15465,375566,360101,No
PRES,Chemical Engineering,KCET,2023,73736,71391,9320,29114,183561,154447,Yes
VSM,Chemical Engineering,COMEDK,2023,217979,90412,16655,13740,338786,325046,No
RAIT,Chemical Engineering,KCET,2024,81127,76116,13461,12408,183112,170704,Yes
DBIT,Electrical and Electronics Engineering,COMEDK,2024,231719,73672,18186,21368,344945,323577,No
SDMIT,Mechanical Engineering,KCET,2024,62892,94622,10283,28645,196442,167797,Yes
AEC,Aerospace Engineering,COMEDK,2023,167778,71947,9070,13534,262329,248795,No
SJBIT,Artificial Intelligence and Data Science,KCET,2023,56107,66382,19634,28795,170918,142123,No
AITM,Aerospace Engineering,COMEDK,2024,204540,81507,17684,15243,318974,303731,No
DBIT,Civil Engineering,KCET,2023,51269,60960,19365,11826,143420,131594,No
KSIT,Electronics and Communication Engineering,COMEDK,2024,195339,72979,14376,15611,298305,282694,No
NIE,Civil Engineering,KCET,2024,53129,63086,15225,11376,142816,131440,No
AITM,Chemical Engineering,KCET,2024,59707,73140,17050,18201,168098,149897,Yes
VIT,Civil Engineering,KCET,2024,51887,72214,10116,22485,156702,134217,Yes
SDMIT,Electronics and Communication Engineering,KCET,2023,57336,82474,15455,12805,168070,155265,No
PESCE,Robotics and Automation Engineering,COMEDK,2023,239396,61000,13271,26933,340600,313667,Yes
KLEIT,Artificial Intelligence and Data Science,COMEDK,2024,227515,73627,16152,18202,335496,317294,No
MSRIT,Civil Engineering,KCET,2023,56619,85433,8088,13550,163690,150140,No
AITM,Information Science and Engineering,KCET,2023,51075,93125,10329,24749,179278,154529,No
BNMIT,Aerospace Engineering,COMEDK,2024,243533,79971,12420,11210,347134,335924,No
BMSIT,Electrical and Electronics Engineering,KCET,2024,66310,75456,19403,21823,182992,161169,Yes
CITGubbi,Civil Engineering,COMEDK,2024,185685,67783,14691,15100,283259,268159,No
BMIT,Civil Engineering,COMEDK,2024,228404,88927,18745,17963,354039,336076,Yes
SCEM,Robotics and Automation Engineering,KCET,2023,71403,60950,18342,14577,165272,150695,Yes
DSATM,Artificial Intelligence and Data Science,KCET,2023,66004,71287,13718,27343,178352,151009,No
BIT,Electrical and Electronics Engineering,COMEDK,2023,161854,81580,19176,18551,281161,262610,No
SITM,Computer Science and Engineering,KCET,2024,75169,85210,18286,20690,199355,178665,Yes
PESCE,Robotics and Automation Engineering,COMEDK,2024,226719,73332,15361,19947,335359,315412,Yes
SITM,Electrical and Electronics Engineering,COMEDK,2023,230092,65210,12927,29960,338189,308229,No
HKBK,Electronics and Communication Engineering,COMEDK,2023,226938,91126,15847,24857,358768,333911,No
NCET,Artificial Intelligence and Data Science,COMEDK,2024,222385,72712,9158,29093,333348,304255,Yes
HKBK,Electronics and Communication Engineering,KCET,2024,62054,69822,15731,18647,166254,147607,No
CITGubbi,Robotics and Automation Engineering,KCET,2023,78340,76796,18496,26145,199777,173632,No
VVIT,Data Science,KCET,2024,61121,76282,14399,24521,176323,151802,No
GIT,Civil Engineering,KCET,2023,56885,90897,9069,20930,177781,156851,No
BIT,Aerospace Engineering,KCET,2024,50980,89508,14018,19155,173661,154506,No
JIT,Civil Engineering,COMEDK,2023,196815,78073,8016,15368,298272,282904,Yes
DBIT,Artificial Intelligence and Data Science,COMEDK,2024,167538,63230,8289,12971,252028,239057,Yes
NIE,Mechanical Engineering,KCET,2023,54844,77400,17657,21893,171794,149901,Yes
EastPoint,Electronics and Communication Engineering,COMEDK,2023,209071,88205,16678,22181,336135,313954,Yes
REVA,Robotics and Automation Engineering,COMEDK,2023,208463,75050,16598,10832,310943,300111,Yes
MSRUAS,Artificial Intelligence and Data Science,KCET,2024,74471,84868,16914,19098,195351,176253,Yes
RVCE,Aerospace Engineering,KCET,2023,76825,75141,16396,22924,191286,168362,No
AECMandya,Biotechnology,COMEDK,2024,240079,80009,8967,16328,345383,329055,Yes
RVUNIV,Chemical Engineering,COMEDK,2024,241723,71805,15705,27462,356695,329233,No
KLEIT,Electrical and Electronics Engineering,COMEDK,2023,238302,65410,14046,18160,335918,317758,No
AIT,Computer Science and Engineering,COMEDK,2024,225271,78766,13870,15272,333179,317907,Yes
VVIT,Electrical and Electronics Engineering,KCET,2023,51172,77776,19449,23589,171986,148397,Yes
NHCE,Data Science,COMEDK,2024,204696,82939,17127,20303,325065,304762,Yes
VVIT,Robotics and Automation Engineering,KCET,2024,84856,75169,11211,11357,182593,171236,No
HKBK,Electrical and Electronics Engineering,COMEDK,2024,236544,71270,9458,19319,336591,317272,Yes
BMSCE,Artificial Intelligence and Data Science,KCET,2024,74621,94972,15271,22745,207609,184864,Yes
SITM,Civil Engineering,COMEDK,2023,225201,71082,18288,23546,338117,314571,No
BMSIT,Mechanical Engineering,KCET,2023,60238,61666,18073,23255,163232,139977,No
EastPoint,Chemical Engineering,COMEDK,2023,213846,62697,11913,27119,315575,288456,Yes
RNSIT,Artificial Intelligence and Data Science,KCET,2024,74197,81057,15822,23756,194832,171076,No
AECMandya,Information Science and Engineering,COMEDK,2023,190517,78656,18453,21909,309535,287626,Yes
CITGubbi,Computer Science and Engineering,KCET,2024,52267,70729,15603,11804,150403,138599,Yes
AEC,Computer Science and Engineering,KCET,2024,78129,85662,17478,21602,202871,181269,Yes
KLEIT,Biotechnology,COMEDK,2023,189244,78248,16197,15828,299517,283689,No
JIT,Mechanical Engineering,COMEDK,2024,241690,84659,9907,13424,349680,336256,No
JSSSTU,Electronics and Communication Engineering,COMEDK,2023,241141,78044,12117,24782,356084,331302,Yes
AITM,Chemical Engineering,KCET,2024,63634,75766,19762,15857,175019,159162,Yes
RNSIT,Biotechnology,KCET,2024,58778,67352,14224,11166,151520,140354,Yes
SDMCET,Artificial Intelligence and Data Science,COMEDK,2024,202665,70266,9228,12361,294520,282159,Yes
GIT,Mechanical Engineering,KCET,2024,55640,81016,15484,21881,174021,152140,Yes
VSM,Chemical Engineering,COMEDK,2024,189249,60118,19746,12931,282044,269113,Yes
ACU,Artificial Intelligence and Data Science,COMEDK,2024,167439,67101,16315,19518,270373,250855,No
KLSGIT,Robotics and Automation Engineering,COMEDK,2024,181724,82287,17018,29217,310246,281029,No
YKCE,Electrical and Electronics Engineering,COMEDK,2023,177075,67351,12244,23365,280035,256670,Yes
VemanaIT,Electronics and Communication Engineering,COMEDK,2023,246387,92516,18201,11126,368230,357104,Yes
SJBCE,Aerospace Engineering,KCET,2023,70635,84604,19407,13213,187859,174646,Yes
KSIT,Computer Science and Engineering,COMEDK,2023,238093,82852,9550,12390,342885,330495,Yes
VIT,Civil Engineering,KCET,2024,75804,69888,16654,26655,189001,162346,No
AECMandya,Computer Science and Engineering,KCET,2023,68682,83493,8725,21934,182834,160900,Yes
RVCE,Electronics and Communication Engineering,KCET,2023,51326,65822,11952,14401,143501,129100,No
NIE,Aerospace Engineering,KCET,2023,58845,70692,13080,21543,164160,142617,No
NCET,Mechanical Engineering,COMEDK,2024,165982,80698,16900,26030,289610,263580,Yes
SIT,Aerospace Engineering,COMEDK,2024,212274,93005,12609,29174,347062,317888,Yes
AIT,Information Science and Engineering,COMEDK,2023,247557,86872,13324,24369,372122,347753,Yes
JSSSTU,Mechanical Engineering,COMEDK,2023,244080,84849,12623,24727,366279,341552,Yes
BMSIT,Aerospace Engineering,KCET,2023,76971,92593,16992,21262,207818,186556,No
SJBIT,Electrical and Electronics Engineering,COMEDK,2024,170763,70490,12797,28407,282457,254050,Yes
VVIT,Electronics and Communication Engineering,COMEDK,2023,241391,93704,9366,15194,359655,344461,No
DBIT,Computer Science and Engineering,KCET,2023,76095,67401,13483,22029,179008,156979,No
SCEM,Aerospace Engineering,KCET,2024,83662,61125,13148,11282,169217,157935,No
SJBCE,Computer Science and Engineering,KCET,2023,51642,91589,16156,28918,188305,159387,Yes
YKCE,Chemical Engineering,KCET,2024,65055,90000,9506,27462,192023,164561,No
SJBCE,Chemical Engineering,KCET,2023,79757,67203,9292,13589,169841,156252,No
EastPoint,Chemical Engineering,COMEDK,2024,198155,78948,13267,11737,302107,290370,No
REVA,Mechanical Engineering,COMEDK,2023,222876,70342,8742,21019,322979,301960,Yes
SJBCE,Data Science,KCET,2024,64733,62885,11121,19940,158679,138739,No
DSATM,Data Science,KCET,2024,83590,71787,19095,14188,188660,174472,Yes
KLSGIT,Chemical Engineering,KCET,2023,51588,72043,18235,17780,159646,141866,No
BMSIT,Artificial Intelligence and Data Science,KCET,2023,57708,65030,11681,16996,151415,134419,No
SDMCET,Robotics and Automation Engineering,COMEDK,2023,169136,93416,12052,24644,299248,274604,No
VIT,Robotics and Automation Engineering,COMEDK,2024,246826,83990,17634,22408,370858,348450,Yes
KLSGIT,Computer Science and Engineering,COMEDK,2024,203043,67215,14453,21750,306461,284711,Yes
DSATM,Aerospace Engineering,KCET,2023,73287,61482,9472,14924,159165,144241,No
KLEIT,Biotechnology,KCET,2023,58552,77703,17277,11279,164811,153532,Yes
RAIT,Mechanical Engineering,KCET,2023,62162,83502,18157,15422,179243,163821,Yes
SCEM,Information Science and Engineering,COMEDK,2023,192012,76424,12118,21621,302175,280554,No
DSATM,Computer Science and Engineering,KCET,2024,67589,74277,9081,27803,178750,150947,No
BNMIT,Computer Science and Engineering,KCET,2024,70266,66692,10541,27952,175451,147499,Yes
JNNCE,Biotechnology,COMEDK,2024,200674,86906,12744,16267,316591,300324,Yes
VemanaIT,Artificial Intelligence and Data Science,COMEDK,2024,190036,60250,19655,25139,295080,269941,Yes
BITM,Information Science and Engineering,COMEDK,2023,175619,69976,17018,21267,283880,262613,No
JNNCE,Aerospace Engineering,KCET,2024,54164,78853,16562,24422,174001,149579,No
AEC,Information Science and Engineering,KCET,2023,74975,84010,13647,18812,191444,172632,Yes
HKBK,Artificial Intelligence and Data Science,KCET,2023,60698,77335,19966,24147,182146,157999,Yes
NHCE,Electrical and Electronics Engineering,KCET,2023,53248,78337,9097,18824,159506,140682,No
BITM,Electronics and Communication Engineering,KCET,2023,56623,75954,8990,13028,154595,141567,Yes
SJBIT,Electronics and Communication Engineering,COMEDK,2024,190690,77449,16503,18048,302690,284642,No
BMSCE,Robotics and Automation Engineering,COMEDK,2024,184459,90930,13390,14854,303633,288779,No
BIT,Information Science and Engineering,COMEDK,2024,223925,85367,8285,27527,345104,317577,No
BMSIT,Biotechnology,KCET,2023,73975,85877,18926,21717,200495,178778,No
EastPoint,Information Science and Engineering,KCET,2024,52822,70051,17861,14617,155351,140734,No
GIT,Aerospace Engineering,COMEDK,2024,165661,93157,17015,13712,289545,275833,No
PESCE,Electrical and Electronics Engineering,COMEDK,2024,186352,78995,15627,27185,308159,280974,Yes
SDMIT,Civil Engineering,KCET,2023,72513,73368,17143,10264,173288,163024,No
RNSIT,Data Science,KCET,2023,64220,75809,15916,22739,178684,155945,No
RVCE,Robotics and Automation Engineering,COMEDK,2024,230221,81829,18608,27008,357666,330658,Yes
CITGubbi,Mechanical Engineering,KCET,2023,62104,94592,8148,15267,180111,164844,Yes
EastPoint,Information Science and Engineering,COMEDK,2023,217463,63377,10371,17067,308278,291211,No
NCET,Electronics and Communication Engineering,KCET,2023,78722,71370,13318,16402,179812,163410,Yes
SDMCET,Chemical Engineering,COMEDK,2024,174537,94188,12104,24034,304863,280829,No
MSRIT,Electrical and Electronics Engineering,KCET,2024,52768,83453,17181,18426,171828,153402,Yes
AECMandya,Data Science,COMEDK,2023,232810,73346,17684,29016,352856,323840,No
HKBK,Civil Engineering,COMEDK,2023,160131,93838,17916,27625,299510,271885,No
BITM,Chemical Engineering,KCET,2024,70876,67047,17111,28693,183727,155034,Yes
EastPoint,Civil Engineering,KCET,2023,61893,85641,19195,15863,182592,166729,No
VemanaIT,Aerospace Engineering,KCET,2023,76347,70291,9815,15894,172347,156453,Yes
SCEM,Artificial Intelligence and Data Science,KCET,2023,64500,88079,13199,11047,176825,165778,No
EastPoint,Information Science and Engineering,KCET,2024,67431,70760,18341,18445,174977,156532,Yes
UVCE,Aerospace Engineering,COMEDK,2024,196974,82907,19538,24393,323812,299419,Yes
KLSGIT,Robotics and Automation Engineering,COMEDK,2024,230310,84522,19122,29136,363090,333954,No
VIT,Data Science,COMEDK,2023,189993,69425,14767,18061,292246,274185,No
BIT,Artificial Intelligence and Data Science,KCET,2024,80823,86382,12499,12918,192622,179704,No
KLSGIT,Biotechnology,KCET,2024,60702,93618,11697,11953,177970,166017,Yes
BMSCE,Robotics and Automation Engineering,KCET,2024,72164,86001,11513,22409,192087,169678,No
SJBCE,Computer Science and Engineering,KCET,2023,60335,74669,18465,29364,182833,153469,Yes
AECMandya,Robotics and Automation Engineering,KCET,2024,72759,90587,15406,18385,197137,178752,No
KLSGIT,Aerospace Engineering,KCET,2023,74235,67999,8492,19764,170490,150726,No
KSIT,Data Science,KCET,2024,59943,74128,11165,27394,172630,145236,No
RNSIT,Biotechnology,COMEDK,2023,169721,72320,15449,26469,283959,257490,No
AEC,Computer Science and Engineering,COMEDK,2024,197073,81130,16475,16435,311113,294678,Yes
AITM,Electrical and Electronics Engineering,COMEDK,2024,232605,88927,17748,27225,366505,339280,No
VSM,Electronics and Communication Engineering,COMEDK,2024,243738,78480,16511,20760,359489,338729,No
AITM,Electrical and Electronics Engineering,COMEDK,2024,207603,84559,13871,29907,335940,306033,Yes
AECMandya,Data Science,COMEDK,2024,165715,64062,10852,26950,267579,240629,No
SJBIT,Information Science and Engineering,COMEDK,2024,211589,91807,15245,22889,341530,318641,Yes
CMRIT,Computer Science and Engineering,KCET,2024,84578,89380,10749,21601,206308,184707,Yes
EastPoint,Robotics and Automation Engineering,KCET,2024,80016,84547,15978,29428,209969,180541,No
JSSSTU,Information Science and Engineering,KCET,2023,84321,73117,9198,21070,187706,166636,Yes
CMRIT,Electronics and Communication Engineering,KCET,2024,69129,84336,16952,24441,194858,170417,No
SDMCET,Aerospace Engineering,KCET,2023,79214,84908,8455,21457,194034,172577,Yes
BMSCE,Data Science,KCET,2023,84790,94937,12716,23718,216161,192443,Yes
AIT,Robotics and Automation Engineering,KCET,2023,74066,63216,8172,18063,163517,145454,No
RVCE,Electrical and Electronics Engineering,COMEDK,2024,249773,90965,17355,23570,381663,358093,Yes
MVJCE,Chemical Engineering,KCET,2024,77076,76425,9638,17034,180173,163139,No
AECMandya,Artificial Intelligence and Data Science,KCET,2023,70337,86499,14874,26295,198005,171710,No
DrAIT,Aerospace Engineering,COMEDK,2023,195213,93253,9780,28262,326508,298246,Yes
BMIT,Electrical and Electronics Engineering,KCET,2023,66804,60490,9299,10270,146863,136593,No
CMRIT,Data Science,KCET,2024,82216,76080,16895,29424,204615,175191,Yes
ACU,Chemical Engineering,KCET,2024,75519,78832,10278,20119,184748,164629,Yes
PESCE,Electrical and Electronics Engineering,KCET,2023,77097,81266,13101,19160,190624,171464,Yes
SCEM,Artificial Intelligence and Data Science,KCET,2024,68454,63292,17189,12475,161410,148935,Yes
CITGubbi,Computer Science and Engineering,COMEDK,2024,169782,74590,10173,17062,271607,254545,Yes
UVCE,Artificial Intelligence and Data Science,KCET,2023,57240,69333,18416,29443,174432,144989,No
BITM,Artificial Intelligence and Data Science,COMEDK,2024,245963,67093,12777,11723,337556,325833,No
NMIT,Artificial Intelligence and Data Science,KCET,2023,70148,90156,8807,22357,191468,169111,No
VemanaIT,Information Science and Engineering,KCET,2023,64027,80366,8062,17920,170375,152455,No
PESU,Data Science,KCET,2024,72092,87520,15999,16359,191970,175611,Yes
RAIT,Mechanical Engineering,COMEDK,2024,172419,76196,13570,25719,287904,262185,Yes
AECMandya,Biotechnology,KCET,2024,53213,69676,8407,27502,158798,131296,Yes
SJBCE,Electrical and Electronics Engineering,KCET,2023,64735,86780,18032,18539,188086,169547,No
NMIT,Information Science and Engineering,KCET,2024,67981,73633,13394,18905,173913,155008,No
VIT,Electrical and Electronics Engineering,COMEDK,2023,249774,86722,13871,22077,372444,350367,Yes
VVIT,Electrical and Electronics Engineering,KCET,2023,59233,67603,14785,13213,154834,141621,Yes
AITM,Data Science,COMEDK,2023,186664,86811,17507,25732,316714,290982,No
BNMIT,Computer Science and Engineering,COMEDK,2023,179613,93042,17027,29020,318702,289682,Yes
VemanaIT,Civil Engineering,COMEDK,2023,198760,76676,18940,16359,310735,294376,No
VVIT,Biotechnology,COMEDK,2023,202308,77405,12937,19049,311699,292650,Yes
PRES,Robotics and Automation Engineering,COMEDK,2023,224034,75042,17733,16143,332952,316809,Yes
SDMIT,Mechanical Engineering,COMEDK,2024,175338,92409,18607,27258,313612,286354,Yes
DBIT,Data Science,COMEDK,2023,195570,94633,19715,18436,328354,309918,Yes
SIT,Biotechnology,COMEDK,2023,237415,92264,19332,25240,374251,349011,No
KLSGIT,Information Science and Engineering,COMEDK,2024,183097,94245,19686,14614,311642,297028,Yes
AIT,Aerospace Engineering,KCET,2024,75049,78836,17428,16787,188100,171313,Yes
SDMCET,Information Science and Engineering,KCET,2023,65081,64924,9890,22874,162769,139895,Yes
NHCE,Robotics and Automation Engineering,KCET,2024,50088,82042,8734,18965,159829,140864,No
MSRUAS,Artificial Intelligence and Data Science,COMEDK,2023,218950,89762,11620,24454,344786,320332,No
NHCE,Artificial Intelligence and Data Science,COMEDK,2023,227789,67220,13429,10136,318574,308438,Yes
AEC,Chemical Engineering,COMEDK,2024,249768,94389,18676,22872,385705,362833,Yes
CITGubbi,Information Science and Engineering,COMEDK,2024,215942,91294,11988,23149,342373,319224,Yes
SCEM,Robotics and Automation Engineering,KCET,2024,51900,70396,13815,23415,159526,136111,Yes
UVCE,Computer Science and Engineering,COMEDK,2023,209505,70013,14419,19282,313219,293937,No
JNNCE,Robotics and Automation Engineering,COMEDK,2024,238507,78809,14393,26440,358149,331709,Yes
DSCE,Artificial Intelligence and Data Science,KCET,2023,65362,81584,19418,20086,186450,166364,Yes
MSRIT,Civil Engineering,KCET,2024,72581,76210,11770,21393,181954,160561,Yes
AIT,Robotics and Automation Engineering,KCET,2023,61223,71118,17410,29425,179176,149751,No
BIT,Civil Engineering,COMEDK,2023,240341,72110,16678,21010,350139,329129,Yes
AEC,Biotechnology,KCET,2024,54406,64705,16765,20041,155917,135876,Yes
GIT,Civil Engineering,COMEDK,2024,170939,86628,19595,23411,300573,277162,No
AITM,Artificial Intelligence and Data Science,KCET,2023,63472,71002,15184,20267,169925,149658,Yes
SDMIT,Electrical and Electronics Engineering,KCET,2023,77507,93190,13164,22707,206568,183861,No
BITM,Robotics and Automation Engineering,KCET,2024,77220,77282,18434,21904,194840,172936,Yes
MVJCE,Chemical Engineering,COMEDK,2023,160946,89229,17963,16617,284755,268138,Yes
DBIT,Electronics and Communication Engineering,COMEDK,2023,213237,75628,12564,27100,328529,301429,No
DSATM,Aerospace Engineering,KCET,2024,68018,72288,12881,21469,174656,153187,Yes
JSSSTU,Electrical and Electronics Engineering,KCET,2023,81200,62237,19918,28739,192094,163355,No
SDMIT,Biotechnology,KCET,2024,84729,79040,9741,15608,189118,173510,No
NHCE,Chemical Engineering,COMEDK,2023,191664,82217,11863,15737,301481,285744,Yes
NMIT,Biotechnology,COMEDK,2023,176882,61497,18778,14169,271326,257157,No
CITGubbi,Robotics and Automation Engineering,KCET,2024,51801,65406,13791,19353,150351,130998,Yes
SITM,Data Science,COMEDK,2024,177409,76841,18572,21710,294532,272822,Yes
PESU,Chemical Engineering,COMEDK,2024,227489,85673,8568,21788,343518,321730,No
DSCE,Robotics and Automation Engineering,COMEDK,2024,179386,91414,19774,19693,310267,290574,Yes
SJBIT,Chemical Engineering,COMEDK,2023,164960,84195,13172,24816,287143,262327,No
NCET,Information Science and Engineering,KCET,2024,82821,66835,16999,17561,184216,166655,No
NCET,Biotechnology,KCET,2023,59935,78565,13099,11083,162682,151599,Yes
RIT,Data Science,KCET,2023,61511,88270,11880,22993,184654,161661,No
SCEM,Artificial Intelligence and Data Science,KCET,2024,82150,81202,13244,11273,187869,176596,No
UVCE,Mechanical Engineering,COMEDK,2023,227705,84865,9191,20699,342460,321761,No
DrAIT,Robotics and Automation Engineering,KCET,2023,52851,82195,14317,26850,176213,149363,Yes
MVJCE,Biotechnology,KCET,2023,59471,89102,8473,26812,183858,157046,Yes
BITM,Data Science,KCET,2023,84276,74040,8101,21959,188376,166417,Yes
AITM,Chemical Engineering,KCET,2024,55169,75486,13414,16225,160294,144069,No
NHCE,Electronics and Communication Engineering,COMEDK,2024,190633,76022,16518,18469,301642,283173,Yes
BMSIT,Robotics and Automation Engineering,COMEDK,2023,166063,87032,13733,22900,289728,266828,Yes
RVCE,Information Science and Engineering,COMEDK,2023,182585,79142,17355,21193,300275,279082,No
NIE,Robotics and Automation Engineering,KCET,2023,74195,91159,9571,15295,190220,174925,Yes
SCEM,Robotics and Automation Engineering,KCET,2023,83783,92921,13390,17331,207425,190094,Yes
SDMIT,Mechanical Engineering,COMEDK,2024,207493,93139,18524,19752,338908,319156,Yes
VVCE,Biotechnology,KCET,2023,61316,71770,11423,10139,154648,144509,No
HKBK,Chemical Engineering,COMEDK,2024,246362,71645,15006,12025,345038,333013,No
KLEIT,Aerospace Engineering,KCET,2023,56766,90804,8955,11950,168475,156525,No
MVJCE,Electronics and Communication Engineering,COMEDK,2023,196706,92538,8852,27859,325955,298096,Yes
RVUNIV,Biotechnology,KCET,2024,72394,74155,8263,10255,165067,154812,Yes
SIT,Electronics and Communication Engineering,KCET,2023,78464,86496,14556,14835,194351,179516,No
PESCE,Artificial Intelligence and Data Science,KCET,2023,79435,69601,13242,14219,176497,162278,Yes
SJBCE,Electrical and Electronics Engineering,COMEDK,2024,184225,66972,17015,29428,297640,268212,No
RNSIT,Robotics and Automation Engineering,KCET,2024,68155,63945,15173,27004,174277,147273,No
NCET,Civil Engineering,COMEDK,2023,210790,90645,8537,27395,337367,309972,No
DBIT,Mechanical Engineering,COMEDK,2023,160975,76265,17585,25558,280383,254825,Yes
DBIT,Biotechnology,KCET,2024,52069,79089,15093,18195,164446,146251,Yes
NCET,Biotechnology,COMEDK,2023,223012,83892,14098,23930,344932,321002,Yes
BITM,Chemical Engineering,KCET,2023,84294,75918,12487,25111,197810,172699,No
BMSCE,Computer Science and Engineering,KCET,2023,83048,89950,10497,20607,204102,183495,Yes
SIT,Aerospace Engineering,KCET,2023,50495,71369,17418,12680,151962,139282,Yes
SITM,Aerospace Engineering,KCET,2023,68668,82051,14901,13849,179469,165620,No
KSIT,Robotics and Automation Engineering,COMEDK,2023,201012,83373,17382,24396,326163,301767,No
BITM,Information Science and Engineering,COMEDK,2024,226735,88892,10919,24340,350886,326546,No
SIT,Chemical Engineering,COMEDK,2023,197683,67027,8071,21970,294751,272781,Yes
NCET,Electrical and Electronics Engineering,COMEDK,2023,216844,89010,13768,26962,346584,319622,No
AEC,Information Science and Engineering,KCET,2023,62516,94109,19446,23127,199198,176071,No
JIT,Robotics and Automation Engineering,COMEDK,2023,204378,78319,10918,15875,309490,293615,No
JNNCE,Electronics and Communication Engineering,COMEDK,2024,175722,77661,14553,22562,290498,267936,No
AEC,Electronics and Communication Engineering,KCET,2024,63240,74607,11121,16706,165674,148968,No
NCET,Computer Science and Engineering,COMEDK,2024,184940,61280,15305,28495,290020,261525,No
UVCE,Electrical and Electronics Engineering,COMEDK,2024,241841,89973,12912,24110,368836,344726,No
PESU,Artificial Intelligence and Data Science,COMEDK,2023,206495,83027,15377,12625,317524,304899,No
SIT,Civil Engineering,COMEDK,2023,217394,88650,8147,22492,336683,314191,Yes
SCEM,Computer Science and Engineering,KCET,2024,68187,86805,9300,14199,178491,164292,Yes
NCET,Computer Science and Engineering,KCET,2024,56972,67594,15223,23770,163559,139789,No
RNSIT,Electronics and Communication Engineering,COMEDK,2024,223710,76822,12055,24156,336743,312587,Yes
HKBK,Civil Engineering,COMEDK,2023,173401,89020,17741,17554,297716,280162,No
REVA,Chemical Engineering,COMEDK,2024,202698,77126,12450,19535,311809,292274,Yes
SCEM,Robotics and Automation Engineering,COMEDK,2024,234282,70242,14671,29040,348235,319195,Yes
GMIT,Data Science,KCET,2023,81641,88782,9334,13749,193506,179757,No
VVIT,Biotechnology,COMEDK,2024,182090,62727,15120,19438,279375,259937,No
RAIT,Electrical and Electronics Engineering,KCET,2024,54980,92627,12349,22282,182238,159956,No
ACU,Information Science and Engineering,COMEDK,2023,228175,76034,15974,29124,349307,320183,Yes
KLEIT,Data Science,KCET,2023,63623,62529,9492,25436,161080,135644,Yes
SIT,Electronics and Communication Engineering,KCET,2024,61067,91686,19898,20585,193236,172651,Yes
BMSIT,Mechanical Engineering,COMEDK,2023,233771,74720,13775,12022,334288,322266,No
BMIT,Computer Science and Engineering,COMEDK,2024,168692,85418,10254,24318,288682,264364,Yes
KSIT,Data Science,KCET,2023,73898,87311,17750,18295,197254,178959,No
SDMCET,Computer Science and Engineering,COMEDK,2024,164271,76875,12702,12555,266403,253848,No
VSM,Information Science and Engineering,KCET,2024,51874,76288,15866,25708,169736,144028,Yes
CMRIT,Chemical Engineering,KCET,2023,71555,60085,19774,19591,171005,151414,No
RNSIT,Biotechnology,COMEDK,2024,212960,63584,17000,18615,312159,293544,No
BMSCE,Electronics and Communication Engineering,KCET,2023,83229,65569,10427,15908,175133,159225,Yes
SJBCE,Information Science and Engineering,KCET,2023,75693,91486,10559,27545,205283,177738,No
AITM,Aerospace Engineering,COMEDK,2023,211035,66367,19584,18386,315372,296986,No
VIT,Electrical and Electronics Engineering,KCET,2023,79464,91573,8391,21728,201156,179428,No
AITM,Data Science,KCET,2023,55499,80184,10511,12053,158247,146194,Yes
BMSIT,Chemical Engineering,KCET,2023,74342,91350,14088,23015,202795,179780,No
MSRIT,Aerospace Engineering,KCET,2024,80249,64440,9438,26073,180200,154127,Yes
RVCE,Chemical Engineering,COMEDK,2023,248045,84052,8000,18374,358471,340097,No
NCET,Biotechnology,COMEDK,2024,235381,76932,10280,10976,333569,322593,Yes
BIT,Chemical Engineering,COMEDK,2023,237508,69910,13927,13125,334470,321345,Yes
SJBIT,Civil Engineering,COMEDK,2024,203097,86024,14483,15075,318679,303604,No
DrAIT,Chemical Engineering,KCET,2023,65877,81629,19060,16324,182890,166566,No
SITM,Civil Engineering,KCET,2024,76647,93053,17284,22679,209663,186984,Yes
MVJCE,Electronics and Communication Engineering,COMEDK,2023,247842,65796,10816,14570,339024,324454,No
RIT,Chemical Engineering,COMEDK,2024,219290,72420,19642,20025,331377,311352,Yes
HKBK,Aerospace Engineering,COMEDK,2023,193475,87197,11574,11732,303978,292246,No
SJBCE,Robotics and Automation Engineering,KCET,2023,52416,66429,15915,20573,155333,134760,No
VemanaIT,Information Science and Engineering,COMEDK,2023,242735,81572,14271,25038,363616,338578,No
SITM,Robotics and Automation Engineering,KCET,2023,84023,87119,15661,11553,198356,186803,Yes
ACU,Electronics and Communication Engineering,KCET,2023,76584,63868,10489,14098,165039,150941,Yes
AECMandya,Data Science,COMEDK,2023,216998,75778,18439,16521,327736,311215,No
GIT,Chemical Engineering,COMEDK,2023,202846,77739,18521,29052,328158,299106,No
MSRIT,Aerospace Engineering,COMEDK,2023,195990,61375,8767,22607,288739,266132,Yes
BITM,Chemical Engineering,COMEDK,2024,204662,78601,14956,13868,312087,298219,Yes
BNMIT,Robotics and Automation Engineering,KCET,2024,79673,79965,10869,20084,190591,170507,No
NCET,Information Science and Engineering,COMEDK,2024,166133,70591,18416,19331,274471,255140,No
DrAIT,Computer Science and Engineering,KCET,2024,64067,81022,13882,15938,174909,158971,No
SITM,Mechanical Engineering,COMEDK,2024,178950,80399,16137,13893,289379,275486,Yes
UVCE,Computer Science and Engineering,KCET,2024,56500,60205,10319,20360,147384,127024,No
JSSSTU,Biotechnology,COMEDK,2023,245703,80974,13413,29974,370064,340090,No
KSIT,Robotics and Automation Engineering,COMEDK,2023,209061,70834,15266,10530,305691,295161,Yes
SIT,Artificial Intelligence and Data Science,KCET,2023,76248,93581,19737,17776,207342,189566,Yes
NIE,Computer Science and Engineering,KCET,2024,53407,64155,14028,25168,156758,131590,No
GMIT,Civil Engineering,KCET,2023,76320,63156,8700,20450,168626,148176,No
DrAIT,Aerospace Engineering,KCET,2023,54430,91703,9889,12248,168270,156022,No
SDMCET,Civil Engineering,KCET,2024,55206,79013,12701,27439,174359,146920,No
JSSSTU,Biotechnology,KCET,2024,76386,74243,11019,24113,185761,161648,Yes
AECMandya,Computer Science and Engineering,COMEDK,2023,181445,66109,16718,20267,284539,264272,Yes
DSCE,Information Science and Engineering,KCET,2024,74160,62783,10880,19271,167094,147823,No
DrAIT,Civil Engineering,COMEDK,2024,236268,71823,13129,18909,340129,321220,Yes
VemanaIT,Chemical Engineering,KCET,2023,63970,79320,17673,29814,190777,160963,Yes
AIT,Chemical Engineering,COMEDK,2024,224991,71110,10309,19805,326215,306410,Yes
BIT,Robotics and Automation Engineering,COMEDK,2024,168038,88768,16040,16850,289696,272846,Yes
JSSSTU,Aerospace Engineering,KCET,2024,52180,65416,9868,29975,157439,127464,No
CMRIT,Robotics and Automation Engineering,COMEDK,2023,222241,74815,19526,12697,329279,316582,Yes
SJBIT,Biotechnology,COMEDK,2023,237959,64818,8329,20391,331497,311106,Yes
BITM,Artificial Intelligence and Data Science,KCET,2023,59726,65527,10852,25606,161711,136105,No
DSCE,Aerospace Engineering,COMEDK,2024,191908,66862,11784,14660,285214,270554,No
BMIT,Computer Science and Engineering,KCET,2023,79530,85618,10130,26256,201534,175278,Yes
JIT,Computer Science and Engineering,COMEDK,2023,223830,83459,18861,19482,345632,326150,No
AIT,Aerospace Engineering,COMEDK,2024,220725,70179,8952,20500,320356,299856,No
YKCE,Information Science and Engineering,COMEDK,2024,211599,65870,13733,19307,310509,291202,Yes
BMIT,Robotics and Automation Engineering,KCET,2024,55912,72774,17773,18838,165297,146459,No
AEC,Aerospace Engineering,KCET,2023,74378,86873,16182,14731,192164,177433,Yes
AIT,Computer Science and Engineering,COMEDK,2024,184500,89938,12018,16199,302655,286456,No
UVCE,Mechanical Engineering,COMEDK,2024,180563,92373,8606,18104,299646,281542,No
NIE,Electrical and Electronics Engineering,COMEDK,2024,198584,90622,14558,15014,318778,303764,Yes
CITGubbi,Civil Engineering,COMEDK,2023,167744,74289,14196,24020,280249,256229,No
SCEM,Chemical Engineering,KCET,2024,51546,81686,15773,29336,178341,149005,Yes
KLEIT,Aerospace Engineering,KCET,2023,51523,68230,13182,25438,158373,132935,Yes
NMIT,Information Science and Engineering,COMEDK,2023,166049,72979,11605,10530,261163,250633,Yes
AECMandya,Robotics and Automation Engineering,KCET,2023,57657,81803,12933,24826,177219,152393,Yes
VVIT,Electrical and Electronics Engineering,COMEDK,2023,198610,76864,19542,12080,307096,295016,Yes
DrAIT,Biotechnology,KCET,2024,66819,76660,14185,19504,177168,157664,No
RVCE,Civil Engineering,KCET,2023,83068,85661,17144,24366,210239,185873,No
BMIT,Data Science,COMEDK,2024,179774,80108,14083,28404,302369,273965,No
RVUNIV,Electrical and Electronics Engineering,COMEDK,2023,161901,76656,8808,18423,265788,247365,No
BITM,Data Science,COMEDK,2023,235824,85494,17871,13361,352550,339189,Yes
MSRIT,Information Science and Engineering,COMEDK,2024,211839,78814,10429,20745,321827,301082,No
GIT,Computer Science and Engineering,COMEDK,2024,180675,72089,16411,17963,287138,269175,No
MSRIT,Chemical Engineering,COMEDK,2024,173283,90735,18676,24563,307257,282694,No
VVCE,Data Science,COMEDK,2024,171389,69311,8263,19680,268643,248963,Yes
BMSCE,Mechanical Engineering,KCET,2024,50021,76734,9365,22246,158366,136120,Yes
RAIT,Mechanical Engineering,COMEDK,2023,203394,89668,10740,26784,330586,303802,Yes
SDMCET,Robotics and Automation Engineering,COMEDK,2023,190326,94053,12253,27201,323833,296632,Yes
SJBIT,Mechanical Engineering,COMEDK,2024,183790,70442,9559,29962,293753,263791,Yes
NCET,Electrical and Electronics Engineering,COMEDK,2023,213503,74595,18057,25211,331366,306155,No
VSM,Computer Science and Engineering,COMEDK,2023,216646,83476,16832,28302,345256,316954,No
MSRUAS,Electrical and Electronics Engineering,KCET,2024,76412,85149,13332,18618,193511,174893,Yes
RIT,Information Science and Engineering,COMEDK,2024,165031,79451,8345,12514,265341,252827,No
NMIT,Biotechnology,KCET,2023,51793,94955,14774,23910,185432,161522,No
PRES,Information Science and Engineering,COMEDK,2024,190148,70853,17487,15713,294201,278488,No
RNSIT,Data Science,COMEDK,2024,218968,63300,8805,25740,316813,291073,Yes
JNNCE,Data Science,COMEDK,2023,216787,73008,8640,29087,327522,298435,No
VIT,Data Science,KCET,2023,77247,75378,14225,23561,190411,166850,No
HKBK,Artificial Intelligence and Data Science,COMEDK,2024,181882,87559,12743,16027,298211,282184,No
NCET,Electronics and Communication Engineering,KCET,2024,56158,91197,12179,23825,183359,159534,Yes
KLEIT,Aerospace Engineering,KCET,2024,68814,77029,14346,17761,177950,160189,No
AIT,Chemical Engineering,COMEDK,2023,161078,87181,11294,27240,286793,259553,No
NIE,Electronics and Communication Engineering,COMEDK,2023,217268,67335,17037,27173,328813,301640,Yes
DBIT,Robotics and Automation Engineering,COMEDK,2023,214225,62159,16795,18896,312075,293179,Yes
NHCE,Information Science and Engineering,COMEDK,2023,199541,82744,13104,27033,322422,295389,No
CMRIT,Data Science,KCET,2024,52326,71519,19649,14157,157651,143494,Yes
EastPoint,Computer Science and Engineering,KCET,2024,69188,75373,13665,21000,179226,158226,Yes
REVA,Computer Science and Engineering,KCET,2024,79569,80706,15340,21596,197211,175615,No
RNSIT,Aerospace Engineering,COMEDK,2024,244051,72788,11299,29489,357627,328138,Yes
DrAIT,Biotechnology,COMEDK,2024,232359,92586,18921,18295,362161,343866,Yes
BMSCE,Mechanical Engineering,KCET,2024,80411,74853,17280,12549,185093,172544,No
SJBIT,Computer Science and Engineering,KCET,2024,74058,92188,10679,12685,189610,176925,Yes
BMIT,Data Science,COMEDK,2023,180207,60949,11470,15760,268386,252626,No
PRES,Aerospace Engineering,COMEDK,2024,173379,84155,9420,20338,287292,266954,No
NCET,Aerospace Engineering,KCET,2024,75357,77348,13354,20574,186633,166059,Yes
JNNCE,Robotics and Automation Engineering,KCET,2023,81975,72032,14511,11974,180492,168518,No
JNNCE,Civil Engineering,COMEDK,2023,212036,84107,12710,10271,319124,308853,No
RAIT,Electrical and Electronics Engineering,COMEDK,2024,207823,78575,10942,26913,324253,297340,No
REVA,Electrical and Electronics Engineering,KCET,2023,53970,77138,9345,12069,152522,140453,Yes
RAIT,Computer Science and Engineering,COMEDK,2023,228990,87307,8878,21834,347009,325175,Yes
MSRUAS,Mechanical Engineering,KCET,2023,82201,88381,17653,21485,209720,188235,Yes
AEC,Biotechnology,KCET,2024,65709,84552,13226,15472,178959,163487,No
NIE,Robotics and Automation Engineering,COMEDK,2024,191768,73269,10627,15187,290851,275664,No
NHCE,Electronics and Communication Engineering,COMEDK,2024,161577,89726,18484,12039,281826,269787,Yes
NMIT,Civil Engineering,COMEDK,2024,167030,71726,16336,21897,276989,255092,Yes
RAIT,Robotics and Automation Engineering,COMEDK,2023,230878,63458,19714,19750,333800,314050,Yes
BMIT,Chemical Engineering,COMEDK,2024,212936,88541,17176,11659,330312,318653,Yes
VVCE,Civil Engineering,COMEDK,2024,181241,63851,18296,16282,279670,263388,Yes
VIT,Mechanical Engineering,COMEDK,2024,202851,88305,14921,24156,330233,306077,Yes
BMIT,Chemical Engineering,COMEDK,2024,174539,66567,13987,10433,265526,255093,No
UVCE,Civil Engineering,KCET,2024,57258,86257,13607,12972,170094,157122,No
EastPoint,Electrical and Electronics Engineering,KCET,2024,63055,92926,15063,26893,197937,171044,No
SDMIT,Robotics and Automation Engineering,COMEDK,2023,245939,68324,13677,25379,353319,327940,No
MVJCE,Mechanical Engineering,COMEDK,2024,218978,90146,10101,18223,337448,319225,Yes
AITM,Data Science,COMEDK,2024,196721,79187,11385,15203,302496,287293,Yes
PESCE,Electrical and Electronics Engineering,KCET,2023,54428,60495,14711,22258,151892,129634,Yes
BITM,Data Science,KCET,2024,80212,84189,9025,10735,184161,173426,Yes
SCEM,Electrical and Electronics Engineering,KCET,2024,66981,86688,13634,21927,189230,167303,No
DBIT,Civil Engineering,KCET,2024,65336,65723,9656,14637,155352,140715,No
NHCE,Electrical and Electronics Engineering,KCET,2023,55376,76100,13494,10163,155133,144970,No
RVCE,Aerospace Engineering,KCET,2024,53688,79048,8969,29369,171074,141705,No
NCET,Mechanical Engineering,KCET,2023,68124,75529,10725,23315,177693,154378,No
BMIT,Electrical and Electronics Engineering,KCET,2024,77428,90664,12730,10512,191334,180822,Yes
VVIT,Electronics and Communication Engineering,KCET,2024,51896,77729,16387,13571,159583,146012,No
NCET,Civil Engineering,KCET,2024,52141,78165,8764,25025,164095,139070,No
VVIT,Artificial Intelligence and Data Science,KCET,2024,75780,87603,8780,13128,185291,172163,Yes
CMRIT,Artificial Intelligence and Data Science,COMEDK,2024,176305,82544,16719,23176,298744,275568,Yes
AITM,Electrical and Electronics Engineering,COMEDK,2023,230756,90020,17611,12060,350447,338387,No
VIT,Artificial Intelligence and Data Science,COMEDK,2024,240670,77393,12297,28107,358467,330360,Yes
PRES,Information Science and Engineering,KCET,2024,84166,76445,14217,14877,189705,174828,No
SJBCE,Biotechnology,KCET,2024,52946,79498,17872,25200,175516,150316,No
MSRIT,Robotics and Automation Engineering,KCET,2024,51044,80821,12599,22432,166896,144464,No
ACU,Computer Science and Engineering,COMEDK,2023,220032,89069,13299,19422,341822,322400,Yes
RVUNIV,Electrical and Electronics Engineering,KCET,2024,55250,88081,15356,19366,178053,158687,No
AITM,Aerospace Engineering,KCET,2024,71255,69994,16921,21653,179823,158170,No
SIT,Electronics and Communication Engineering,COMEDK,2023,220927,68386,11395,13412,314120,300708,No
VSM,Artificial Intelligence and Data Science,KCET,2024,84247,77780,11201,23191,196419,173228,No
KLSGIT,Biotechnology,COMEDK,2024,236583,87610,13888,26704,364785,338081,Yes
RAIT,Civil Engineering,COMEDK,2024,162106,67179,13055,29571,271911,242340,Yes
NIE,Computer Science and Engineering,COMEDK,2023,249787,60500,8787,21606,340680,319074,Yes
NHCE,Artificial Intelligence and Data Science,KCET,2023,52204,69801,16493,26842,165340,138498,No
UVCE,Aerospace Engineering,COMEDK,2023,248911,82665,12398,10483,354457,343974,Yes
RNSIT,Electronics and Communication Engineering,KCET,2024,65262,60014,9220,23809,158305,134496,Yes
GIT,Data Science,KCET,2023,79930,73714,17816,19697,191157,171460,No
NHCE,Data Science,COMEDK,2023,202549,70886,18495,10445,302375,291930,No
SJBIT,Electrical and Electronics Engineering,COMEDK,2023,240827,83520,18394,27981,370722,342741,No
CITGubbi,Data Science,KCET,2023,74431,67959,15931,18079,176400,158321,No
VSM,Aerospace Engineering,COMEDK,2024,170201,66434,16089,19016,271740,252724,No
RAIT,Chemical Engineering,KCET,2023,82631,71283,16080,14850,184844,169994,No
NCET,Electrical and Electronics Engineering,KCET,2023,65465,70522,13275,20015,169277,149262,Yes
AITM,Mechanical Engineering,KCET,2023,61632,79955,13036,11723,166346,154623,Yes
BITM,Artificial Intelligence and Data Science,KCET,2024,50534,66328,16821,19825,153508,133683,No
NIE,Data Science,COMEDK,2023,214235,71489,9759,20831,316314,295483,Yes
EastPoint,Robotics and Automation Engineering,COMEDK,2024,169131,86781,16213,28008,300133,272125,Yes
BMIT,Artificial Intelligence and Data Science,COMEDK,2024,221939,86166,17599,23712,349416,325704,No
AITM,Electronics and Communication Engineering,KCET,2023,83523,83642,8572,13142,188879,175737,Yes
RIT,Aerospace Engineering,KCET,2023,68353,87933,13112,11717,181115,169398,Yes
BMIT,Civil Engineering,KCET,2024,71877,73404,18497,23543,187321,163778,Yes
SDMCET,Information Science and Engineering,COMEDK,2024,191539,89823,11663,14701,307726,293025,Yes
BMIT,Civil Engineering,COMEDK,2023,232702,87095,17659,11543,348999,337456,Yes
SDMIT,Biotechnology,KCET,2023,70293,74666,10898,18184,174041,155857,No
RIT,Data Science,KCET,2024,80608,87564,9522,23437,201131,177694,No
KLEIT,Mechanical Engineering,KCET,2023,84198,88474,16148,23027,211847,188820,No
RIT,Chemical Engineering,KCET,2023,82992,67567,18596,18220,187375,169155,No
GMIT,Aerospace Engineering,COMEDK,2024,216140,68355,18000,14835,317330,302495,No
MSRIT,Electrical and Electronics Engineering,KCET,2023,54706,86161,16276,10205,167348,157143,No
SCEM,Civil Engineering,COMEDK,2023,200491,76684,18780,15955,311910,295955,Yes
GMIT,Electronics and Communication Engineering,KCET,2024,75723,79730,19162,20531,195146,174615,Yes
RAIT,Information Science and Engineering,KCET,2024,74191,92304,11508,12474,190477,178003,Yes
BIT,Computer Science and Engineering,KCET,2023,53450,80134,8292,24912,166788,141876,Yes
RNSIT,Electronics and Communication Engineering,COMEDK,2024,195704,60135,12825,23428,292092,268664,No
PESCE,Electrical and Electronics Engineering,COMEDK,2024,217510,95000,13494,24987,350991,326004,No
AITM,Data Science,KCET,2023,52247,75874,17428,21468,167017,145549,Yes
NIE,Biotechnology,COMEDK,2024,163911,82915,12249,19545,278620,259075,No
UVCE,Civil Engineering,KCET,2023,72904,64935,19715,24599,182153,157554,Yes
BMSCE,Biotechnology,COMEDK,2023,212534,85281,13144,14077,325036,310959,Yes
MSRIT,Artificial Intelligence and Data Science,COMEDK,2024,228939,83572,11568,22309,346388,324079,No
RVCE,Robotics and Automation Engineering,COMEDK,2023,223329,62947,18192,29927,334395,304468,Yes
RAIT,Chemical Engineering,KCET,2023,78985,86793,13545,22208,201531,179323,Yes
NMIT,Aerospace Engineering,COMEDK,2023,223804,91398,17544,10518,343264,332746,Yes
BIT,Aerospace Engineering,COMEDK,2024,189317,63084,19339,14272,286012,271740,No
NCET,Electrical and Electronics Engineering,KCET,2024,66488,91930,13784,13075,185277,172202,Yes
MSRIT,Electronics and Communication Engineering,KCET,2024,70679,68040,14360,22910,175989,153079,No
JNNCE,Biotechnology,COMEDK,2024,193561,78603,19042,20882,312088,291206,No
BITM,Robotics and Automation Engineering,COMEDK,2024,247700,62504,15038,29929,355171,325242,No
VemanaIT,Electronics and Communication Engineering,KCET,2024,65002,75639,16604,21158,178403,157245,No
VSM,Biotechnology,KCET,2024,61726,93774,8032,21451,184983,163532,No
BMIT,Electronics and Communication Engineering,COMEDK,2024,164509,60529,12342,28243,265623,237380,Yes
JIT,Robotics and Automation Engineering,KCET,2024,81692,86865,17430,14390,200377,185987,Yes
BMSCE,Electronics and Communication Engineering,KCET,2023,72328,89182,17806,13270,192586,179316,Yes
PRES,Computer Science and Engineering,COMEDK,2023,176417,75952,17958,21947,292274,270327,Yes
RNSIT,Electrical and Electronics Engineering,KCET,2024,70539,93308,14887,22966,201700,178734,Yes
VIT,Electrical and Electronics Engineering,KCET,2023,62898,67880,19684,22041,172503,150462,No
DSCE,Civil Engineering,KCET,2023,67471,89056,16737,20944,194208,173264,No
BMSIT,Civil Engineering,KCET,2024,79221,62274,18733,26076,186304,160228,No
KLEIT,Chemical Engineering,KCET,2023,50007,93917,11962,22788,178674,155886,Yes
BMSCE,Biotechnology,KCET,2023,68418,87282,17918,10127,183745,173618,No
JIT,Chemical Engineering,COMEDK,2024,182660,87979,9995,24131,304765,280634,Yes
BMIT,Information Science and Engineering,COMEDK,2024,199220,80510,17460,27623,324813,297190,Yes
BMSIT,Computer Science and Engineering,COMEDK,2024,202473,64379,13304,20382,300538,280156,No
SIT,Information Science and Engineering,KCET,2024,53641,89877,8197,23840,175555,151715,No
DSCE,Computer Science and Engineering,KCET,2024,79616,85316,14825,24745,204502,179757,Yes
JNNCE,Aerospace Engineering,KCET,2023,79404,82655,12969,16239,191267,175028,No
DrAIT,Data Science,COMEDK,2023,209253,91374,14228,26296,341151,314855,No
GIT,Information Science and Engineering,COMEDK,2024,180471,76443,8400,22596,287910,265314,No
DrAIT,Artificial Intelligence and Data Science,COMEDK,2024,179239,66670,8540,25301,279750,254449,No
AEC,Artificial Intelligence and Data Science,COMEDK,2024,183878,92259,19360,22514,318011,295497,No
SDMIT,Computer Science and Engineering,COMEDK,2023,229874,93078,10741,25075,358768,333693,No
MSRUAS,Robotics and Automation Engineering,COMEDK,2023,175281,89842,18450,21839,305412,283573,No
KSIT,Civil Engineering,KCET,2024,75868,84552,13048,19789,193257,173468,No
PESCE,Information Science and Engineering,KCET,2023,68449,88651,11670,27546,196316,168770,Yes
RIT,Aerospace Engineering,KCET,2024,72193,93081,9427,20819,195520,174701,No
BIT,Information Science and Engineering,KCET,2023,64358,65425,14130,27071,170984,143913,Yes
MSRIT,Chemical Engineering,COMEDK,2023,226010,88452,18844,23763,357069,333306,Yes
KLSGIT,Aerospace Engineering,COMEDK,2024,212091,91329,16554,29673,349647,319974,No
AITM,Biotechnology,KCET,2023,74454,92176,18714,25273,210617,185344,Yes
SJBCE,Electrical and Electronics Engineering,COMEDK,2023,208268,94433,9586,21497,333784,312287,Yes
PESCE,Computer Science and Engineering,COMEDK,2024,240013,80137,18649,15267,354066,338799,No
REVA,Data Science,COMEDK,2024,201302,82339,11599,27670,322910,295240,Yes
JSSSTU,Computer Science and Engineering,COMEDK,2023,197503,72985,13280,15872,299640,283768,No
RIT,Information Science and Engineering,KCET,2024,56365,94671,19717,11420,182173,170753,Yes
JNNCE,Robotics and Automation Engineering,KCET,2024,71029,85560,10656,19704,186949,167245,Yes
SDMIT,Aerospace Engineering,KCET,2023,76876,72985,8415,24158,182434,158276,No
RNSIT,Civil Engineering,COMEDK,2024,201669,84952,12542,29441,328604,299163,Yes
SJBIT,Chemical Engineering,KCET,2023,72839,63314,18286,19709,174148,154439,No
MSRIT,Data Science,COMEDK,2024,202790,60326,10688,22020,295824,273804,No
RIT,Robotics and Automation Engineering,KCET,2023,65686,90555,9619,24978,190838,165860,Yes
GMIT,Computer Science and Engineering,COMEDK,2023,161705,62136,18752,20531,263124,242593,Yes
JNNCE,Artificial Intelligence and Data Science,COMEDK,2023,221327,78932,17700,15145,333104,317959,No
KLSGIT,Information Science and Engineering,KCET,2023,52469,84058,18909,26431,181867,155436,No
NIE,Aerospace Engineering,COMEDK,2024,193390,88094,12642,10644,304770,294126,No
EastPoint,Chemical Engineering,COMEDK,2023,207301,77414,8685,12290,305690,293400,Yes
GMIT,Artificial Intelligence and Data Science,KCET,2024,52533,70107,13012,25659,161311,135652,Yes
VIT,Chemical Engineering,COMEDK,2024,181877,89332,15162,27995,314366,286371,Yes
SJBIT,Computer Science and Engineering,COMEDK,2024,245624,81757,16452,24045,367878,343833,No
CITGubbi,Aerospace Engineering,COMEDK,2023,232483,83045,8768,15447,339743,324296,No
DBIT,Civil Engineering,COMEDK,2023,200265,60587,14320,27052,302224,275172,Yes
REVA,Mechanical Engineering,KCET,2024,54176,86836,12608,23063,176683,153620,Yes
UVCE,Information Science and Engineering,KCET,2024,63152,74218,9239,24444,171053,146609,Yes
MSRUAS,Robotics and Automation Engineering,COMEDK,2023,210908,89579,14186,25863,340536,314673,Yes
CITGubbi,Chemical Engineering,KCET,2023,58934,67954,14667,17376,158931,141555,No
SJBCE,Electronics and Communication Engineering,COMEDK,2024,248683,94252,11482,17135,371552,354417,Yes
DrAIT,Civil Engineering,COMEDK,2024,233293,80284,13309,14601,341487,326886,No
VemanaIT,Aerospace Engineering,KCET,2024,62131,63305,16089,22962,164487,141525,Yes
SJBIT,Electrical and Electronics Engineering,COMEDK,2023,177008,94545,13461,27729,312743,285014,Yes
GMIT,Aerospace Engineering,COMEDK,2023,199524,79289,19227,25920,323960,298040,No
RIT,Civil Engineering,COMEDK,2023,165875,67583,8774,10897,253129,242232,Yes
JNNCE,Chemical Engineering,COMEDK,2024,165583,81429,18120,11751,276883,265132,No
BMSCE,Electrical and Electronics Engineering,KCET,2023,55224,86389,14713,17509,173835,156326,No
AITM,Computer Science and Engineering,COMEDK,2024,189950,79543,12008,22617,304118,281501,No
NHCE,Civil Engineering,KCET,2024,55227,89233,18358,18704,181522,162818,No
PESU,Aerospace Engineering,COMEDK,2024,238861,82341,9271,22981,353454,330473,Yes
JIT,Electrical and Electronics Engineering,COMEDK,2023,223226,93106,13653,25262,355247,329985,Yes
GMIT,Chemical Engineering,COMEDK,2023,198153,73256,15026,23528,309963,286435,No
HKBK,Robotics and Automation Engineering,COMEDK,2024,233662,93156,9207,11046,347071,336025,Yes
SJBCE,Computer Science and Engineering,KCET,2023,57332,74207,16384,20381,168304,147923,No
KLSGIT,Biotechnology,KCET,2023,61128,71482,17457,20928,170995,150067,Yes
DBIT,Civil Engineering,COMEDK,2024,230868,80783,18417,21393,351461,330068,No
SJBCE,Information Science and Engineering,KCET,2024,82433,74354,14599,15850,187236,171386,No
HKBK,Information Science and Engineering,KCET,2023,64789,71157,11247,11976,159169,147193,No
DBIT,Biotechnology,COMEDK,2024,242447,88233,15464,28498,374642,346144,No
SIT,Robotics and Automation Engineering,KCET,2024,83558,91391,17150,18988,211087,192099,Yes
BMIT,Artificial Intelligence and Data Science,KCET,2024,81343,93821,19309,21406,215879,194473,Yes
AEC,Electronics and Communication Engineering,KCET,2023,77124,79588,12394,18640,187746,169106,No
UVCE,Chemical Engineering,KCET,2024,69906,76352,19189,22282,187729,165447,Yes
CITGubbi,Data Science,KCET,2024,81165,69654,19653,25128,195600,170472,Yes
PESCE,Civil Engineering,KCET,2023,77472,64075,8054,19539,169140,149601,Yes
BNMIT,Information Science and Engineering,KCET,2023,67844,83324,15577,21854,188599,166745,No
SDMIT,Information Science and Engineering,COMEDK,2023,188422,61461,12191,22201,284275,262074,No
BIT,Mechanical Engineering,KCET,2023,55362,91339,8684,24822,180207,155385,No
SDMIT,Chemical Engineering,COMEDK,2024,189115,74072,16791,27179,307157,279978,No
PESU,Aerospace Engineering,KCET,2024,68198,84983,8697,26586,188464,161878,Yes
DBIT,Computer Science and Engineering,COMEDK,2023,187703,92580,16575,13204,310062,296858,Yes
KLSGIT,Electronics and Communication Engineering,COMEDK,2024,231219,70997,15967,12609,330792,318183,No
BMIT,Aerospace Engineering,KCET,2023,52780,79921,8987,17426,159114,141688,Yes
NIE,Electronics and Communication Engineering,KCET,2023,74393,94379,13911,19568,202251,182683,No
VemanaIT,Computer Science and Engineering,KCET,2023,50091,85144,12644,19690,167569,147879,Yes
BIT,Biotechnology,COMEDK,2023,192965,91507,8750,24382,317604,293222,Yes
RAIT,Data Science,KCET,2023,51847,86729,13589,12740,164905,152165,No
VVIT,Mechanical Engineering,KCET,2024,58054,67867,11579,28174,165674,137500,No
UVCE,Civil Engineering,KCET,2024,64634,78456,15022,21520,179632,158112,Yes
BIT,Mechanical Engineering,COMEDK,2024,208668,73929,8266,16042,306905,290863,Yes
BMSCE,Electronics and Communication Engineering,COMEDK,2024,178329,86519,11689,24304,300841,276537,Yes
PESU,Electrical and Electronics Engineering,COMEDK,2023,241773,63654,14309,21436,341172,319736,Yes
CITGubbi,Aerospace Engineering,KCET,2024,57695,79868,17189,14870,169622,154752,No
SDMIT,Data Science,KCET,2024,77377,81268,14491,14411,187547,173136,Yes
VVIT,Information Science and Engineering,COMEDK,2024,170526,70073,13688,16040,270327,254287,Yes
AIT,Civil Engineering,KCET,2023,80908,75202,9023,26741,191874,165133,No
CMRIT,Artificial Intelligence and Data Science,COMEDK,2023,249633,81315,10249,16624,357821,341197,No
REVA,Electronics and Communication Engineering,KCET,2023,83318,82028,14922,17837,198105,180268,No
RNSIT,Chemical Engineering,KCET,2023,71467,81234,17571,10270,180542,170272,No
JIT,Civil Engineering,KCET,2024,60941,92516,17267,14149,184873,170724,Yes
HKBK,Computer Science and Engineering,KCET,2023,62029,61050,9878,27022,159979,132957,Yes
VSM,Civil Engineering,COMEDK,2023,212528,84509,16004,10696,323737,313041,Yes
AEC,Data Science,COMEDK,2023,236330,73708,13335,25760,349133,323373,Yes
BMIT,Civil Engineering,COMEDK,2023,167011,74479,14083,15803,271376,255573,No
GIT,Computer Science and Engineering,COMEDK,2024,248693,75934,10051,24013,358691,334678,Yes
VVIT,Electronics and Communication Engineering,COMEDK,2023,180076,62020,13396,23811,279303,255492,Yes
AEC,Electronics and Communication Engineering,KCET,2024,50364,75037,14053,20812,160266,139454,Yes
VemanaIT,Artificial Intelligence and Data Science,COMEDK,2023,225128,87685,19760,24291,356864,332573,No
GIT,Mechanical Engineering,COMEDK,2024,193324,66051,8664,10241,278280,268039,Yes
KLSGIT,Data Science,KCET,2023,55925,62238,17184,16609,151956,135347,Yes
HKBK,Chemical Engineering,COMEDK,2023,179703,86220,16181,14665,296769,282104,Yes
CMRIT,Biotechnology,KCET,2024,70698,67548,15385,26572,180203,153631,Yes
JNNCE,Civil Engineering,COMEDK,2023,170821,68681,14524,13022,267048,254026,No
VIT,Chemical Engineering,COMEDK,2024,210411,61529,14438,11661,298039,286378,Yes
SDMCET,Aerospace Engineering,KCET,2023,73253,75671,9804,21277,180005,158728,No
PESU,Electronics and Communication Engineering,COMEDK,2023,168271,72380,16537,27880,285068,257188,Yes
GIT,Electronics and Communication Engineering,COMEDK,2024,180940,91434,9184,27671,309229,281558,Yes
KLEIT,Mechanical Engineering,COMEDK,2023,199176,74905,13263,18591,305935,287344,No
EastPoint,Electrical and Electronics Engineering,KCET,2023,77341,68321,17866,27408,190936,163528,No
EastPoint,Aerospace Engineering,KCET,2023,68259,76426,17706,15379,177770,162391,Yes
VemanaIT,Electrical and Electronics Engineering,COMEDK,2023,191181,73564,19548,18313,302606,284293,No
JNNCE,Chemical Engineering,KCET,2024,76609,90462,15470,23753,206294,182541,No
YKCE,Electronics and Communication Engineering,KCET,2024,73857,63819,12121,24962,174759,149797,Yes
RNSIT,Information Science and Engineering,KCET,2024,56824,61924,13255,22744,154747,132003,No
AECMandya,Information Science and Engineering,KCET,2024,76319,70343,9352,17762,173776,156014,No
RNSIT,Electrical and Electronics Engineering,KCET,2024,71982,91998,12910,22424,199314,176890,Yes
DBIT,Electronics and Communication Engineering,KCET,2024,50446,74368,16067,26413,167294,140881,No
BMSCE,Robotics and Automation Engineering,KCET,2024,75924,71091,17368,13271,177654,164383,No
SCEM,Civil Engineering,KCET,2023,57955,85798,13641,23536,180930,157394,No
JIT,Computer Science and Engineering,COMEDK,2024,205914,87331,10039,11754,315038,303284,No
AEC,Civil Engineering,KCET,2024,79084,87833,13082,28077,208076,179999,No
SDMCET,Electronics and Communication Engineering,KCET,2023,54641,71684,15363,23627,165315,141688,Yes
RVUNIV,Aerospace Engineering,COMEDK,2023,179470,64915,15203,13410,272998,259588,No
VSM,Electronics and Communication Engineering,KCET,2024,69647,63008,9185,17238,159078,141840,Yes
NMIT,Aerospace Engineering,COMEDK,2023,179392,93526,9122,24174,306214,282040,No
MSRIT,Biotechnology,KCET,2023,79447,85134,11088,18746,194415,175669,No
PESCE,Electronics and Communication Engineering,COMEDK,2023,197637,88031,10601,21552,317821,296269,No
PESU,Mechanical Engineering,COMEDK,2024,215136,61000,10133,27909,314178,286269,No
REVA,Mechanical Engineering,COMEDK,2023,240675,69604,17103,26384,353766,327382,No
BIT,Artificial Intelligence and Data Science,KCET,2023,58894,93432,16984,13309,182619,169310,No
DrAIT,Mechanical Engineering,COMEDK,2024,184743,94159,14152,17829,310883,293054,No
CMRIT,Robotics and Automation Engineering,KCET,2023,77038,91779,15688,19311,203816,184505,No
MSRIT,Civil Engineering,COMEDK,2024,242653,74903,10186,14047,341789,327742,Yes
HKBK,Electrical and Electronics Engineering,KCET,2023,80567,81659,18133,18040,198399,180359,No
RAIT,Electrical and Electronics Engineering,KCET,2024,82416,84878,18556,29710,215560,185850,Yes
NCET,Biotechnology,COMEDK,2024,217129,72984,8284,12504,310901,298397,No
DSATM,Electrical and Electronics Engineering,KCET,2024,57300,80291,19462,19615,176668,157053,Yes
BMIT,Mechanical Engineering,COMEDK,2024,181257,82150,8663,15248,287318,272070,Yes
HKBK,Electrical and Electronics Engineering,KCET,2023,61505,63286,11957,14178,150926,136748,Yes
NIE,Chemical Engineering,COMEDK,2023,176173,93596,12303,22203,304275,282072,No
REVA,Data Science,KCET,2023,51720,83153,16173,10539,161585,151046,No
NIE,Artificial Intelligence and Data Science,KCET,2024,83409,66020,8177,11063,168669,157606,Yes
NIE,Civil Engineering,KCET,2024,59718,72496,19134,25947,177295,151348,Yes
AECMandya,Civil Engineering,KCET,2023,77475,91356,13671,13576,196078,182502,No
JIT,Information Science and Engineering,KCET,2023,70248,89612,8971,26105,194936,168831,No
SJBIT,Mechanical Engineering,COMEDK,2024,165222,77894,16505,24354,283975,259621,No
DBIT,Robotics and Automation Engineering,KCET,2024,54374,92160,11934,26948,185416,158468,No
VIT,Mechanical Engineering,COMEDK,2024,245357,61086,17558,18554,342555,324001,Yes
SJBIT,Biotechnology,KCET,2024,72410,87628,18497,23089,201624,178535,No
SDMIT,Artificial Intelligence and Data Science,COMEDK,2024,206730,87217,9359,28723,332029,303306,No
RIT,Electrical and Electronics Engineering,COMEDK,2024,249393,69963,19969,14693,354018,339325,No
YKCE,Chemical Engineering,KCET,2023,68810,75358,15381,26321,185870,159549,No
REVA,Aerospace Engineering,KCET,2024,52756,67775,9796,17883,148210,130327,Yes
PRES,Electrical and Electronics Engineering,COMEDK,2024,199519,89849,8407,14317,312092,297775,Yes
BMIT,Electrical and Electronics Engineering,KCET,2023,61959,70237,17763,12760,162719,149959,Yes
AEC,Biotechnology,COMEDK,2024,206931,76579,15865,23248,322623,299375,Yes
RVCE,Mechanical Engineering,KCET,2023,58876,84482,13097,29318,185773,156455,Yes
RNSIT,Mechanical Engineering,COMEDK,2023,235780,89625,9284,10694,345383,334689,No
BIT,Electronics and Communication Engineering,COMEDK,2023,162625,66878,9101,21061,259665,238604,Yes
SCEM,Chemical Engineering,KCET,2023,70382,63570,18023,11204,163179,151975,Yes
VSM,Mechanical Engineering,KCET,2024,57596,94470,16019,28421,196506,168085,No
MVJCE,Electrical and Electronics Engineering,COMEDK,2023,192364,79566,10340,28422,310692,282270,No
GIT,Computer Science and Engineering,KCET,2023,58490,92241,10073,15702,176506,160804,No
REVA,Robotics and Automation Engineering,COMEDK,2024,225722,79698,11861,15196,332477,317281,Yes
GIT,Chemical Engineering,KCET,2023,69920,91669,13178,13548,188315,174767,No
DSATM,Electrical and Electronics Engineering,KCET,2024,80165,72225,15601,10882,178873,167991,No
SJBCE,Artificial Intelligence and Data Science,COMEDK,2024,195685,74230,19024,10969,299908,288939,No
UVCE,Robotics and Automation Engineering,COMEDK,2023,189348,71598,14217,21811,296974,275163,Yes
RVCE,Data Science,KCET,2023,75553,62186,13830,25408,176977,151569,Yes
SJBCE,Artificial Intelligence and Data Science,KCET,2023,83871,73180,16571,25721,199343,173622,No
DSATM,Civil Engineering,COMEDK,2023,232373,84153,16616,24274,357416,333142,No
BMSIT,Mechanical Engineering,COMEDK,2024,183021,94020,11163,18565,306769,288204,No
EastPoint,Chemical Engineering,COMEDK,2023,242399,75063,11192,13760,342414,328654,Yes
PESCE,Computer Science and Engineering,KCET,2024,82002,94771,9430,19416,205619,186203,Yes
PRES,Aerospace Engineering,COMEDK,2024,192416,63925,8586,17778,282705,264927,Yes
PESU,Data Science,COMEDK,2024,219598,88438,14923,24017,346976,322959,No
BMSCE,Information Science and Engineering,COMEDK,2023,240495,72160,19724,22527,354906,332379,Yes
KLEIT,Artificial Intelligence and Data Science,COMEDK,2023,180717,75309,12750,21753,290529,268776,No
JSSSTU,Robotics and Automation Engineering,COMEDK,2023,184318,77914,14317,26892,303441,276549,Yes
AIT,Data Science,COMEDK,2024,195629,83754,8789,21792,309964,288172,Yes
PRES,Robotics and Automation Engineering,KCET,2024,54090,72726,8260,18013,153089,135076,Yes
RIT,Information Science and Engineering,COMEDK,2023,233616,74971,12033,21500,342120,320620,Yes
MSRIT,Robotics and Automation Engineering,KCET,2023,76019,87845,13172,15297,192333,177036,No
RVCE,Robotics and Automation Engineering,KCET,2024,83294,83375,14709,17558,198936,181378,No
AECMandya,Artificial Intelligence and Data Science,COMEDK,2024,239169,62995,8621,24008,334793,310785,Yes
AEC,Mechanical Engineering,COMEDK,2024,240094,89944,11033,27766,368837,341071,Yes
DSCE,Data Science,KCET,2023,70167,93763,19162,20684,203776,183092,Yes
RVCE,Data Science,KCET,2024,51218,90276,19279,24158,184931,160773,Yes
KLSGIT,Electrical and Electronics Engineering,KCET,2024,60653,92498,10950,12407,176508,164101,Yes
SITM,Mechanical Engineering,KCET,2023,50586,66295,14560,12660,144101,131441,No
VemanaIT,Chemical Engineering,COMEDK,2023,246142,66435,19773,24545,356895,332350,Yes
VemanaIT,Mechanical Engineering,KCET,2024,71832,76625,10035,22430,180922,158492,No
BMSIT,Biotechnology,COMEDK,2023,235645,65316,11616,24487,337064,312577,Yes
EastPoint,Biotechnology,KCET,2024,54690,89770,11131,10892,166483,155591,No
SJBIT,Electronics and Communication Engineering,COMEDK,2024,206784,60139,12807,14062,293792,279730,Yes
MVJCE,Mechanical Engineering,KCET,2024,80413,85072,18713,10858,195056,184198,Yes
SDMCET,Aerospace Engineering,COMEDK,2023,194078,85804,17382,16105,313369,297264,Yes
KSIT,Biotechnology,COMEDK,2023,232969,61791,11185,14215,320160,305945,Yes
AECMandya,Computer Science and Engineering,COMEDK,2024,232063,83055,19435,12856,347409,334553,No
BITM,Electronics and Communication Engineering,COMEDK,2023,172724,91191,10152,28719,302786,274067,No
MSRIT,Aerospace Engineering,COMEDK,2023,201107,80968,18477,15149,315701,300552,Yes
DSCE,Computer Science and Engineering,COMEDK,2024,203775,74085,17503,22698,318061,295363,No
AEC,Mechanical Engineering,KCET,2023,50685,60868,11258,27986,150797,122811,Yes
PESU,Mechanical Engineering,COMEDK,2024,193393,76465,11789,17758,299405,281647,No
UVCE,Biotechnology,COMEDK,2023,211991,73937,15324,23402,324654,301252,No
DrAIT,Information Science and Engineering,KCET,2024,59461,93044,12212,13996,178713,164717,No
BMSIT,Information Science and Engineering,KCET,2024,55171,65335,18806,24156,163468,139312,Yes
RIT,Civil Engineering,KCET,2023,50212,61662,8393,22410,142677,120267,No
MVJCE,Mechanical Engineering,COMEDK,2023,160233,88334,17707,23060,289334,266274,No
BMIT,Chemical Engineering,COMEDK,2024,170913,84090,19922,26052,300977,274925,No
DrAIT,Artificial Intelligence and Data Science,KCET,2023,81183,88454,10203,13647,193487,179840,No
AIT,Aerospace Engineering,COMEDK,2024,161842,72904,16090,12669,263505,250836,Yes
PESU,Electronics and Communication Engineering,KCET,2023,64627,81359,11498,22510,179994,157484,Yes
VemanaIT,Biotechnology,COMEDK,2024,219865,71900,19921,27184,338870,311686,No
BIT,Information Science and Engineering,KCET,2024,56092,88800,18467,13231,176590,163359,Yes
AIT,Data Science,COMEDK,2023,187328,89651,9157,19025,305161,286136,Yes
SDMCET,Robotics and Automation Engineering,KCET,2023,57465,70056,16881,10540,154942,144402,No
RAIT,Biotechnology,KCET,2024,72041,72379,18860,18239,181519,163280,Yes
DrAIT,Computer Science and Engineering,KCET,2023,53043,60997,11871,13499,139410,125911,Yes
BIT,Chemical Engineering,KCET,2024,66139,73506,14072,13869,167586,153717,Yes
PRES,Civil Engineering,KCET,2024,63548,88040,18989,24786,195363,170577,No
CITGubbi,Robotics and Automation Engineering,COMEDK,2023,206907,94711,18212,19509,339339,319830,Yes
BMSIT,Aerospace Engineering,KCET,2024,59277,73837,8391,28532,170037,141505,Yes
SDMIT,Chemical Engineering,KCET,2023,66798,77441,16137,28976,189352,160376,Yes
SJBIT,Biotechnology,COMEDK,2024,178944,78942,16407,19740,294033,274293,No
UVCE,Information Science and Engineering,KCET,2024,68792,77601,12889,23149,182431,159282,No
NHCE,Civil Engineering,COMEDK,2023,180419,72797,10769,17508,281493,263985,Yes
MVJCE,Robotics and Automation Engineering,COMEDK,2024,202059,70295,12100,29260,313714,284454,Yes
DSATM,Robotics and Automation Engineering,COMEDK,2023,218021,86654,11749,14042,330466,316424,No
AECMandya,Information Science and Engineering,COMEDK,2024,243348,94922,10087,28514,376871,348357,Yes
HKBK,Electrical and Electronics Engineering,KCET,2024,76839,89714,16708,12794,196055,183261,Yes
AIT,Biotechnology,COMEDK,2023,220110,82706,17220,24025,344061,320036,No
JSSSTU,Data Science,COMEDK,2023,195478,74232,9041,20001,298752,278751,Yes
REVA,Robotics and Automation Engineering,KCET,2024,76313,91083,16388,29600,213384,183784,Yes
GIT,Aerospace Engineering,COMEDK,2024,224051,72163,10355,15596,322165,306569,No
PESU,Artificial Intelligence and Data Science,KCET,2024,72727,73235,9351,27471,182784,155313,Yes
REVA,Biotechnology,COMEDK,2023,198216,63465,8400,18667,288748,270081,No
RVUNIV,Artificial Intelligence and Data Science,COMEDK,2023,224678,64777,8577,28292,326324,298032,No
SJBCE,Robotics and Automation Engineering,KCET,2024,64976,89681,8450,13186,176293,163107,No
VemanaIT,Artificial Intelligence and Data Science,KCET,2024,71864,67372,11946,23467,174649,151182,Yes
BMSIT,Electronics and Communication Engineering,KCET,2024,72320,72182,14892,11266,170660,159394,No
VVIT,Data Science,KCET,2023,63614,76148,18949,10534,169245,158711,No
VIT,Data Science,COMEDK,2023,207537,83533,18306,24115,333491,309376,No
SJBCE,Civil Engineering,KCET,2023,54810,71772,15214,17999,159795,141796,Yes
AIT,Mechanical Engineering,KCET,2024,54394,64435,11018,26729,156576,129847,No
RVUNIV,Data Science,COMEDK,2024,183291,83743,15226,28131,310391,282260,Yes
SDMCET,Mechanical Engineering,KCET,2023,71868,69508,9597,12225,163198,150973,Yes
KSIT,Artificial Intelligence and Data Science,KCET,2024,56595,71910,13034,26258,167797,141539,No
KLEIT,Artificial Intelligence and Data Science,KCET,2024,62425,87845,17912,13252,181434,168182,No
MSRIT,Information Science and Engineering,KCET,2024,77603,69895,13777,11595,172870,161275,Yes
SDMIT,Civil Engineering,COMEDK,2023,166496,92166,11311,12584,282557,269973,Yes
NMIT,Electronics and Communication Engineering,COMEDK,2024,181840,91355,16187,13232,302614,289382,No
AIT,Computer Science and Engineering,COMEDK,2023,247268,70934,14314,11869,344385,332516,Yes
AECMandya,Artificial Intelligence and Data Science,COMEDK,2023,246311,62960,8101,12391,329763,317372,Yes
BITM,Computer Science and Engineering,COMEDK,2024,203185,78995,16971,21312,320463,299151,No
RAIT,Civil Engineering,COMEDK,2023,233357,89938,10239,10298,343832,333534,No
VSM,Electrical and Electronics Engineering,COMEDK,2023,229586,65449,9921,20695,325651,304956,No
CITGubbi,Biotechnology,COMEDK,2024,188824,65998,18385,29634,302841,273207,Yes
KLEIT,Artificial Intelligence and Data Science,COMEDK,2024,205767,83814,16105,16348,322034,305686,Yes
REVA,Artificial Intelligence and Data Science,COMEDK,2023,234294,77039,9547,16674,337554,320880,No
RIT,Data Science,COMEDK,2023,218339,83261,10324,28066,339990,311924,No
SDMIT,Chemical Engineering,COMEDK,2024,176199,73414,9401,23239,282253,259014,No
BIT,Chemical Engineering,KCET,2023,56875,73671,12196,21568,164310,142742,Yes
RIT,Artificial Intelligence and Data Science,KCET,2024,76329,83368,9327,11512,180536,169024,Yes
YKCE,Electrical and Electronics Engineering,COMEDK,2024,217145,74429,19244,16092,326910,310818,No
VSM,Biotechnology,COMEDK,2024,196690,78383,18459,13540,307072,293532,Yes
JSSSTU,Artificial Intelligence and Data Science,COMEDK,2024,218384,90227,11620,27761,347992,320231,No
SJBCE,Mechanical Engineering,KCET,2024,80105,80660,13089,27124,200978,173854,No
KLSGIT,Biotechnology,KCET,2023,64917,82930,13205,22137,183189,161052,No
BITM,Biotechnology,KCET,2023,68029,89689,12844,29095,199657,170562,Yes
EastPoint,Mechanical Engineering,KCET,2023,76197,75565,18063,16676,186501,169825,No
AIT,Biotechnology,COMEDK,2024,226744,71960,16156,24007,338867,314860,No
SDMIT,Data Science,KCET,2024,80332,61730,12632,14980,169674,154694,No
GMIT,Robotics and Automation Engineering,KCET,2023,73052,62433,12306,24584,172375,147791,No
JSSSTU,Data Science,COMEDK,2024,219953,65486,9060,29416,323915,294499,Yes
BMIT,Biotechnology,KCET,2023,52509,90793,14972,21510,179784,158274,Yes
NIE,Mechanical Engineering,KCET,2024,54112,69220,11278,19305,153915,134610,Yes
SJBCE,Mechanical Engineering,COMEDK,2023,228187,67777,16483,21348,333795,312447,No
KSIT,Information Science and Engineering,KCET,2023,50440,69879,13889,20780,154988,134208,No
SCEM,Chemical Engineering,COMEDK,2024,200141,87426,17633,12750,317950,305200,Yes
PESU,Artificial Intelligence and Data Science,KCET,2024,74798,77561,16147,13371,181877,168506,No
RNSIT,Aerospace Engineering,KCET,2024,62823,64362,18892,29487,175564,146077,Yes
SDMCET,Electrical and Electronics Engineering,COMEDK,2024,233326,71521,18802,21517,345166,323649,Yes
NCET,Electrical and Electronics Engineering,COMEDK,2024,224175,80422,12357,17989,334943,316954,Yes
AECMandya,Computer Science and Engineering,KCET,2024,55677,66154,13965,20849,156645,135796,No
JSSSTU,Computer Science and Engineering,COMEDK,2024,242594,70417,8291,10897,332199,321302,No
JIT,Electronics and Communication Engineering,COMEDK,2023,206748,79058,17330,19132,322268,303136,Yes
NIE,Artificial Intelligence and Data Science,KCET,2024,74693,78027,11884,17599,182203,164604,Yes
VVIT,Electrical and Electronics Engineering,COMEDK,2023,162352,76404,9794,15935,264485,248550,No
DrAIT,Data Science,KCET,2024,63079,91086,9294,26431,189890,163459,Yes
JSSSTU,Biotechnology,KCET,2024,67564,72691,13293,27535,181083,153548,No
AITM,Mechanical Engineering,COMEDK,2023,185371,62947,11028,16806,276152,259346,Yes
MSRUAS,Biotechnology,KCET,2023,74416,68886,15604,24694,183600,158906,Yes
CITGubbi,Information Science and Engineering,COMEDK,2023,170102,76086,17178,11918,275284,263366,No
BITM,Artificial Intelligence and Data Science,KCET,2024,62818,83998,10968,17552,175336,157784,Yes
YKCE,Civil Engineering,COMEDK,2023,236728,67859,15963,18092,338642,320550,Yes
BITM,Computer Science and Engineering,COMEDK,2023,185996,82059,12863,21597,302515,280918,No
KLEIT,Aerospace Engineering,KCET,2024,77441,84963,10462,19075,191941,172866,No
SIT,Mechanical Engineering,COMEDK,2023,218116,75366,19440,26663,339585,312922,Yes
SJBCE,Electrical and Electronics Engineering,KCET,2023,69827,77571,12399,26585,186382,159797,No
AEC,Electronics and Communication Engineering,KCET,2023,51966,77890,8463,25383,163702,138319,No
RIT,Computer Science and Engineering,COMEDK,2024,195748,84547,9907,27860,318062,290202,No
VIT,Aerospace Engineering,KCET,2023,66135,67157,10641,10763,154696,143933,No
JNNCE,Electronics and Communication Engineering,COMEDK,2023,242490,91207,8959,25423,368079,342656,Yes
SITM,Computer Science and Engineering,COMEDK,2024,177404,63325,10338,16453,267520,251067,No
YKCE,Mechanical Engineering,COMEDK,2023,239947,73740,17538,25898,357123,331225,Yes
NCET,Mechanical Engineering,COMEDK,2023,234355,91477,17495,25832,369159,343327,No
NCET,Aerospace Engineering,KCET,2023,84805,63177,19175,13374,180531,167157,No
REVA,Mechanical Engineering,COMEDK,2024,183302,63127,9398,21247,277074,255827,No
DrAIT,Computer Science and Engineering,COMEDK,2023,204420,60404,15275,22805,302904,280099,Yes
KLEIT,Mechanical Engineering,COMEDK,2023,216418,85079,19941,14166,335604,321438,No
VVIT,Biotechnology,COMEDK,2023,202584,88938,16510,25650,333682,308032,Yes
SDMCET,Computer Science and Engineering,KCET,2024,63334,85443,12195,23187,184159,160972,No
UVCE,Mechanical Engineering,KCET,2024,55249,92132,19369,23628,190378,166750,No
SJBIT,Robotics and Automation Engineering,KCET,2023,79979,87956,15416,27266,210617,183351,No
SCEM,Biotechnology,COMEDK,2023,191358,64333,10218,29052,294961,265909,Yes
SIT,Computer Science and Engineering,COMEDK,2023,216947,81948,14477,21765,335137,313372,No
VIT,Electronics and Communication Engineering,COMEDK,2023,219750,82174,13854,14835,330613,315778,Yes
BMSIT,Chemical Engineering,COMEDK,2024,240596,81416,19878,24884,366774,341890,No
RAIT,Aerospace Engineering,KCET,2024,55432,85640,14615,14652,170339,155687,No
GMIT,Electrical and Electronics Engineering,COMEDK,2023,195793,91246,9940,13767,310746,296979,No
CMRIT,Data Science,COMEDK,2024,197237,67209,10665,16076,291187,275111,Yes
SDMIT,Electronics and Communication Engineering,KCET,2024,61166,86159,9478,15891,172694,156803,No
REVA,Artificial Intelligence and Data Science,KCET,2023,68384,76376,10909,10103,165772,155669,No
AIT,Civil Engineering,COMEDK,2024,209345,62083,17887,27920,317235,289315,Yes
PRES,Electronics and Communication Engineering,COMEDK,2023,206358,74945,10753,26291,318347,292056,No
BMSIT,Artificial Intelligence and Data Science,COMEDK,2023,171466,66113,11945,19681,269205,249524,No
BMSCE,Robotics and Automation Engineering,KCET,2023,81428,90575,15142,20206,207351,187145,No
SCEM,Chemical Engineering,KCET,2024,83528,74309,12855,22255,192947,170692,No
AEC,Electronics and Communication Engineering,KCET,2024,75515,71227,9046,27027,182815,155788,Yes
BMIT,Chemical Engineering,COMEDK,2024,192049,74681,9660,20864,297254,276390,No
RAIT,Electrical and Electronics Engineering,KCET,2023,51887,84301,13506,22575,172269,149694,No
DSCE,Robotics and Automation Engineering,KCET,2023,76996,82732,14330,12939,186997,174058,Yes
DrAIT,Artificial Intelligence and Data Science,COMEDK,2023,218704,60403,19253,13251,311611,298360,No
RAIT,Biotechnology,KCET,2024,53610,69002,18966,16631,158209,141578,Yes
MSRUAS,Computer Science and Engineering,KCET,2024,59517,88330,18445,28508,194800,166292,No
RVUNIV,Electrical and Electronics Engineering,COMEDK,2024,244858,77399,12769,23789,358815,335026,No
AECMandya,Mechanical Engineering,KCET,2024,57372,82166,9566,17414,166518,149104,Yes
NMIT,Information Science and Engineering,COMEDK,2024,192969,83913,17666,25626,320174,294548,Yes
AIT,Data Science,KCET,2024,80810,84770,11316,16370,193266,176896,Yes
DSCE,Aerospace Engineering,KCET,2024,59639,91256,9949,27692,188536,160844,No
REVA,Information Science and Engineering,COMEDK,2024,218808,81488,12965,24296,337557,313261,Yes
RAIT,Chemical Engineering,KCET,2024,71891,68202,8778,21321,170192,148871,Yes
DSCE,Biotechnology,COMEDK,2023,180689,68453,12835,22935,284912,261977,No
SJBCE,Electrical and Electronics Engineering,KCET,2023,51716,77687,15694,18499,163596,145097,No
RVCE,Computer Science and Engineering,KCET,2023,52201,87243,8720,23546,171710,148164,Yes
JIT,Aerospace Engineering,COMEDK,2024,184789,75338,17768,11115,289010,277895,Yes
CITGubbi,Civil Engineering,COMEDK,2023,172167,83536,17828,23258,296789,273531,No
PRES,Electronics and Communication Engineering,COMEDK,2024,212073,60372,8260,23966,304671,280705,Yes
CMRIT,Biotechnology,COMEDK,2024,231545,80093,12678,13834,338150,324316,Yes
GMIT,Biotechnology,KCET,2024,80090,82299,19733,19361,201483,182122,Yes
DSCE,Electronics and Communication Engineering,COMEDK,2023,226602,84052,16660,27750,355064,327314,No
NCET,Civil Engineering,COMEDK,2024,180618,74545,8422,23345,286930,263585,Yes
GIT,Biotechnology,KCET,2024,52946,86243,10227,15434,164850,149416,Yes
DrAIT,Robotics and Automation Engineering,KCET,2023,64969,75360,14154,22135,176618,154483,No
VSM,Computer Science and Engineering,COMEDK,2024,221921,94360,8722,13036,338039,325003,No
UVCE,Chemical Engineering,COMEDK,2023,177983,94076,15765,18990,306814,287824,Yes
BMSIT,Biotechnology,COMEDK,2023,196341,92830,17699,28557,335427,306870,No
EastPoint,Computer Science and Engineering,KCET,2023,52014,80037,11812,16831,160694,143863,Yes
CITGubbi,Data Science,COMEDK,2024,224272,86911,15968,17622,344773,327151,Yes
BIT,Computer Science and Engineering,KCET,2024,85000,78736,13990,26730,204456,177726,Yes
SCEM,Civil Engineering,COMEDK,2023,184731,93645,13699,14395,306470,292075,No
GIT,Computer Science and Engineering,KCET,2023,68563,91373,12795,10262,182993,172731,Yes
BMSCE,Chemical Engineering,KCET,2024,79766,77551,8240,11378,176935,165557,Yes
JIT,Civil Engineering,KCET,2023,83916,74033,18554,13884,190387,176503,No
AEC,Electronics and Communication Engineering,COMEDK,2023,218166,69945,9376,26831,324318,297487,No
RAIT,Robotics and Automation Engineering,COMEDK,2024,227196,89591,9220,12365,338372,326007,Yes
KLSGIT,Data Science,COMEDK,2024,213810,65998,14055,29842,323705,293863,Yes
PESU,Computer Science and Engineering,COMEDK,2023,182536,94897,19319,28072,324824,296752,Yes
CITGubbi,Aerospace Engineering,COMEDK,2023,232625,74477,19345,27334,353781,326447,No
RIT,Electronics and Communication Engineering,KCET,2024,63375,87940,12236,21388,184939,163551,No
RNSIT,Chemical Engineering,KCET,2024,69632,60371,14822,11478,156303,144825,No
DSATM,Electronics and Communication Engineering,KCET,2024,54501,80939,19001,22101,176542,154441,No
UVCE,Electrical and Electronics Engineering,COMEDK,2024,183284,79096,9491,18244,290115,271871,No
SCEM,Chemical Engineering,COMEDK,2023,192020,94803,16154,28724,331701,302977,Yes
NCET,Biotechnology,KCET,2024,79478,81352,12352,27819,201001,173182,Yes
JSSSTU,Electronics and Communication Engineering,COMEDK,2023,245514,65765,9860,10875,332014,321139,No
PRES,Aerospace Engineering,KCET,2024,52894,88875,15754,28933,186456,157523,No
RVCE,Electronics and Communication Engineering,COMEDK,2023,227567,68796,8753,20652,325768,305116,No
CITGubbi,Mechanical Engineering,KCET,2023,76184,87488,18835,17127,199634,182507,Yes
SJBCE,Civil Engineering,COMEDK,2023,244624,60324,18163,13546,336657,323111,Yes
CITGubbi,Electrical and Electronics Engineering,COMEDK,2023,244961,61986,15618,15942,338507,322565,No
AITM,Aerospace Engineering,COMEDK,2024,182483,69782,19238,13533,285036,271503,No
BMSIT,Artificial Intelligence and Data Science,COMEDK,2024,191623,60368,12681,19029,283701,264672,Yes
KLEIT,Chemical Engineering,COMEDK,2024,180565,79760,11878,19728,291931,272203,No
CITGubbi,Electrical and Electronics Engineering,KCET,2023,60389,80099,9412,11128,161028,149900,Yes
VIT,Information Science and Engineering,COMEDK,2023,176069,72005,16013,13723,277810,264087,Yes
SJBCE,Civil Engineering,KCET,2023,66963,76411,12525,12732,168631,155899,No
KSIT,Artificial Intelligence and Data Science,KCET,2023,71081,71852,17222,20080,180235,160155,No
SDMIT,Electronics and Communication Engineering,COMEDK,2023,161615,83312,13002,16134,274063,257929,No
BITM,Information Science and Engineering,COMEDK,2023,232011,79568,19826,25202,356607,331405,No
UVCE,Data Science,KCET,2024,60983,65528,9382,22710,158603,135893,Yes
KLSGIT,Mechanical Engineering,KCET,2024,72666,66968,19181,16370,175185,158815,No
SJBIT,Robotics and Automation Engineering,COMEDK,2023,234317,74950,11690,29058,350015,320957,No
SIT,Civil Engineering,KCET,2023,58918,74006,14322,16199,163445,147246,Yes
AITM,Biotechnology,COMEDK,2023,248335,82973,8372,20377,360057,339680,No
DSCE,Electrical and Electronics Engineering,COMEDK,2023,161111,67696,19484,17616,265907,248291,Yes
BMSIT,Biotechnology,COMEDK,2023,169162,61235,9817,13839,254053,240214,Yes
VIT,Information Science and Engineering,COMEDK,2023,239107,82325,11156,25759,358347,332588,Yes
VSM,Mechanical Engineering,KCET,2023,59722,75865,15078,20316,170981,150665,Yes
SDMIT,Chemical Engineering,COMEDK,2024,222254,61514,19613,25325,328706,303381,No
REVA,Electrical and Electronics Engineering,COMEDK,2023,197881,62866,13539,25592,299878,274286,No
HKBK,Electronics and Communication Engineering,KCET,2023,70132,61693,17735,16310,165870,149560,Yes
VIT,Mechanical Engineering,KCET,2024,78633,72888,10355,18340,180216,161876,Yes
DSCE,Civil Engineering,COMEDK,2023,193726,69979,16272,24506,304483,279977,Yes
CITGubbi,Civil Engineering,KCET,2023,81002,90269,9473,26088,206832,180744,No
BMSIT,Data Science,KCET,2023,82025,80763,16024,13635,192447,178812,Yes
NMIT,Civil Engineering,COMEDK,2023,226252,77364,14057,12050,329723,317673,Yes
DBIT,Aerospace Engineering,COMEDK,2023,214123,72747,11636,20966,319472,298506,Yes
PESCE,Biotechnology,COMEDK,2023,181108,82300,13049,23644,300101,276457,Yes
VSM,Mechanical Engineering,COMEDK,2024,232148,72468,17243,26754,348613,321859,Yes
JSSSTU,Information Science and Engineering,COMEDK,2024,170080,77630,9146,11728,268584,256856,Yes
SITM,Information Science and Engineering,COMEDK,2023,206167,84292,10518,17241,318218,300977,Yes
VSM,Robotics and Automation Engineering,COMEDK,2023,165890,79353,17389,25145,287777,262632,Yes
NHCE,Electrical and Electronics Engineering,COMEDK,2023,209493,74915,13316,21657,319381,297724,No
RAIT,Robotics and Automation Engineering,COMEDK,2024,242881,87889,14588,15839,361197,345358,No
DSATM,Robotics and Automation Engineering,KCET,2024,58884,88566,18800,18518,184768,166250,No
VSM,Computer Science and Engineering,COMEDK,2023,239013,87558,13678,19064,359313,340249,Yes
DSCE,Electronics and Communication Engineering,COMEDK,2024,177859,78371,12373,20720,289323,268603,Yes
DrAIT,Robotics and Automation Engineering,COMEDK,2023,167632,73347,12724,19626,273329,253703,No
BMSIT,Electrical and Electronics Engineering,COMEDK,2024,237278,77794,10372,19982,345426,325444,Yes
VVIT,Robotics and Automation Engineering,COMEDK,2024,170735,94313,19752,10807,295607,284800,No
SCEM,Electrical and Electronics Engineering,KCET,2024,58918,79567,16518,16737,171740,155003,Yes
RIT,Biotechnology,KCET,2024,55959,64222,14243,15255,149679,134424,Yes
BIT,Electrical and Electronics Engineering,KCET,2024,83863,64485,9009,24447,181804,157357,Yes
SDMIT,Robotics and Automation Engineering,COMEDK,2023,208246,94490,15532,20084,338352,318268,No
YKCE,Data Science,COMEDK,2023,185105,63013,19759,20806,288683,267877,Yes
NMIT,Data Science,KCET,2024,50522,73678,19299,13285,156784,143499,No
BMSCE,Electronics and Communication Engineering,KCET,2024,69959,88407,13375,18411,190152,171741,Yes
SDMCET,Electrical and Electronics Engineering,COMEDK,2024,181541,79960,9222,12842,283565,270723,Yes
ACU,Mechanical Engineering,COMEDK,2023,167404,84871,11077,24980,288332,263352,Yes
KLEIT,Electronics and Communication Engineering,KCET,2023,72926,70807,8366,13437,165536,152099,No
VIT,Biotechnology,KCET,2024,57070,74293,12896,22036,166295,144259,No
DrAIT,Mechanical Engineering,KCET,2023,66915,87022,9334,17263,180534,163271,Yes
DSATM,Electronics and Communication Engineering,COMEDK,2023,199907,67286,9011,20397,296601,276204,Yes
DrAIT,Mechanical Engineering,KCET,2023,65350,77912,9772,20753,173787,153034,No
MSRUAS,Aerospace Engineering,COMEDK,2024,205394,65646,12017,28735,311792,283057,No
SJBCE,Mechanical Engineering,KCET,2024,53843,65898,13476,23566,156783,133217,Yes
NHCE,Electronics and Communication Engineering,KCET,2024,81006,80426,9458,10841,181731,170890,Yes
SIT,Robotics and Automation Engineering,COMEDK,2024,194190,68473,17094,26858,306615,279757,Yes
SCEM,Civil Engineering,KCET,2024,66318,78921,11810,12435,169484,157049,Yes
SDMCET,Information Science and Engineering,COMEDK,2024,172532,68412,13582,13800,268326,254526,No
SITM,Aerospace Engineering,COMEDK,2023,173705,93057,14343,20330,301435,281105,Yes
DrAIT,Civil Engineering,KCET,2023,68594,83055,19094,26075,196818,170743,No
NCET,Electrical and Electronics Engineering,KCET,2023,70697,61612,17752,28885,178946,150061,Yes
SITM,Artificial Intelligence and Data Science,KCET,2024,61450,69685,18719,22177,172031,149854,Yes
AECMandya,Electronics and Communication Engineering,KCET,2023,52546,63512,12818,24554,153430,128876,Yes
MSRIT,Biotechnology,COMEDK,2023,214981,85572,18938,22666,342157,319491,No
SJBCE,Aerospace Engineering,COMEDK,2024,170598,80266,9514,29310,289688,260378,Yes
NMIT,Information Science and Engineering,COMEDK,2023,213576,77290,8245,23653,322764,299111,No
SITM,Information Science and Engineering,KCET,2024,83119,81380,16230,26462,207191,180729,No
VVCE,Information Science and Engineering,KCET,2024,79358,71156,15474,16462,182450,165988,Yes
DSCE,Chemical Engineering,KCET,2023,67780,90362,17877,17947,193966,176019,Yes
BITM,Electrical and Electronics Engineering,COMEDK,2023,207543,73725,10220,10366,301854,291488,Yes
DBIT,Data Science,COMEDK,2024,199607,72041,16691,18710,307049,288339,Yes
MVJCE,Data Science,COMEDK,2023,203878,90583,19037,21383,334881,313498,No
VVIT,Artificial Intelligence and Data Science,KCET,2023,79477,62696,17081,23109,182363,159254,No
KLEIT,Aerospace Engineering,KCET,2024,60299,77956,11829,12635,162719,150084,Yes
SIT,Chemical Engineering,KCET,2023,65195,69286,19566,20886,174933,154047,No
PESU,Electronics and Communication Engineering,KCET,2024,76186,70624,18521,14614,179945,165331,Yes
SITM,Mechanical Engineering,COMEDK,2023,219865,73627,12820,23534,329846,306312,No
REVA,Aerospace Engineering,KCET,2023,53146,75531,11553,10086,150316,140230,No
SDMIT,Mechanical Engineering,COMEDK,2023,225499,87920,15999,20607,350025,329418,Yes
KSIT,Robotics and Automation Engineering,COMEDK,2023,214061,79616,8665,18016,320358,302342,Yes
NCET,Chemical Engineering,KCET,2023,56971,70525,12902,16588,156986,140398,No
BITM,Electronics and Communication Engineering,KCET,2024,51275,81646,15960,25596,174477,148881,Yes
RAIT,Aerospace Engineering,KCET,2023,63462,80190,17984,15596,177232,161636,No
CMRIT,Artificial Intelligence and Data Science,KCET,2024,73559,84175,16609,20999,195342,174343,No
MSRUAS,Information Science and Engineering,KCET,2023,61604,68333,9667,23565,163169,139604,Yes
BMSIT,Data Science,KCET,2023,71419,94943,18557,26147,211066,184919,No
EastPoint,Civil Engineering,COMEDK,2024,190419,84332,16678,10419,301848,291429,Yes
UVCE,Robotics and Automation Engineering,KCET,2023,83784,68428,19002,13403,184617,171214,No
VVIT,Aerospace Engineering,COMEDK,2024,166614,66329,9114,17067,259124,242057,No
JNNCE,Artificial Intelligence and Data Science,COMEDK,2024,225979,64739,10233,23746,324697,300951,No
CITGubbi,Aerospace Engineering,COMEDK,2023,187792,64656,16639,27276,296363,269087,No
BNMIT,Computer Science and Engineering,COMEDK,2024,181237,75358,9800,27019,293414,266395,No
SJBIT,Mechanical Engineering,KCET,2024,50277,92699,12750,22638,178364,155726,Yes
CMRIT,Information Science and Engineering,KCET,2023,80993,93766,18282,28432,221473,193041,No
SITM,Electronics and Communication Engineering,KCET,2024,54007,60432,14580,29008,158027,129019,No
BIT,Electrical and Electronics Engineering,KCET,2023,59491,70084,12078,29757,171410,141653,No
ACU,Mechanical Engineering,COMEDK,2023,224977,73453,18888,27769,345087,317318,No
KLEIT,Aerospace Engineering,COMEDK,2024,244080,68061,9893,26422,348456,322034,No
NMIT,Computer Science and Engineering,KCET,2024,66714,66278,13123,18518,164633,146115,No
AECMandya,Aerospace Engineering,COMEDK,2023,198312,65367,18222,23848,305749,281901,No
JNNCE,Mechanical Engineering,COMEDK,2024,179001,77269,8579,22723,287572,264849,Yes
JNNCE,Aerospace Engineering,KCET,2023,68012,80249,8767,14025,171053,157028,No
KSIT,Civil Engineering,KCET,2023,61872,94816,16735,13541,186964,173423,No
KLEIT,Information Science and Engineering,KCET,2024,71771,93334,18176,23960,207241,183281,No
BMIT,Civil Engineering,COMEDK,2023,186440,81506,12033,22932,302911,279979,No
RNSIT,Civil Engineering,KCET,2024,66309,67801,15056,29009,178175,149166,Yes
MSRUAS,Robotics and Automation Engineering,KCET,2024,74495,81474,16325,15726,188020,172294,No
PESU,Civil Engineering,COMEDK,2024,198347,63203,8365,11128,281043,269915,No
AECMandya,Artificial Intelligence and Data Science,KCET,2024,67183,75034,19188,24047,185452,161405,Yes
REVA,Electrical and Electronics Engineering,COMEDK,2024,226081,61762,19804,28305,335952,307647,No
NMIT,Data Science,KCET,2023,72122,72645,15353,24302,184422,160120,No
SITM,Electrical and Electronics Engineering,KCET,2023,79922,69167,10180,21096,180365,159269,No
BNMIT,Chemical Engineering,KCET,2024,70093,69536,8145,11291,159065,147774,Yes
RIT,Mechanical Engineering,KCET,2023,69262,93669,14237,13139,190307,177168,No
BMSCE,Artificial Intelligence and Data Science,KCET,2023,80705,63969,14374,28200,187248,159048,No
KLSGIT,Civil Engineering,COMEDK,2023,247536,84422,18298,27224,377480,350256,No
PRES,Information Science and Engineering,COMEDK,2024,195365,71031,15205,16372,297973,281601,Yes
MSRIT,Chemical Engineering,COMEDK,2023,214141,71801,19257,16965,322164,305199,Yes
NCET,Mechanical Engineering,KCET,2023,56805,64317,17700,27228,166050,138822,No
BMSIT,Mechanical Engineering,COMEDK,2024,203447,61354,18367,25056,308224,283168,No
PESCE,Civil Engineering,KCET,2024,74501,82526,16997,24788,198812,174024,No
MSRIT,Chemical Engineering,KCET,2024,77423,82249,18475,29100,207247,178147,Yes
ACU,Electronics and Communication Engineering,COMEDK,2024,181045,68552,8860,29744,288201,258457,Yes
MSRIT,Computer Science and Engineering,COMEDK,2024,238146,68416,11313,27624,345499,317875,No
EastPoint,Computer Science and Engineering,KCET,2023,64611,75799,18659,13120,172189,159069,No
BITM,Information Science and Engineering,KCET,2023,52269,75692,19465,29156,176582,147426,No
DSCE,Civil Engineering,COMEDK,2023,240364,86771,13457,16278,356870,340592,No
AEC,Electrical and Electronics Engineering,KCET,2024,72071,82663,19014,14240,187988,173748,No
GMIT,Mechanical Engineering,COMEDK,2023,176336,70380,10845,24346,281907,257561,No
UVCE,Mechanical Engineering,COMEDK,2023,207725,68097,18910,19133,313865,294732,Yes
RIT,Mechanical Engineering,COMEDK,2024,226744,79928,19876,24791,351339,326548,No
BIT,Aerospace Engineering,KCET,2024,56266,79954,17776,22532,176528,153996,No
BIT,Robotics and Automation Engineering,COMEDK,2024,233895,74839,16983,24682,350399,325717,Yes
EastPoint,Chemical Engineering,KCET,2024,64041,73691,15507,28575,181814,153239,Yes
KSIT,Electronics and Communication Engineering,KCET,2023,68199,80346,16930,24527,190002,165475,Yes
CITGubbi,Mechanical Engineering,COMEDK,2024,214871,69199,11041,24748,319859,295111,Yes
SDMIT,Biotechnology,KCET,2024,62919,80579,15124,10136,168758,158622,Yes
KLSGIT,Mechanical Engineering,KCET,2024,64871,65538,16730,13382,160521,147139,Yes
JIT,Data Science,COMEDK,2024,177317,79897,11427,15690,284331,268641,Yes
MVJCE,Data Science,KCET,2024,63463,80838,18279,22055,184635,162580,Yes
AITM,Robotics and Automation Engineering,KCET,2023,51740,62404,8384,22782,145310,122528,Yes
PRES,Electrical and Electronics Engineering,COMEDK,2024,189707,83061,19581,19752,312101,292349,Yes
ACU,Biotechnology,KCET,2024,74758,77643,19597,27262,199260,171998,No
RVUNIV,Aerospace Engineering,KCET,2024,55964,78990,8489,19939,163382,143443,No
SIT,Aerospace Engineering,COMEDK,2024,196814,94144,17479,15548,323985,308437,No
REVA,Electrical and Electronics Engineering,KCET,2023,52079,88189,19989,27183,187440,160257,Yes
MVJCE,Civil Engineering,KCET,2024,50607,88543,15616,25869,180635,154766,No
KLEIT,Robotics and Automation Engineering,KCET,2024,73109,68250,17563,24335,183257,158922,Yes
JSSSTU,Biotechnology,COMEDK,2023,220113,67121,9291,28826,325351,296525,Yes
KLSGIT,Aerospace Engineering,KCET,2023,76831,81375,11257,20134,189597,169463,Yes
KSIT,Biotechnology,KCET,2023,65643,86261,11256,13398,176558,163160,Yes
BMSCE,Mechanical Engineering,KCET,2023,61397,94959,8665,22830,187851,165021,Yes
PESU,Information Science and Engineering,KCET,2023,79502,70428,14678,26121,190729,164608,Yes
BMSCE,Artificial Intelligence and Data Science,KCET,2023,59452,81317,10054,11236,162059,150823,Yes
PESCE,Computer Science and Engineering,COMEDK,2023,180945,94548,9499,16970,301962,284992,No
CMRIT,Computer Science and Engineering,KCET,2024,82390,63659,19743,11966,177758,165792,No
DBIT,Computer Science and Engineering,COMEDK,2024,218784,81194,14827,18952,333757,314805,No
NCET,Mechanical Engineering,KCET,2024,60632,61577,18055,14341,154605,140264,No
AITM,Information Science and Engineering,KCET,2023,78875,85399,19231,17065,200570,183505,Yes
NCET,Computer Science and Engineering,COMEDK,2023,209253,89575,9209,26881,334918,308037,Yes
DSCE,Artificial Intelligence and Data Science,COMEDK,2024,193586,63695,18570,12535,288386,275851,No
NIE,Civil Engineering,COMEDK,2023,236674,89938,9351,23224,359187,335963,Yes
GIT,Electrical and Electronics Engineering,COMEDK,2024,189895,61822,18540,17265,287522,270257,Yes
VVIT,Biotechnology,COMEDK,2024,173117,84094,19764,18261,295236,276975,Yes
BITM,Information Science and Engineering,KCET,2023,60724,87595,18449,17620,184388,166768,Yes
SDMIT,Robotics and Automation Engineering,COMEDK,2024,238997,81949,11294,29596,361836,332240,No
SJBCE,Artificial Intelligence and Data Science,KCET,2024,79137,88436,8421,21929,197923,175994,No
NCET,Aerospace Engineering,COMEDK,2024,182879,89474,12093,22521,306967,284446,Yes
DSATM,Civil Engineering,COMEDK,2023,162993,85553,19340,19781,287667,267886,Yes
BNMIT,Data Science,KCET,2024,50369,89081,10274,11603,161327,149724,Yes
PESCE,Aerospace Engineering,KCET,2023,82891,85729,19939,11157,199716,188559,Yes
GIT,Biotechnology,KCET,2024,75573,77326,17075,12273,182247,169974,No
SJBIT,Aerospace Engineering,COMEDK,2024,176616,87918,9173,18608,292315,273707,Yes
NIE,Robotics and Automation Engineering,KCET,2024,83307,60928,19754,12046,176035,163989,Yes
VSM,Electrical and Electronics Engineering,COMEDK,2024,243379,85207,10232,29885,368703,338818,Yes
SJBIT,Biotechnology,COMEDK,2024,189300,91899,10298,20343,311840,291497,No
BNMIT,Chemical Engineering,KCET,2024,62372,77276,16497,23227,179372,156145,No
AIT,Computer Science and Engineering,KCET,2023,69523,77396,19900,15178,181997,166819,No
JNNCE,Electronics and Communication Engineering,COMEDK,2023,239057,90847,19638,18524,368066,349542,No
BNMIT,Electronics and Communication Engineering,KCET,2023,59194,92957,17538,28180,197869,169689,Yes
MSRIT,Robotics and Automation Engineering,COMEDK,2024,188294,92336,10232,17355,308217,290862,Yes
UVCE,Mechanical Engineering,COMEDK,2023,207221,93776,9054,24757,334808,310051,Yes
DSCE,Artificial Intelligence and Data Science,KCET,2024,75244,90682,11228,18723,195877,177154,Yes
VSM,Chemical Engineering,KCET,2024,59195,60595,14586,18383,152759,134376,No
VVCE,Information Science and Engineering,COMEDK,2023,204133,76241,17192,25814,323380,297566,No
KLSGIT,Chemical Engineering,KCET,2023,76778,63442,10603,15859,166682,150823,No
CITGubbi,Information Science and Engineering,KCET,2024,61213,86015,13801,10639,171668,161029,No
SIT,Artificial Intelligence and Data Science,KCET,2024,65728,64277,11364,25115,166484,141369,Yes
AIT,Electronics and Communication Engineering,COMEDK,2024,205886,70819,12576,20306,309587,289281,No
JNNCE,Information Science and Engineering,COMEDK,2023,248410,93111,15718,19698,376937,357239,No
VemanaIT,Aerospace Engineering,COMEDK,2024,184930,93434,17177,19833,315374,295541,No
MSRUAS,Data Science,COMEDK,2024,237163,94557,15700,27351,374771,347420,No
MSRIT,Electrical and Electronics Engineering,KCET,2023,76359,60651,16864,27383,181257,153874,Yes
CITGubbi,Biotechnology,KCET,2023,56391,83454,9630,29715,179190,149475,No
SIT,Chemical Engineering,COMEDK,2023,183036,74395,10524,13714,281669,267955,No
MSRUAS,Electrical and Electronics Engineering,COMEDK,2024,215441,69944,11622,17300,314307,297007,No
VVIT,Mechanical Engineering,KCET,2024,72858,61143,14657,15955,164613,148658,No
GMIT,Robotics and Automation Engineering,KCET,2024,68698,67878,16433,16483,169492,153009,No
SDMCET,Electronics and Communication Engineering,COMEDK,2024,164522,77453,18836,22496,283307,260811,No
GMIT,Information Science and Engineering,COMEDK,2024,176154,60451,18360,10495,265460,254965,Yes
DrAIT,Robotics and Automation Engineering,COMEDK,2023,175273,78613,17636,11526,283048,271522,No
BMSCE,Aerospace Engineering,COMEDK,2023,190196,80718,13732,17397,302043,284646,Yes
VVCE,Robotics and Automation Engineering,KCET,2023,83730,92925,13202,17816,207673,189857,No
ACU,Chemical Engineering,KCET,2023,66077,74433,15261,27200,182971,155771,Yes
SDMIT,Data Science,COMEDK,2024,164281,83033,19908,26533,293755,267222,Yes
PRES,Artificial Intelligence and Data Science,KCET,2024,83685,88606,15465,29958,217714,187756,Yes
NCET,Civil Engineering,KCET,2023,82824,85370,16610,17586,202390,184804,Yes
CITGubbi,Aerospace Engineering,COMEDK,2024,226923,65433,13825,29642,335823,306181,No
RVCE,Data Science,COMEDK,2024,205211,65734,10809,29037,310791,281754,No
VemanaIT,Aerospace Engineering,KCET,2024,83756,87920,17170,22877,211723,188846,No
AECMandya,Biotechnology,COMEDK,2024,242960,77533,16815,20313,357621,337308,No
SDMCET,Computer Science and Engineering,COMEDK,2024,175204,71830,8233,27723,282990,255267,No
SJBCE,Information Science and Engineering,COMEDK,2024,208869,90469,17347,11264,327949,316685,Yes
BIT,Electronics and Communication Engineering,KCET,2024,61002,65317,9001,10759,146079,135320,Yes
VemanaIT,Mechanical Engineering,KCET,2023,58068,69646,13993,13308,155015,141707,Yes
NHCE,Electrical and Electronics Engineering,COMEDK,2024,196009,80855,9042,28572,314478,285906,No
SCEM,Computer Science and Engineering,COMEDK,2024,192700,63826,10131,21838,288495,266657,Yes
PESU,Chemical Engineering,COMEDK,2023,193734,68219,14357,18232,294542,276310,Yes
MVJCE,Data Science,COMEDK,2024,187482,60651,15754,27053,290940,263887,No
SIT,Chemical Engineering,KCET,2023,71930,92263,17224,11961,193378,181417,Yes
MVJCE,Civil Engineering,COMEDK,2023,211366,88346,8992,13327,322031,308704,No
MSRUAS,Artificial Intelligence and Data Science,KCET,2024,61781,93775,13985,15557,185098,169541,No
VVCE,Data Science,COMEDK,2023,197831,74027,15740,14129,301727,287598,No
REVA,Biotechnology,KCET,2023,53352,76292,19902,15614,165160,149546,No
SITM,Artificial Intelligence and Data Science,KCET,2024,64824,74244,10921,10235,160224,149989,No
JNNCE,Computer Science and Engineering,COMEDK,2024,162873,64521,17620,12748,257762,245014,Yes
BITM,Robotics and Automation Engineering,KCET,2024,61979,66989,10572,29821,169361,139540,Yes
DBIT,Information Science and Engineering,COMEDK,2024,177724,86576,8260,26194,298754,272560,No
SDMCET,Civil Engineering,COMEDK,2024,226182,72054,16198,16163,330597,314434,No
PESU,Artificial Intelligence and Data Science,COMEDK,2023,181309,60294,17175,15683,274461,258778,Yes
AITM,Biotechnology,COMEDK,2024,237042,71729,13748,15983,338502,322519,No
GIT,Mechanical Engineering,KCET,2024,53790,75462,16438,26889,172579,145690,No
JNNCE,Biotechnology,COMEDK,2024,201492,81584,17475,29171,329722,300551,No
NMIT,Robotics and Automation Engineering,COMEDK,2024,224092,91822,10335,16162,342411,326249,No
CMRIT,Artificial Intelligence and Data Science,COMEDK,2023,197844,61366,14171,24204,297585,273381,Yes
RVCE,Computer Science and Engineering,KCET,2023,64616,65503,9073,15351,154543,139192,Yes
GIT,Mechanical Engineering,KCET,2024,76454,75971,17143,14878,184446,169568,No
MSRIT,Aerospace Engineering,COMEDK,2023,193829,74448,8438,28752,305467,276715,Yes
SIT,Data Science,KCET,2023,55486,88729,17677,24474,186366,161892,Yes
ACU,Computer Science and Engineering,COMEDK,2024,220359,75280,12148,21626,329413,307787,No
VIT,Biotechnology,COMEDK,2024,166556,67917,10099,21706,266278,244572,Yes
BMSCE,Artificial Intelligence and Data Science,KCET,2024,74492,84210,8162,29532,196396,166864,No
DSCE,Biotechnology,KCET,2024,68626,93459,8379,28477,198941,170464,Yes
SDMIT,Mechanical Engineering,KCET,2024,79478,72313,15732,11966,179489,167523,Yes
UVCE,Robotics and Automation Engineering,KCET,2023,54538,88410,15648,16003,174599,158596,Yes
NHCE,Computer Science and Engineering,KCET,2024,71740,63265,13542,24405,172952,148547,Yes
GIT,Biotechnology,KCET,2023,76394,67107,17070,14425,174996,160571,No
DrAIT,Electrical and Electronics Engineering,KCET,2024,67151,83525,13914,18649,183239,164590,Yes
BITM,Chemical Engineering,COMEDK,2024,214662,66756,12284,28436,322138,293702,No
VIT,Data Science,KCET,2023,69235,87331,9612,20044,186222,166178,No
SJBIT,Chemical Engineering,KCET,2023,61586,64793,12430,12530,151339,138809,No
VVIT,Chemical Engineering,KCET,2024,50114,90653,13342,18629,172738,154109,No
MSRUAS,Aerospace Engineering,COMEDK,2024,212057,62328,8865,21135,304385,283250,Yes
JSSSTU,Information Science and Engineering,KCET,2023,83916,70754,19371,25842,199883,174041,Yes
AITM,Electrical and Electronics Engineering,KCET,2023,56520,91404,16569,19587,184080,164493,No
DSCE,Electrical and Electronics Engineering,KCET,2023,57404,68432,17565,18734,162135,143401,Yes
RNSIT,Electronics and Communication Engineering,KCET,2024,64160,62524,15964,27170,169818,142648,No
GMIT,Robotics and Automation Engineering,COMEDK,2023,249664,69236,13318,24794,357012,332218,No
RNSIT,Biotechnology,COMEDK,2024,183377,71111,15577,21871,291936,270065,No
BITM,Computer Science and Engineering,COMEDK,2023,246999,83770,12096,20764,363629,342865,Yes
BITM,Aerospace Engineering,KCET,2023,54331,65606,19667,27373,166977,139604,No
DrAIT,Robotics and Automation Engineering,KCET,2024,64771,86067,12473,11280,174591,163311,Yes
RNSIT,Mechanical Engineering,COMEDK,2024,185343,62814,9951,23434,281542,258108,Yes
KSIT,Artificial Intelligence and Data Science,COMEDK,2024,193959,64258,11849,12911,282977,270066,Yes
REVA,Information Science and Engineering,COMEDK,2023,175065,78356,18436,10869,282726,271857,Yes
RAIT,Mechanical Engineering,COMEDK,2024,245062,71106,11811,13281,341260,327979,No
BNMIT,Information Science and Engineering,COMEDK,2024,243555,63718,19025,17053,343351,326298,No
AIT,Aerospace Engineering,KCET,2023,74956,69926,19166,18035,182083,164048,Yes
PESU,Aerospace Engineering,KCET,2023,83155,82673,13045,22922,201795,178873,No
JNNCE,Electronics and Communication Engineering,KCET,2024,83539,92774,18714,19980,215007,195027,Yes
RVCE,Information Science and Engineering,COMEDK,2023,184570,75178,13511,27035,300294,273259,No
SDMCET,Information Science and Engineering,COMEDK,2024,160700,89992,12187,21051,283930,262879,No
RVUNIV,Data Science,COMEDK,2023,223026,92194,13373,21411,350004,328593,Yes
HKBK,Aerospace Engineering,COMEDK,2024,238839,89170,18462,28037,374508,346471,Yes
SJBIT,Civil Engineering,KCET,2024,58422,89707,9626,16436,174191,157755,Yes
NHCE,Robotics and Automation Engineering,KCET,2024,74966,93963,12486,24669,206084,181415,Yes
BITM,Civil Engineering,COMEDK,2023,184393,73871,14154,21637,294055,272418,Yes
MSRIT,Mechanical Engineering,KCET,2023,53576,65013,9694,21708,149991,128283,No
KLSGIT,Chemical Engineering,COMEDK,2024,174537,69669,10479,25677,280362,254685,No
VSM,Data Science,COMEDK,2024,219439,75612,13802,27241,336094,308853,Yes
VVIT,Artificial Intelligence and Data Science,KCET,2023,66284,62836,9560,12244,150924,138680,No
VSM,Civil Engineering,COMEDK,2024,236384,91942,17640,22604,368570,345966,Yes
PESCE,Chemical Engineering,COMEDK,2023,195092,75392,9431,27495,307410,279915,No
BITM,Mechanical Engineering,COMEDK,2024,217075,69212,18109,11301,315697,304396,Yes
EastPoint,Aerospace Engineering,KCET,2024,75802,74991,13186,18024,182003,163979,No
GMIT,Information Science and Engineering,KCET,2023,59218,79444,16944,18160,173766,155606,No
DSCE,Aerospace Engineering,KCET,2023,62371,70685,13250,23591,169897,146306,No
VVIT,Data Science,KCET,2024,65051,91125,11858,28504,196538,168034,Yes
DrAIT,Aerospace Engineering,KCET,2024,57791,70846,16043,26227,170907,144680,Yes
NIE,Electronics and Communication Engineering,KCET,2024,81777,94248,8983,19065,204073,185008,Yes
NCET,Computer Science and Engineering,KCET,2023,63773,77214,11043,29730,181760,152030,Yes
KSIT,Computer Science and Engineering,KCET,2024,62569,84116,9038,28482,184205,155723,No
RAIT,Artificial Intelligence and Data Science,KCET,2023,53381,89558,16634,14890,174463,159573,No
NIE,Artificial Intelligence and Data Science,COMEDK,2024,208722,60522,15679,28270,313193,284923,Yes
VemanaIT,Civil Engineering,KCET,2024,54807,85664,14859,15555,170885,155330,No
DSATM,Electrical and Electronics Engineering,COMEDK,2024,201592,75086,17539,23390,317607,294217,Yes
BMSIT,Computer Science and Engineering,COMEDK,2023,203346,69575,11041,12497,296459,283962,No
VemanaIT,Artificial Intelligence and Data Science,COMEDK,2023,237172,91292,13939,29044,371447,342403,No
AITM,Artificial Intelligence and Data Science,KCET,2024,65637,70853,10167,29339,175996,146657,No
SCEM,Information Science and Engineering,COMEDK,2023,240695,78753,9071,11253,339772,328519,Yes
MVJCE,Aerospace Engineering,KCET,2024,79688,62689,9344,13451,165172,151721,Yes
REVA,Artificial Intelligence and Data Science,COMEDK,2024,171007,64209,14872,22509,272597,250088,Yes
AECMandya,Data Science,COMEDK,2023,162186,64462,10266,11083,247997,236914,No
SIT,Electrical and Electronics Engineering,COMEDK,2023,214941,68452,19995,15937,319325,303388,Yes
VIT,Mechanical Engineering,KCET,2023,77185,61487,9518,13306,161496,148190,No
HKBK,Biotechnology,KCET,2024,51129,70650,17545,16124,155448,139324,Yes
UVCE,Civil Engineering,COMEDK,2024,226562,79791,15773,21276,343402,322126,No
VIT,Computer Science and Engineering,KCET,2024,50044,64256,11456,14337,140093,125756,No
BMSCE,Chemical Engineering,COMEDK,2024,199351,76335,18478,27273,321437,294164,No
JSSSTU,Biotechnology,COMEDK,2024,173203,71128,12213,14872,271416,256544,Yes
BITM,Artificial Intelligence and Data Science,COMEDK,2023,204928,76242,16774,15749,313693,297944,No
AITM,Computer Science and Engineering,KCET,2023,70003,71547,10829,27675,180054,152379,Yes
BMSIT,Artificial Intelligence and Data Science,COMEDK,2023,211166,86832,11317,23913,333228,309315,Yes
AIT,Information Science and Engineering,KCET,2024,56611,63607,19553,20329,160100,139771,No
AEC,Biotechnology,COMEDK,2023,231356,93703,18343,12255,355657,343402,Yes
JIT,Electrical and Electronics Engineering,KCET,2023,62473,74309,16506,28700,181988,153288,Yes
VemanaIT,Biotechnology,KCET,2023,70675,83062,14435,25202,193374,168172,Yes
REVA,Aerospace Engineering,KCET,2023,54235,66972,10921,17515,149643,132128,Yes
PESCE,Electrical and Electronics Engineering,KCET,2023,83668,85661,14572,26844,210745,183901,Yes
SIT,Aerospace Engineering,KCET,2024,51705,73130,16604,15062,156501,141439,Yes
EastPoint,Computer Science and Engineering,COMEDK,2023,239494,69325,18438,25459,352716,327257,Yes
CITGubbi,Chemical Engineering,KCET,2024,77401,67500,13846,27137,185884,158747,No
CMRIT,Electrical and Electronics Engineering,KCET,2024,51319,87328,9540,11975,160162,148187,Yes
EastPoint,Chemical Engineering,COMEDK,2023,227179,65148,12587,11399,316313,304914,No
VIT,Robotics and Automation Engineering,KCET,2024,65987,88384,17230,13132,184733,171601,No
VVIT,Artificial Intelligence and Data Science,COMEDK,2024,172757,92992,18015,26791,310555,283764,Yes
JNNCE,Artificial Intelligence and Data Science,KCET,2024,72875,87364,17637,25280,203156,177876,Yes
SJBIT,Chemical Engineering,COMEDK,2024,243516,78845,11446,21572,355379,333807,Yes
VemanaIT,Mechanical Engineering,COMEDK,2024,236659,64041,8416,23248,332364,309116,No
YKCE,Biotechnology,COMEDK,2024,171584,81561,19423,26106,298674,272568,No
GMIT,Artificial Intelligence and Data Science,KCET,2023,53080,79027,19367,11373,162847,151474,Yes
BMSIT,Chemical Engineering,KCET,2024,63511,92617,8295,11578,176001,164423,Yes
VIT,Robotics and Automation Engineering,COMEDK,2023,164848,87452,18658,23932,294890,270958,Yes
RIT,Computer Science and Engineering,KCET,2023,58396,66481,12288,13708,150873,137165,Yes
SJBIT,Data Science,COMEDK,2024,231192,78895,17908,16317,344312,327995,No
RAIT,Robotics and Automation Engineering,COMEDK,2024,201991,82019,12097,17098,313205,296107,Yes
KLEIT,Data Science,KCET,2024,69503,60701,12449,26749,169402,142653,No
MSRUAS,Information Science and Engineering,KCET,2024,66196,91696,9662,15627,183181,167554,Yes
SITM,Data Science,KCET,2023,61070,72117,12221,16197,161605,145408,Yes
SITM,Chemical Engineering,COMEDK,2023,187365,81361,18387,15935,303048,287113,No
JIT,Biotechnology,COMEDK,2024,170712,82884,15494,26823,295913,269090,No
RNSIT,Computer Science and Engineering,KCET,2023,61772,86814,10604,29706,188896,159190,No
KLEIT,Electrical and Electronics Engineering,COMEDK,2024,164368,92673,15141,25757,297939,272182,Yes
AITM,Robotics and Automation Engineering,COMEDK,2024,238947,62321,12066,15120,328454,313334,No
VSM,Chemical Engineering,COMEDK,2024,191886,76433,10810,25528,304657,279129,Yes
RIT,Information Science and Engineering,COMEDK,2023,202690,63803,12731,11320,290544,279224,Yes
DrAIT,Chemical Engineering,COMEDK,2024,185538,70680,18106,24893,299217,274324,Yes
NCET,Artificial Intelligence and Data Science,COMEDK,2024,219696,64567,13677,18879,316819,297940,No
GMIT,Electronics and Communication Engineering,COMEDK,2023,230666,77108,9177,26144,343095,316951,Yes
HKBK,Artificial Intelligence and Data Science,KCET,2024,77648,86831,18315,22154,204948,182794,No
HKBK,Electrical and Electronics Engineering,KCET,2024,80571,93914,17245,16115,207845,191730,No
BMSIT,Civil Engineering,COMEDK,2023,218014,88140,12009,26294,344457,318163,No
DrAIT,Robotics and Automation Engineering,COMEDK,2023,244919,74806,18584,17499,355808,338309,No
ACU,Chemical Engineering,KCET,2024,64184,60612,13171,15489,153456,137967,Yes
JIT,Information Science and Engineering,COMEDK,2023,187721,94170,13961,22914,318766,295852,No
SJBCE,Information Science and Engineering,KCET,2024,67019,82969,14110,16442,180540,164098,Yes
MSRUAS,Civil Engineering,COMEDK,2023,200795,62714,10273,18831,292613,273782,Yes
RVCE,Information Science and Engineering,KCET,2023,69810,65649,9701,23970,169130,145160,No
VSM,Electronics and Communication Engineering,COMEDK,2024,215429,67344,14471,18725,315969,297244,No
JIT,Chemical Engineering,COMEDK,2023,220791,79741,17513,11630,329675,318045,No
RIT,Chemical Engineering,KCET,2023,74731,85360,13541,19913,193545,173632,No
RIT,Electrical and Electronics Engineering,COMEDK,2024,203578,85117,8871,16272,313838,297566,No
BMSCE,Electronics and Communication Engineering,COMEDK,2024,211546,79458,13171,17442,321617,304175,Yes
PESU,Chemical Engineering,KCET,2024,78611,76542,15665,27431,198249,170818,No
ACU,Electrical and Electronics Engineering,COMEDK,2024,186581,94059,19987,19410,320037,300627,No
CMRIT,Chemical Engineering,COMEDK,2024,169320,61213,15129,13695,259357,245662,Yes
CMRIT,Biotechnology,COMEDK,2024,160136,66074,11728,25326,263264,237938,No
EastPoint,Chemical Engineering,KCET,2023,59470,77226,19380,24971,181047,156076,No
SITM,Mechanical Engineering,KCET,2023,74925,64110,13920,13588,166543,152955,Yes
DBIT,Aerospace Engineering,COMEDK,2024,169973,70433,14564,28988,283958,254970,Yes
EastPoint,Artificial Intelligence and Data Science,COMEDK,2024,211396,73794,9553,14557,309300,294743,Yes
BMSCE,Information Science and Engineering,KCET,2023,51426,63320,13428,10092,138266,128174,No
PRES,Biotechnology,COMEDK,2024,173201,62399,17812,20795,274207,253412,No
VVCE,Aerospace Engineering,KCET,2024,79081,78467,9424,25557,192529,166972,No
BITM,Artificial Intelligence and Data Science,KCET,2023,66294,75427,12410,15953,170084,154131,No
DrAIT,Information Science and Engineering,COMEDK,2023,232931,63329,9069,17245,322574,305329,Yes
DrAIT,Electronics and Communication Engineering,COMEDK,2024,188168,76491,8061,23599,296319,272720,Yes
SJBIT,Electronics and Communication Engineering,COMEDK,2023,175015,94282,18777,21768,309842,288074,Yes
BNMIT,Data Science,KCET,2023,81336,67123,9845,13009,171313,158304,Yes
DSCE,Mechanical Engineering,KCET,2023,53009,94424,16022,20693,184148,163455,No
SITM,Civil Engineering,KCET,2024,54701,77396,16136,22562,170795,148233,No
VVCE,Civil Engineering,KCET,2024,77687,92273,8556,27135,205651,178516,Yes
RVCE,Civil Engineering,KCET,2023,71912,66215,17707,14384,170218,155834,No
VVCE,Biotechnology,COMEDK,2023,206273,67203,15696,27993,317165,289172,No
MSRUAS,Information Science and Engineering,COMEDK,2023,167620,75184,18950,19741,281495,261754,No
DBIT,Artificial Intelligence and Data Science,COMEDK,2023,221852,79153,19329,17932,338266,320334,Yes
PRES,Mechanical Engineering,COMEDK,2024,206282,70792,9426,22756,309256,286500,No
RNSIT,Electronics and Communication Engineering,KCET,2023,59179,76417,11422,19890,166908,147018,Yes
BMSCE,Information Science and Engineering,KCET,2023,58265,92642,14363,20994,186264,165270,Yes
REVA,Mechanical Engineering,COMEDK,2023,212136,76822,14942,12310,316210,303900,Yes
NIE,Mechanical Engineering,KCET,2024,65824,70574,16959,23180,176537,153357,Yes
MVJCE,Electronics and Communication Engineering,COMEDK,2023,248999,67425,8451,26004,350879,324875,Yes
PRES,Electronics and Communication Engineering,COMEDK,2023,212795,79112,18215,12609,322731,310122,Yes
MVJCE,Aerospace Engineering,KCET,2023,78919,61551,18847,17459,176776,159317,No
VVIT,Information Science and Engineering,KCET,2023,77074,74795,17644,11488,181001,169513,No
AIT,Mechanical Engineering,COMEDK,2024,246131,86005,17763,13399,363298,349899,No
BMIT,Mechanical Engineering,COMEDK,2023,179945,89288,17416,25604,312253,286649,No
JSSSTU,Computer Science and Engineering,KCET,2024,72222,66248,9779,27953,176202,148249,Yes
RIT,Chemical Engineering,KCET,2024,73483,80440,18137,25320,197380,172060,Yes
AITM,Computer Science and Engineering,COMEDK,2024,225694,91481,19241,29243,365659,336416,Yes
ACU,Information Science and Engineering,KCET,2024,73950,78420,14267,25973,192610,166637,Yes
KLEIT,Artificial Intelligence and Data Science,COMEDK,2023,194881,72665,14359,11221,293126,281905,Yes
BITM,Data Science,KCET,2024,69305,62825,17238,29044,178412,149368,No
MSRUAS,Computer Science and Engineering,COMEDK,2023,237651,78554,19793,13637,349635,335998,Yes
MSRUAS,Aerospace Engineering,KCET,2024,61910,87214,13354,16768,179246,162478,Yes
PESU,Electronics and Communication Engineering,KCET,2024,72760,79710,14629,10846,177945,167099,Yes
MSRUAS,Chemical Engineering,COMEDK,2023,181689,83781,14161,25197,304828,279631,Yes
SDMIT,Artificial Intelligence and Data Science,COMEDK,2024,160087,87842,15059,16024,279012,262988,No
RIT,Data Science,COMEDK,2024,219828,83151,15066,19174,337219,318045,Yes
VSM,Electronics and Communication Engineering,COMEDK,2023,184842,74548,14985,13885,288260,274375,No
SCEM,Computer Science and Engineering,COMEDK,2023,232540,76303,13053,18668,340564,321896,Yes
JSSSTU,Aerospace Engineering,COMEDK,2024,174381,73721,10198,16724,275024,258300,Yes
EastPoint,Data Science,COMEDK,2023,224528,75272,15222,14325,329347,315022,Yes
UVCE,Mechanical Engineering,KCET,2023,62920,85165,9570,17935,175590,157655,Yes
CITGubbi,Artificial Intelligence and Data Science,KCET,2024,51549,63200,15501,20799,151049,130250,Yes
VSM,Civil Engineering,COMEDK,2024,194058,74532,14223,24043,306856,282813,No
DBIT,Robotics and Automation Engineering,COMEDK,2024,244853,94778,10571,26789,376991,350202,No
PESU,Chemical Engineering,KCET,2024,83658,74741,18061,16462,192922,176460,No
VVIT,Information Science and Engineering,KCET,2024,78901,64051,18958,13818,175728,161910,No
HKBK,Chemical Engineering,COMEDK,2023,224498,70492,10344,17480,322814,305334,No
RIT,Biotechnology,KCET,2023,51828,73663,10552,26643,162686,136043,Yes
RAIT,Electronics and Communication Engineering,KCET,2023,81238,62451,16168,16329,176186,159857,No
DSCE,Electrical and Electronics Engineering,KCET,2024,83402,88106,9299,12997,193804,180807,Yes
JNNCE,Aerospace Engineering,KCET,2023,57072,69415,13095,13194,152776,139582,Yes
BMSIT,Robotics and Automation Engineering,COMEDK,2023,207785,91011,15102,18650,332548,313898,Yes
DrAIT,Information Science and Engineering,COMEDK,2023,246703,91757,13686,21441,373587,352146,No
DBIT,Biotechnology,COMEDK,2024,210562,80556,13162,11307,315587,304280,Yes
EastPoint,Electronics and Communication Engineering,KCET,2023,78477,61351,8501,12433,160762,148329,Yes
SJBCE,Robotics and Automation Engineering,COMEDK,2024,246637,92269,17197,13603,369706,356103,Yes
GMIT,Biotechnology,KCET,2023,75042,88425,11328,11777,186572,174795,Yes
VSM,Civil Engineering,COMEDK,2024,180501,80446,12105,29106,302158,273052,Yes
UVCE,Robotics and Automation Engineering,COMEDK,2024,240918,62192,18457,29563,351130,321567,No
BMIT,Chemical Engineering,KCET,2023,84492,60406,19802,14265,178965,164700,No
UVCE,Civil Engineering,KCET,2024,81764,63012,15687,24343,184806,160463,Yes
BITM,Electrical and Electronics Engineering,COMEDK,2023,218830,65419,8265,26901,319415,292514,Yes
SJBIT,Data Science,KCET,2024,57202,67864,13348,23246,161660,138414,No
SDMIT,Information Science and Engineering,KCET,2024,74292,94244,15497,29147,213180,184033,No
HKBK,Computer Science and Engineering,KCET,2023,65662,92807,9526,20725,188720,167995,No
RVUNIV,Artificial Intelligence and Data Science,KCET,2024,53296,83379,19957,12051,168683,156632,No
KLSGIT,Civil Engineering,KCET,2024,54587,83473,11332,22767,172159,149392,No
DSATM,Chemical Engineering,KCET,2023,84680,61484,8234,20391,174789,154398,Yes
BMSIT,Robotics and Automation Engineering,KCET,2024,78859,67053,13345,23110,182367,159257,Yes
BIT,Electronics and Communication Engineering,COMEDK,2023,198800,77548,17280,14115,307743,293628,No
JIT,Mechanical Engineering,KCET,2024,84099,62787,13489,24960,185335,160375,Yes
VVIT,Biotechnology,KCET,2024,54385,82927,15779,12675,165766,153091,Yes
DrAIT,Mechanical Engineering,COMEDK,2024,234988,89563,10067,20516,355134,334618,Yes
DSCE,Robotics and Automation Engineering,COMEDK,2024,184288,78771,14780,12286,290125,277839,Yes
PRES,Electrical and Electronics Engineering,KCET,2023,74785,78677,16503,12735,182700,169965,Yes
JNNCE,Data Science,COMEDK,2024,161888,91953,18214,20214,292269,272055,No
NCET,Electronics and Communication Engineering,KCET,2024,74996,91575,11931,20632,199134,178502,Yes
NIE,Mechanical Engineering,COMEDK,2024,229627,74491,18148,10392,332658,322266,No
VIT,Biotechnology,COMEDK,2023,168791,74582,18053,14347,275773,261426,Yes
MSRIT,Mechanical Engineering,KCET,2024,69741,89919,9918,16481,186059,169578,No
RVUNIV,Artificial Intelligence and Data Science,KCET,2024,59767,61059,18048,21464,160338,138874,No
SIT,Computer Science and Engineering,KCET,2024,78723,70317,14629,29364,193033,163669,Yes
ACU,Civil Engineering,KCET,2024,61450,68640,19313,24035,173438,149403,Yes
PESU,Aerospace Engineering,KCET,2023,55488,79819,18024,16771,170102,153331,Yes
VVIT,Chemical Engineering,KCET,2023,54269,67796,13787,17027,152879,135852,No
VIT,Artificial Intelligence and Data Science,COMEDK,2023,235186,81508,15605,23675,355974,332299,Yes
MSRIT,Biotechnology,KCET,2023,68133,90528,9227,18260,186148,167888,No
UVCE,Chemical Engineering,COMEDK,2024,222560,76925,10332,10268,320085,309817,Yes
NHCE,Chemical Engineering,KCET,2024,77310,60642,14346,21078,173376,152298,No
SDMIT,Aerospace Engineering,KCET,2024,69738,91868,18064,22785,202455,179670,No
KLSGIT,Artificial Intelligence and Data Science,KCET,2024,50960,70032,12417,19065,152474,133409,No
AITM,Chemical Engineering,KCET,2023,59589,75222,17428,17314,169553,152239,No
NIE,Information Science and Engineering,COMEDK,2024,200565,89806,15057,29545,334973,305428,Yes
MSRIT,Robotics and Automation Engineering,KCET,2024,66233,76222,11346,12383,166184,153801,No
RAIT,Civil Engineering,KCET,2023,66309,64095,13618,22074,166096,144022,Yes
BIT,Electronics and Communication Engineering,KCET,2024,51386,61507,12644,18893,144430,125537,Yes
BNMIT,Electrical and Electronics Engineering,KCET,2024,60485,60162,16793,23957,161397,137440,Yes
BIT,Information Science and Engineering,COMEDK,2023,171507,62873,17210,23072,274662,251590,Yes
RAIT,Information Science and Engineering,COMEDK,2023,190683,81044,13231,16869,301827,284958,Yes
CMRIT,Computer Science and Engineering,COMEDK,2023,249154,90267,8303,13217,360941,347724,No
JIT,Artificial Intelligence and Data Science,KCET,2023,75938,88309,19507,23488,207242,183754,No
AITM,Robotics and Automation Engineering,COMEDK,2024,244134,62917,11677,22515,341243,318728,Yes
RNSIT,Robotics and Automation Engineering,COMEDK,2024,230497,71698,17144,21654,340993,319339,No
SDMCET,Electrical and Electronics Engineering,KCET,2023,64716,61398,11411,22429,159954,137525,No
JSSSTU,Civil Engineering,COMEDK,2023,163017,72444,13501,26718,275680,248962,Yes
EastPoint,Computer Science and Engineering,KCET,2023,66614,62802,9363,27710,166489,138779,No
BNMIT,Data Science,KCET,2023,83584,63126,17183,25129,189022,163893,No
RAIT,Data Science,COMEDK,2023,208599,78477,16888,25251,329215,303964,Yes
JSSSTU,Civil Engineering,KCET,2023,55515,84514,10367,21783,172179,150396,No
RAIT,Electrical and Electronics Engineering,COMEDK,2023,245577,79833,19998,20211,365619,345408,No
VVCE,Aerospace Engineering,COMEDK,2024,208627,66621,10858,28911,315017,286106,Yes
KSIT,Chemical Engineering,KCET,2024,81298,65072,17397,10272,174039,163767,Yes
DSATM,Computer Science and Engineering,KCET,2023,80449,90824,18831,11945,202049,190104,Yes
PESCE,Computer Science and Engineering,COMEDK,2024,165797,60347,18002,17473,261619,244146,Yes
REVA,Computer Science and Engineering,COMEDK,2024,199220,86338,19821,17260,322639,305379,Yes
ACU,Computer Science and Engineering,KCET,2024,64035,73873,8848,25959,172715,146756,Yes
RNSIT,Mechanical Engineering,KCET,2023,80305,91509,17211,17229,206254,189025,Yes
JNNCE,Chemical Engineering,COMEDK,2024,192583,69640,11999,18593,292815,274222,No
VemanaIT,Electrical and Electronics Engineering,COMEDK,2023,224491,77570,11605,24934,338600,313666,Yes
BMSCE,Robotics and Automation Engineering,COMEDK,2024,207927,84527,9818,11524,313796,302272,Yes
BMSCE,Electrical and Electronics Engineering,COMEDK,2023,166338,91926,14211,10567,283042,272475,Yes
VemanaIT,Biotechnology,KCET,2024,78879,79988,9702,14188,182757,168569,Yes
RVUNIV,Electronics and Communication Engineering,COMEDK,2023,215118,86506,16331,17217,335172,317955,No
RAIT,Artificial Intelligence and Data Science,KCET,2023,74530,88387,14440,29258,206615,177357,Yes
BNMIT,Robotics and Automation Engineering,KCET,2023,81362,89896,19768,12263,203289,191026,Yes
BNMIT,Robotics and Automation Engineering,COMEDK,2023,205531,85511,14455,14584,320081,305497,No
SJBCE,Biotechnology,KCET,2023,74540,73857,12102,11296,171795,160499,No
VVCE,Data Science,KCET,2024,54385,69716,8211,22333,154645,132312,Yes
BIT,Biotechnology,COMEDK,2024,188215,62842,12102,26333,289492,263159,No
SJBIT,Electronics and Communication Engineering,COMEDK,2023,230540,77576,18824,27221,354161,326940,No
MSRIT,Civil Engineering,KCET,2024,68445,83134,11214,21514,184307,162793,No
RVUNIV,Civil Engineering,COMEDK,2023,179166,65753,16384,22104,283407,261303,No
RAIT,Artificial Intelligence and Data Science,KCET,2023,61251,61790,11434,15385,149860,134475,Yes
BMIT,Aerospace Engineering,KCET,2024,66778,88834,9442,12377,177431,165054,No
MSRUAS,Civil Engineering,COMEDK,2023,238781,67492,10543,28216,345032,316816,No
VVCE,Aerospace Engineering,COMEDK,2023,216931,76775,15591,17307,326604,309297,No
RNSIT,Computer Science and Engineering,COMEDK,2023,179494,71917,11273,27393,290077,262684,Yes
BMSIT,Mechanical Engineering,COMEDK,2024,193546,86234,14512,21492,315784,294292,No
JIT,Electrical and Electronics Engineering,COMEDK,2024,243113,69366,15068,22387,349934,327547,Yes
VVCE,Robotics and Automation Engineering,COMEDK,2023,210541,93583,16312,27571,348007,320436,No
SDMIT,Robotics and Automation Engineering,COMEDK,2023,207591,67746,18981,27555,321873,294318,Yes
REVA,Aerospace Engineering,KCET,2023,74310,92116,13025,11275,190726,179451,No
PESU,Artificial Intelligence and Data Science,COMEDK,2023,218167,88693,15657,26596,349113,322517,No
BMSIT,Electronics and Communication Engineering,KCET,2023,80348,71978,14713,17983,185022,167039,Yes
AIT,Artificial Intelligence and Data Science,COMEDK,2024,232850,68360,16030,20824,338064,317240,No
SJBIT,Aerospace Engineering,COMEDK,2024,227824,71621,18857,26108,344410,318302,No
KSIT,Mechanical Engineering,COMEDK,2024,181755,93427,12356,10918,298456,287538,No
PESU,Data Science,KCET,2023,70338,78706,9770,20061,178875,158814,Yes
JSSSTU,Information Science and Engineering,COMEDK,2023,226294,90300,9042,20954,346590,325636,Yes
NCET,Data Science,COMEDK,2024,189553,77835,8229,22294,297911,275617,No
BITM,Civil Engineering,COMEDK,2023,231711,91398,17254,22166,362529,340363,No
PESU,Civil Engineering,COMEDK,2024,232626,64312,16876,21069,334883,313814,No
DBIT,Artificial Intelligence and Data Science,COMEDK,2023,184722,67318,8538,20138,280716,260578,No
VVIT,Information Science and Engineering,KCET,2024,75320,68835,13434,13462,171051,157589,No
DBIT,Aerospace Engineering,COMEDK,2024,177131,68341,18094,14595,278161,263566,No
BMSIT,Information Science and Engineering,COMEDK,2023,208335,74877,19487,25250,327949,302699,No
DrAIT,Data Science,COMEDK,2023,242437,89019,8722,16323,356501,340178,Yes
NHCE,Aerospace Engineering,KCET,2024,51912,87216,13259,19209,171596,152387,Yes
BIT,Chemical Engineering,KCET,2024,84423,60458,13522,28011,186414,158403,No
VemanaIT,Information Science and Engineering,KCET,2024,52869,67152,19844,13840,153705,139865,Yes
RIT,Electrical and Electronics Engineering,COMEDK,2023,235171,61689,11076,22374,330310,307936,No
BMSIT,Electronics and Communication Engineering,KCET,2024,68046,71251,9704,11570,160571,149001,No
GMIT,Civil Engineering,COMEDK,2024,199769,87182,17794,12282,317027,304745,Yes
PRES,Data Science,KCET,2024,50909,60762,12916,13422,138009,124587,No
RNSIT,Artificial Intelligence and Data Science,COMEDK,2024,173918,86104,12774,23756,296552,272796,No
AECMandya,Civil Engineering,KCET,2024,58186,88458,13385,16021,176050,160029,Yes
KLEIT,Civil Engineering,COMEDK,2024,179980,91527,8933,10369,290809,280440,Yes
AECMandya,Electronics and Communication Engineering,KCET,2023,74068,84977,18280,19231,196556,177325,No
SIT,Mechanical Engineering,KCET,2024,72105,94733,13190,11309,191337,180028,Yes
RIT,Robotics and Automation Engineering,COMEDK,2024,168283,75197,16514,18906,278900,259994,Yes
PRES,Computer Science and Engineering,KCET,2024,52052,79255,16588,27275,175170,147895,Yes
CITGubbi,Mechanical Engineering,KCET,2024,51735,86648,18733,21945,179061,157116,No
MVJCE,Chemical Engineering,COMEDK,2023,181863,91941,17091,29626,320521,290895,No
DrAIT,Chemical Engineering,COMEDK,2023,199984,84812,17912,29129,331837,302708,Yes
RNSIT,Civil Engineering,COMEDK,2023,165032,75597,8642,11644,260915,249271,No
KSIT,Aerospace Engineering,COMEDK,2023,215588,80134,14244,22075,332041,309966,Yes
RIT,Electronics and Communication Engineering,COMEDK,2023,185116,92852,16208,19755,313931,294176,Yes
SIT,Chemical Engineering,KCET,2024,57770,68254,16131,18635,160790,142155,No
HKBK,Information Science and Engineering,KCET,2024,76467,85910,11596,15942,189915,173973,Yes
SITM,Aerospace Engineering,KCET,2024,57180,62096,13076,19443,151795,132352,No
MSRIT,Robotics and Automation Engineering,COMEDK,2023,205305,79204,17687,15389,317585,302196,No
PESCE,Civil Engineering,KCET,2024,69078,76835,13327,27636,186876,159240,Yes
PRES,Data Science,KCET,2023,78760,76543,16229,25694,197226,171532,No
EastPoint,Robotics and Automation Engineering,KCET,2023,57196,91009,12880,24510,185595,161085,No
DrAIT,Mechanical Engineering,COMEDK,2023,183895,72301,13533,14194,283923,269729,No
BMSCE,Information Science and Engineering,KCET,2023,76087,70605,8809,13669,169170,155501,Yes
KLEIT,Electronics and Communication Engineering,KCET,2024,67378,84958,12630,24273,189239,164966,No
SCEM,Robotics and Automation Engineering,COMEDK,2024,223344,81953,19246,19593,344136,324543,Yes
VVIT,Information Science and Engineering,KCET,2024,55113,79876,11549,19223,165761,146538,No
SITM,Chemical Engineering,KCET,2023,68260,90722,10017,23170,192169,168999,No
AIT,Aerospace Engineering,COMEDK,2023,168083,93275,17943,16624,295925,279301,Yes
DSCE,Computer Science and Engineering,KCET,2024,77074,71599,10524,16049,175246,159197,Yes
UVCE,Information Science and Engineering,KCET,2024,57057,60467,11881,14227,143632,129405,No
BIT,Electronics and Communication Engineering,COMEDK,2023,192461,70828,16468,10503,290260,279757,No
JSSSTU,Aerospace Engineering,COMEDK,2023,243962,91158,9501,27157,371778,344621,No
RAIT,Information Science and Engineering,COMEDK,2023,184956,69277,14270,12440,280943,268503,Yes
EastPoint,Artificial Intelligence and Data Science,KCET,2023,52431,69392,18209,11664,151696,140032,Yes
SJBCE,Data Science,COMEDK,2024,179715,61887,10371,11620,263593,251973,No
BIT,Chemical Engineering,KCET,2023,63153,65179,8665,25301,162298,136997,Yes
NIE,Chemical Engineering,COMEDK,2023,244343,63244,14015,28993,350595,321602,Yes
MSRIT,Mechanical Engineering,COMEDK,2023,226452,71631,19577,10582,328242,317660,No
NMIT,Artificial Intelligence and Data Science,COMEDK,2024,217817,88884,8939,15986,331626,315640,Yes
DBIT,Electronics and Communication Engineering,KCET,2024,68098,88194,9724,20841,186857,166016,Yes
CITGubbi,Artificial Intelligence and Data Science,KCET,2023,73912,70233,8010,20810,172965,152155,No
CMRIT,Information Science and Engineering,COMEDK,2024,214700,78276,19619,29136,341731,312595,Yes
SCEM,Civil Engineering,KCET,2024,55923,71781,17405,21547,166656,145109,Yes
RVCE,Electronics and Communication Engineering,KCET,2024,79036,63774,12721,15714,171245,155531,No
KLSGIT,Robotics and Automation Engineering,COMEDK,2023,208366,74641,18362,22809,324178,301369,Yes
DrAIT,Data Science,COMEDK,2023,239543,89331,8121,11745,348740,336995,No
ACU,Computer Science and Engineering,KCET,2023,71264,84135,9582,20198,185179,164981,No
MVJCE,Electrical and Electronics Engineering,COMEDK,2024,204442,89038,10381,27211,331072,303861,No
RAIT,Electrical and Electronics Engineering,COMEDK,2023,197579,81977,9963,27409,316928,289519,No
SDMIT,Computer Science and Engineering,COMEDK,2024,165251,86129,11378,13840,276598,262758,No
BNMIT,Electrical and Electronics Engineering,COMEDK,2023,230146,65402,14370,16853,326771,309918,No
KSIT,Civil Engineering,KCET,2024,84940,84712,15922,13936,199510,185574,Yes
DBIT,Electronics and Communication Engineering,KCET,2023,78869,64309,15082,10849,169109,158260,Yes
DBIT,Information Science and Engineering,KCET,2023,74634,77015,12624,16302,180575,164273,Yes
GIT,Artificial Intelligence and Data Science,KCET,2024,69392,81758,12358,27327,190835,163508,Yes
UVCE,Information Science and Engineering,KCET,2023,69502,75060,19021,16271,179854,163583,No
DSATM,Computer Science and Engineering,KCET,2024,82458,67204,12555,22036,184253,162217,No
PESU,Chemical Engineering,KCET,2023,63865,89511,9168,17708,180252,162544,No
BMSCE,Biotechnology,COMEDK,2023,179733,83678,9718,28006,301135,273129,No
MVJCE,Electronics and Communication Engineering,COMEDK,2023,219523,69468,11489,17305,317785,300480,No
SIT,Civil Engineering,COMEDK,2023,184751,71129,8911,28997,293788,264791,Yes
PESCE,Robotics and Automation Engineering,COMEDK,2024,193595,87143,19295,10557,310590,300033,Yes
VVCE,Aerospace Engineering,COMEDK,2023,186011,72494,16617,21162,296284,275122,No
NCET,Electronics and Communication Engineering,COMEDK,2024,232068,70270,9073,19884,331295,311411,No
AITM,Aerospace Engineering,COMEDK,2023,179229,86715,16177,10481,292602,282121,Yes
AITM,Artificial Intelligence and Data Science,COMEDK,2023,227568,85658,17269,25362,355857,330495,No
CITGubbi,Biotechnology,KCET,2024,82453,89968,16430,11586,200437,188851,Yes
BMSIT,Data Science,KCET,2024,66034,82488,13018,17574,179114,161540,No
REVA,Computer Science and Engineering,COMEDK,2023,203619,63995,12207,19509,299330,279821,No
GIT,Aerospace Engineering,COMEDK,2023,190540,62868,17787,19159,290354,271195,Yes
DBIT,Information Science and Engineering,COMEDK,2024,226289,84256,12389,12677,335611,322934,No
DSATM,Chemical Engineering,KCET,2024,79028,77966,10996,29941,197931,167990,No
BITM,Electronics and Communication Engineering,COMEDK,2024,162770,74885,8389,26731,272775,246044,Yes
NMIT,Civil Engineering,KCET,2024,75120,91491,13548,14792,194951,180159,No
YKCE,Robotics and Automation Engineering,KCET,2023,82568,66343,17069,28122,194102,165980,Yes
VSM,Aerospace Engineering,KCET,2024,71419,63660,9854,17745,162678,144933,Yes
VIT,Mechanical Engineering,COMEDK,2023,201674,61516,16363,19459,299012,279553,No
VVCE,Artificial Intelligence and Data Science,COMEDK,2023,230871,64641,12406,19961,327879,307918,No
HKBK,Aerospace Engineering,COMEDK,2023,188137,94495,11422,17355,311409,294054,No
RNSIT,Artificial Intelligence and Data Science,COMEDK,2023,161679,85145,17829,22257,286910,264653,Yes
JNNCE,Electrical and Electronics Engineering,KCET,2024,59389,68792,17146,12443,157770,145327,Yes
JIT,Computer Science and Engineering,COMEDK,2023,226260,64662,16731,13827,321480,307653,No
REVA,Electronics and Communication Engineering,COMEDK,2023,223099,90991,17443,28846,360379,331533,No
VSM,Chemical Engineering,KCET,2023,68967,64369,10551,21104,164991,143887,No
SJBIT,Aerospace Engineering,KCET,2023,81550,80529,9251,20826,192156,171330,Yes
DSCE,Biotechnology,COMEDK,2024,240507,88709,11230,25259,365705,340446,No
KLEIT,Chemical Engineering,KCET,2024,70954,62707,15568,15968,165197,149229,Yes
HKBK,Electrical and Electronics Engineering,COMEDK,2023,195169,92712,17661,16062,321604,305542,Yes
ACU,Artificial Intelligence and Data Science,KCET,2023,83200,92640,9422,29414,214676,185262,No
ACU,Electronics and Communication Engineering,COMEDK,2023,198343,93785,13466,28921,334515,305594,Yes
PRES,Robotics and Automation Engineering,KCET,2023,75009,72092,16412,10554,174067,163513,Yes
AIT,Electronics and Communication Engineering,KCET,2024,63074,60150,17923,27783,168930,141147,No
BIT,Data Science,KCET,2023,74990,63837,12063,14675,165565,150890,No
SDMCET,Information Science and Engineering,COMEDK,2024,243094,71515,15673,19817,350099,330282,Yes
AECMandya,Electronics and Communication Engineering,COMEDK,2023,244779,73635,8769,28135,355318,327183,Yes
MSRUAS,Computer Science and Engineering,COMEDK,2024,231737,83622,8018,16533,339910,323377,Yes
KLSGIT,Robotics and Automation Engineering,KCET,2023,59219,71943,15036,10209,156407,146198,Yes
DrAIT,Robotics and Automation Engineering,COMEDK,2024,209442,80898,14727,13786,318853,305067,No
DSCE,Data Science,COMEDK,2024,245223,85711,13968,15847,360749,344902,Yes
DSCE,Aerospace Engineering,COMEDK,2024,198950,80880,8665,28521,317016,288495,Yes
NMIT,Data Science,KCET,2023,71237,87260,11726,28085,198308,170223,No
NHCE,Electrical and Electronics Engineering,KCET,2024,73809,73045,8757,18044,173655,155611,No
ACU,Civil Engineering,COMEDK,2024,237740,67188,12890,14243,332061,317818,Yes
NCET,Chemical Engineering,KCET,2023,60156,94880,16875,27099,199010,171911,Yes
BMSCE,Biotechnology,KCET,2023,57437,70215,12020,13155,152827,139672,Yes
HKBK,Aerospace Engineering,COMEDK,2023,232984,78489,16340,14606,342419,327813,Yes
SITM,Electronics and Communication Engineering,KCET,2024,71904,79482,18028,28186,197600,169414,No
JSSSTU,Artificial Intelligence and Data Science,KCET,2023,79962,91011,18789,28131,217893,189762,No
BNMIT,Biotechnology,COMEDK,2024,170331,75098,14886,12437,272752,260315,No
VVCE,Electrical and Electronics Engineering,KCET,2024,80648,75738,19703,20666,196755,176089,No
DrAIT,Computer Science and Engineering,KCET,2024,55815,63688,18942,21426,159871,138445,Yes
SDMCET,Electronics and Communication Engineering,COMEDK,2023,191446,70797,12268,10132,284643,274511,Yes
BITM,Civil Engineering,KCET,2023,58905,80244,12002,16530,167681,151151,Yes
DSATM,Electrical and Electronics Engineering,KCET,2024,73950,71120,15522,18049,178641,160592,Yes
ACU,Electrical and Electronics Engineering,KCET,2024,58330,92737,14472,17557,183096,165539,No
UVCE,Computer Science and Engineering,KCET,2023,70841,71031,8620,27207,177699,150492,No
KLEIT,Civil Engineering,KCET,2024,54740,92073,9745,16979,173537,156558,No
BMSCE,Information Science and Engineering,COMEDK,2024,241251,61678,18264,27268,348461,321193,No
MSRUAS,Electrical and Electronics Engineering,KCET,2024,59219,67768,8040,25854,160881,135027,Yes
AEC,Chemical Engineering,KCET,2024,65688,94165,8690,27821,196364,168543,Yes
VVCE,Artificial Intelligence and Data Science,KCET,2024,53770,75299,14974,15120,159163,144043,Yes
BIT,Data Science,COMEDK,2023,231423,92407,14080,28624,366534,337910,Yes
VSM,Information Science and Engineering,KCET,2023,74480,60915,9637,28686,173718,145032,Yes
HKBK,Chemical Engineering,KCET,2023,69106,63525,10436,18110,161177,143067,No
BITM,Robotics and Automation Engineering,KCET,2023,79296,86560,9369,29276,204501,175225,No
DBIT,Electronics and Communication Engineering,COMEDK,2023,188294,64113,18901,26179,297487,271308,Yes
SDMIT,Civil Engineering,KCET,2023,59018,75655,18439,26756,179868,153112,No
AEC,Robotics and Automation Engineering,COMEDK,2024,176548,64807,19515,18783,279653,260870,Yes
BITM,Biotechnology,KCET,2024,69146,89344,9654,27778,195922,168144,No
VSM,Computer Science and Engineering,COMEDK,2024,182375,80455,13754,28308,304892,276584,No
KLEIT,Mechanical Engineering,KCET,2024,64679,69820,19589,27664,181752,154088,No
SDMCET,Electronics and Communication Engineering,COMEDK,2024,214205,83821,18918,11144,328088,316944,Yes
AEC,Computer Science and Engineering,COMEDK,2024,231450,94079,15738,29008,370275,341267,Yes
SDMCET,Civil Engineering,COMEDK,2023,227034,81575,19251,11193,339053,327860,Yes
RVUNIV,Aerospace Engineering,KCET,2023,73378,71142,14237,25160,183917,158757,No
CITGubbi,Computer Science and Engineering,COMEDK,2024,173757,70207,15449,25286,284699,259413,Yes
SITM,Data Science,COMEDK,2023,235995,89882,13880,26211,365968,339757,Yes
CITGubbi,Robotics and Automation Engineering,COMEDK,2024,243380,87999,11366,18720,361465,342745,No
SJBIT,Mechanical Engineering,COMEDK,2023,209078,69270,19275,29853,327476,297623,Yes
AITM,Chemical Engineering,COMEDK,2024,187768,78750,11364,24017,301899,277882,No
MVJCE,Data Science,KCET,2024,59016,64783,19335,27766,170900,143134,Yes
SJBIT,Electrical and Electronics Engineering,KCET,2024,52590,61605,9853,29279,153327,124048,No
DSCE,Biotechnology,KCET,2023,59681,85459,9282,27717,182139,154422,Yes
VVCE,Robotics and Automation Engineering,KCET,2023,75124,89750,11496,23512,199882,176370,No
AIT,Aerospace Engineering,KCET,2024,50622,87445,9858,25887,173812,147925,Yes
RVUNIV,Mechanical Engineering,KCET,2023,73463,63186,10019,29887,176555,146668,Yes
UVCE,Aerospace Engineering,KCET,2024,73334,70099,9871,21353,174657,153304,Yes
VSM,Civil Engineering,KCET,2024,70567,83887,19778,13227,187459,174232,Yes
BNMIT,Information Science and Engineering,COMEDK,2024,206930,69125,18211,22880,317146,294266,Yes
MSRUAS,Civil Engineering,KCET,2023,68240,78298,16936,11063,174537,163474,Yes
UVCE,Computer Science and Engineering,KCET,2023,75172,65921,9445,13171,163709,150538,Yes
SJBCE,Mechanical Engineering,KCET,2023,50410,77508,12490,29721,170129,140408,Yes
BMSCE,Electrical and Electronics Engineering,KCET,2024,74101,82478,13700,18182,188461,170279,Yes
CITGubbi,Information Science and Engineering,KCET,2023,79745,89571,18606,13114,201036,187922,No
VSM,Aerospace Engineering,KCET,2024,52160,72918,14591,26114,165783,139669,No
GMIT,Electrical and Electronics Engineering,COMEDK,2024,173998,76261,11661,24309,286229,261920,Yes
KLSGIT,Mechanical Engineering,COMEDK,2023,178146,81729,10679,22471,293025,270554,No
JSSSTU,Chemical Engineering,KCET,2024,75130,73599,17623,13511,179863,166352,Yes
DrAIT,Mechanical Engineering,COMEDK,2024,200704,91910,10381,12797,315792,302995,Yes
AECMandya,Biotechnology,COMEDK,2024,221005,73611,10841,27547,333004,305457,No
BMSCE,Robotics and Automation Engineering,KCET,2024,80035,61640,10002,19718,171395,151677,No
SCEM,Robotics and Automation Engineering,COMEDK,2023,239831,85490,17826,21295,364442,343147,Yes
NHCE,Computer Science and Engineering,KCET,2023,51337,65711,13997,18345,149390,131045,Yes
DrAIT,Computer Science and Engineering,KCET,2023,61992,63217,16021,13594,154824,141230,No
VIT,Mechanical Engineering,KCET,2024,81134,92566,10288,24475,208463,183988,No
GIT,Artificial Intelligence and Data Science,COMEDK,2023,217180,85540,12950,16387,332057,315670,No
JIT,Biotechnology,COMEDK,2023,172283,75453,8304,21496,277536,256040,No
VSM,Aerospace Engineering,COMEDK,2023,183143,86467,17155,21235,308000,286765,No
BMSCE,Aerospace Engineering,KCET,2023,77856,73160,16892,25048,192956,167908,No
BNMIT,Data Science,COMEDK,2024,240473,86331,10449,24352,361605,337253,Yes
PRES,Information Science and Engineering,COMEDK,2024,207293,90358,16980,21950,336581,314631,Yes
SITM,Data Science,KCET,2024,58983,91348,12497,25750,188578,162828,Yes
AITM,Artificial Intelligence and Data Science,COMEDK,2023,229980,71376,19667,14114,335137,321023,No
CITGubbi,Data Science,KCET,2023,54262,75737,15444,19642,165085,145443,Yes
SITM,Robotics and Automation Engineering,KCET,2024,64363,83501,14560,24556,186980,162424,No
VemanaIT,Electronics and Communication Engineering,KCET,2023,73331,79516,8750,27739,189336,161597,No
DrAIT,Data Science,COMEDK,2023,178267,73538,8111,17625,277541,259916,Yes
MSRIT,Biotechnology,COMEDK,2023,170983,78717,10257,12572,272529,259957,No
SJBCE,Information Science and Engineering,KCET,2024,77428,62314,11162,27437,178341,150904,No
BIT,Chemical Engineering,COMEDK,2024,168682,83101,11091,10275,273149,262874,Yes
AECMandya,Artificial Intelligence and Data Science,KCET,2023,63890,63735,19214,29103,175942,146839,No
MVJCE,Robotics and Automation Engineering,COMEDK,2023,225180,68228,16136,13332,322876,309544,No
RVUNIV,Information Science and Engineering,KCET,2024,68904,72444,15397,10972,167717,156745,No
JSSSTU,Information Science and Engineering,COMEDK,2023,199216,82584,14429,15360,311589,296229,No
DrAIT,Biotechnology,COMEDK,2023,194824,61830,13423,22849,292926,270077,No
PESCE,Information Science and Engineering,COMEDK,2023,197212,72549,18553,12814,301128,288314,Yes
YKCE,Civil Engineering,COMEDK,2023,244178,83839,11648,16616,356281,339665,Yes
YKCE,Civil Engineering,KCET,2024,68522,64697,12946,17025,163190,146165,Yes
CMRIT,Civil Engineering,KCET,2024,61228,79754,18648,23306,182936,159630,Yes
RVCE,Robotics and Automation Engineering,KCET,2024,50468,65371,10004,24517,150360,125843,No
BNMIT,Robotics and Automation Engineering,COMEDK,2024,207426,85360,15915,20090,328791,308701,Yes
DSATM,Mechanical Engineering,COMEDK,2024,160012,65582,8240,23439,257273,233834,No
VVCE,Information Science and Engineering,KCET,2024,61151,94343,17444,21299,194237,172938,Yes
RVCE,Mechanical Engineering,KCET,2023,68558,61348,17855,14322,162083,147761,No
BMIT,Aerospace Engineering,KCET,2024,83198,66035,18484,18779,186496,167717,Yes
SITM,Electrical and Electronics Engineering,COMEDK,2024,224034,62429,15962,18402,320827,302425,No
AITM,Artificial Intelligence and Data Science,KCET,2024,79248,67780,19416,13272,179716,166444,No
AEC,Computer Science and Engineering,COMEDK,2023,174036,84040,18312,20559,296947,276388,Yes
PESCE,Biotechnology,COMEDK,2023,207466,92003,15395,12509,327373,314864,No
REVA,Artificial Intelligence and Data Science,COMEDK,2023,174725,61567,9318,16155,261765,245610,No
NCET,Civil Engineering,KCET,2024,56888,68443,16262,18402,159995,141593,Yes
AIT,Computer Science and Engineering,COMEDK,2024,220808,86393,10536,20369,338106,317737,No
REVA,Chemical Engineering,KCET,2023,62976,71049,14680,25242,173947,148705,Yes
BMIT,Electrical and Electronics Engineering,COMEDK,2024,202497,80128,8755,20715,312095,291380,Yes
MSRIT,Information Science and Engineering,KCET,2024,59463,87735,13860,28076,189134,161058,No
KSIT,Civil Engineering,COMEDK,2024,183156,76616,15992,25680,301444,275764,Yes
DrAIT,Information Science and Engineering,COMEDK,2023,206110,69091,9749,10914,295864,284950,Yes
RVUNIV,Civil Engineering,COMEDK,2023,235029,78352,15937,26174,355492,329318,Yes
UVCE,Civil Engineering,COMEDK,2023,185097,74432,19965,24169,303663,279494,No
PRES,Aerospace Engineering,COMEDK,2023,193618,68873,14895,18173,295559,277386,Yes
VSM,Aerospace Engineering,KCET,2023,57674,66562,18667,27374,170277,142903,Yes
MVJCE,Civil Engineering,COMEDK,2024,221908,86456,13882,27894,350140,322246,Yes
AECMandya,Biotechnology,COMEDK,2023,181781,81497,14865,18471,296614,278143,Yes
DSCE,Biotechnology,KCET,2023,53707,65886,8774,29231,157598,128367,No
EastPoint,Artificial Intelligence and Data Science,KCET,2023,62332,68938,12037,28383,171690,143307,No
UVCE,Mechanical Engineering,KCET,2024,67161,64876,18074,21680,171791,150111,No
MSRUAS,Mechanical Engineering,KCET,2024,58868,91445,11728,16864,178905,162041,Yes
VemanaIT,Data Science,KCET,2023,56134,83282,12275,18623,170314,151691,Yes
UVCE,Information Science and Engineering,COMEDK,2024,194637,80645,19769,20362,315413,295051,No
SDMCET,Aerospace Engineering,KCET,2024,64959,91201,16313,17442,189915,172473,No
AIT,Artificial Intelligence and Data Science,KCET,2024,72266,72995,15439,24198,184898,160700,No
JNNCE,Computer Science and Engineering,KCET,2024,61816,80872,13351,15172,171211,156039,Yes
RAIT,Data Science,COMEDK,2024,183848,94691,19750,25043,323332,298289,Yes
CITGubbi,Aerospace Engineering,KCET,2024,84987,79931,16607,24943,206468,181525,No
KLEIT,Mechanical Engineering,COMEDK,2024,214264,90038,19426,12896,336624,323728,No
DSATM,Information Science and Engineering,COMEDK,2024,175727,91960,18007,26423,312117,285694,No
HKBK,Aerospace Engineering,COMEDK,2024,196518,88806,10033,13207,308564,295357,Yes
JIT,Aerospace Engineering,COMEDK,2023,238891,71250,10185,13478,333804,320326,No
NCET,Chemical Engineering,COMEDK,2023,188884,80954,18600,27771,316209,288438,Yes
PRES,Computer Science and Engineering,COMEDK,2024,186879,73331,9065,27426,296701,269275,No
DrAIT,Civil Engineering,KCET,2023,75486,62444,15402,20712,174044,153332,No
MSRIT,Information Science and Engineering,COMEDK,2023,165010,93035,19024,19688,296757,277069,No
NMIT,Electronics and Communication Engineering,COMEDK,2024,205529,88781,19341,21825,335476,313651,No
SDMIT,Computer Science and Engineering,COMEDK,2023,237399,90825,14363,27876,370463,342587,No
NCET,Electronics and Communication Engineering,KCET,2023,75190,81655,16998,17188,191031,173843,No
SDMIT,Aerospace Engineering,COMEDK,2024,193999,76726,13563,19837,304125,284288,Yes
NIE,Robotics and Automation Engineering,KCET,2023,80794,73368,9863,16811,180836,164025,Yes
UVCE,Artificial Intelligence and Data Science,KCET,2023,50992,76396,18882,11294,157564,146270,No
SCEM,Electronics and Communication Engineering,KCET,2024,75412,76946,18981,17260,188599,171339,No
VSM,Electronics and Communication Engineering,COMEDK,2023,194885,72415,8995,15134,291429,276295,No
UVCE,Biotechnology,COMEDK,2024,231134,81155,17674,17369,347332,329963,Yes
BIT,Information Science and Engineering,KCET,2023,53826,94013,14980,21723,184542,162819,No
CITGubbi,Electronics and Communication Engineering,COMEDK,2023,220001,68703,8004,23435,320143,296708,Yes
KLEIT,Information Science and Engineering,KCET,2023,68933,92010,15491,29661,206095,176434,Yes
KLEIT,Electronics and Communication Engineering,COMEDK,2024,195706,77672,8156,17449,298983,281534,No
SJBIT,Chemical Engineering,KCET,2024,66096,84613,11452,14846,177007,162161,Yes
GIT,Biotechnology,KCET,2024,59368,65262,11492,22920,159042,136122,Yes
KSIT,Computer Science and Engineering,KCET,2023,67942,61394,8403,13550,151289,137739,Yes
BMSCE,Aerospace Engineering,COMEDK,2023,241262,73515,9656,15154,339587,324433,No
RVUNIV,Artificial Intelligence and Data Science,COMEDK,2024,234641,88958,17981,23476,365056,341580,Yes
SITM,Computer Science and Engineering,KCET,2023,64489,69124,14469,29614,177696,148082,No
JNNCE,Electronics and Communication Engineering,COMEDK,2024,197961,71887,17996,16424,304268,287844,No
VVIT,Computer Science and Engineering,KCET,2024,70227,84840,11685,27994,194746,166752,No
MSRUAS,Aerospace Engineering,COMEDK,2024,205944,77492,8293,16608,308337,291729,No
HKBK,Electronics and Communication Engineering,KCET,2023,76037,61085,16563,11550,165235,153685,Yes
MSRIT,Mechanical Engineering,COMEDK,2024,219458,90765,8682,18954,337859,318905,No
GIT,Computer Science and Engineering,KCET,2023,81915,63936,12401,20040,178292,158252,Yes
MVJCE,Aerospace Engineering,KCET,2024,50718,68112,13128,16637,148595,131958,Yes
BMSIT,Electronics and Communication Engineering,COMEDK,2024,221585,61216,15570,22127,320498,298371,Yes
VemanaIT,Biotechnology,COMEDK,2024,185107,90273,19310,22925,317615,294690,Yes
NMIT,Aerospace Engineering,COMEDK,2024,204208,65255,11020,14966,295449,280483,Yes
VSM,Mechanical Engineering,COMEDK,2023,169887,88684,18555,19903,297029,277126,No
DSATM,Aerospace Engineering,COMEDK,2023,222168,61053,8989,17919,310129,292210,No
MSRUAS,Data Science,KCET,2023,72485,79979,19796,21575,193835,172260,No
CMRIT,Aerospace Engineering,KCET,2024,55265,63344,14123,25317,158049,132732,Yes
SITM,Artificial Intelligence and Data Science,COMEDK,2023,248748,67692,11845,20726,349011,328285,No
RVCE,Biotechnology,COMEDK,2024,241888,75992,12435,16304,346619,330315,No
VSM,Civil Engineering,KCET,2023,82939,82236,8697,18620,192492,173872,Yes
KLEIT,Data Science,KCET,2023,56669,79661,13646,10885,160861,149976,No
NHCE,Artificial Intelligence and Data Science,KCET,2024,72438,93868,17166,18467,201939,183472,Yes
BITM,Robotics and Automation Engineering,COMEDK,2024,249980,74371,13070,24517,361938,337421,No
VIT,Artificial Intelligence and Data Science,KCET,2023,66501,89972,15507,10907,182887,171980,No
NMIT,Information Science and Engineering,COMEDK,2024,189765,75083,18389,28441,311678,283237,Yes
SITM,Civil Engineering,KCET,2023,68559,78457,10168,15199,172383,157184,No
BITM,Data Science,KCET,2023,51985,86200,13146,11400,162731,151331,Yes
SDMCET,Civil Engineering,COMEDK,2023,209288,90655,13086,21066,334095,313029,No
CMRIT,Data Science,COMEDK,2023,242725,67218,12959,23561,346463,322902,No
KSIT,Mechanical Engineering,COMEDK,2024,162859,89494,13201,20139,285693,265554,Yes
KLEIT,Data Science,KCET,2024,81602,61991,16970,11399,171962,160563,No
JSSSTU,Biotechnology,KCET,2024,83845,64742,13888,22382,184857,162475,No
BMSCE,Computer Science and Engineering,KCET,2023,60639,83649,14498,18929,177715,158786,Yes
DSCE,Aerospace Engineering,COMEDK,2023,165452,83075,17731,27704,293962,266258,No
VVIT,Robotics and Automation Engineering,COMEDK,2023,229460,77685,19688,17425,344258,326833,Yes
VSM,Civil Engineering,KCET,2023,61516,70366,17173,20338,169393,149055,No
SITM,Robotics and Automation Engineering,KCET,2024,61687,87565,19986,19704,188942,169238,Yes
MVJCE,Civil Engineering,KCET,2024,82050,81519,8237,11144,182950,171806,No
VIT,Electronics and Communication Engineering,COMEDK,2024,225213,70951,14088,22926,333178,310252,No
JIT,Robotics and Automation Engineering,COMEDK,2023,209611,66666,19861,24194,320332,296138,No
HKBK,Robotics and Automation Engineering,KCET,2023,81056,71358,18404,22761,193579,170818,Yes
PESU,Biotechnology,COMEDK,2023,235199,69639,17430,22259,344527,322268,Yes
UVCE,Artificial Intelligence and Data Science,COMEDK,2024,242478,70798,11784,14219,339279,325060,No
BNMIT,Biotechnology,COMEDK,2023,176319,84561,9927,13293,284100,270807,Yes
BITM,Artificial Intelligence and Data Science,COMEDK,2023,215159,78014,10020,11195,314388,303193,No
GIT,Robotics and Automation Engineering,COMEDK,2023,226512,93145,15149,14040,348846,334806,Yes
BNMIT,Information Science and Engineering,KCET,2024,72404,79634,18438,18912,189388,170476,No
PESU,Civil Engineering,COMEDK,2023,199423,65209,11449,17947,294028,276081,Yes
EastPoint,Artificial Intelligence and Data Science,COMEDK,2024,242892,71418,8634,21830,344774,322944,Yes
VVIT,Mechanical Engineering,COMEDK,2024,213276,94120,8582,21371,337349,315978,Yes
KLEIT,Information Science and Engineering,COMEDK,2024,167300,70989,17488,26290,282067,255777,Yes
UVCE,Electronics and Communication Engineering,COMEDK,2024,209719,93371,16613,17808,337511,319703,No
VemanaIT,Aerospace Engineering,COMEDK,2024,230630,92344,14503,24451,361928,337477,Yes
UVCE,Mechanical Engineering,COMEDK,2024,192908,74674,10080,14545,292207,277662,No
KSIT,Information Science and Engineering,COMEDK,2023,167041,87630,8972,14231,277874,263643,No
PRES,Mechanical Engineering,KCET,2024,69839,64568,14947,21492,170846,149354,No
NCET,Civil Engineering,KCET,2024,59540,63169,14279,16334,153322,136988,No
RNSIT,Chemical Engineering,COMEDK,2024,168636,60104,10669,14222,253631,239409,No
PRES,Civil Engineering,COMEDK,2024,213030,60214,19751,11096,304091,292995,No
SJBCE,Aerospace Engineering,KCET,2024,68716,81951,19241,12176,182084,169908,No
PESCE,Artificial Intelligence and Data Science,COMEDK,2024,182468,64282,15964,19039,281753,262714,No
SDMIT,Computer Science and Engineering,KCET,2024,83722,74630,19208,27824,205384,177560,No
BNMIT,Mechanical Engineering,KCET,2024,80192,89844,11469,15223,196728,181505,No
SITM,Robotics and Automation Engineering,COMEDK,2023,207011,72782,15368,17163,312324,295161,No
HKBK,Artificial Intelligence and Data Science,KCET,2023,55700,81244,19930,19770,176644,156874,Yes
DrAIT,Mechanical Engineering,KCET,2023,65117,69310,13155,25660,173242,147582,No
VVCE,Chemical Engineering,COMEDK,2023,190415,66428,12679,15731,285253,269522,Yes
VVCE,Mechanical Engineering,KCET,2023,50337,70722,19056,22963,163078,140115,Yes
PESU,Electrical and Electronics Engineering,COMEDK,2024,178009,87616,8355,20748,294728,273980,Yes
SJBCE,Aerospace Engineering,COMEDK,2024,162475,71142,15391,22164,271172,249008,No
DrAIT,Computer Science and Engineering,COMEDK,2024,215910,66101,11807,21347,315165,293818,Yes
KLEIT,Robotics and Automation Engineering,COMEDK,2024,189472,74480,18822,23372,306146,282774,Yes
BITM,Data Science,COMEDK,2024,244511,90599,10615,13383,359108,345725,No
RNSIT,Chemical Engineering,COMEDK,2023,245294,91975,13304,13858,364431,350573,Yes
AECMandya,Robotics and Automation Engineering,KCET,2023,57440,67699,19059,19225,163423,144198,No
VemanaIT,Artificial Intelligence and Data Science,KCET,2023,58359,82818,17546,26515,185238,158723,Yes
DSCE,Electrical and Electronics Engineering,COMEDK,2024,196876,63419,17033,10574,287902,277328,Yes
BITM,Civil Engineering,COMEDK,2023,219944,85826,17427,29187,352384,323197,Yes
JSSSTU,Electrical and Electronics Engineering,COMEDK,2023,205371,65382,12463,29351,312567,283216,No
AECMandya,Chemical Engineering,COMEDK,2023,193419,74728,13190,19733,301070,281337,No
NMIT,Civil Engineering,KCET,2024,64007,92304,8374,11969,176654,164685,No
VSM,Chemical Engineering,KCET,2024,68026,61985,8323,23832,162166,138334,No
BITM,Electronics and Communication Engineering,KCET,2024,74762,62248,15265,17321,169596,152275,Yes
VVCE,Electrical and Electronics Engineering,KCET,2024,68509,67002,9230,18551,163292,144741,Yes
ACU,Chemical Engineering,KCET,2023,74493,76389,12758,15874,179514,163640,No
CMRIT,Robotics and Automation Engineering,COMEDK,2024,164776,93394,9237,10628,278035,267407,No
RVUNIV,Computer Science and Engineering,COMEDK,2023,192478,92810,14470,11343,311101,299758,Yes
BIT,Mechanical Engineering,KCET,2023,79204,83063,17544,13279,193090,179811,No
UVCE,Civil Engineering,KCET,2023,64893,88508,8696,26505,188602,162097,Yes
NHCE,Robotics and Automation Engineering,KCET,2024,74428,74018,17512,28324,194282,165958,Yes
VIT,Biotechnology,KCET,2023,77131,90194,10912,17647,195884,178237,Yes
REVA,Electrical and Electronics Engineering,COMEDK,2023,220888,70578,13073,10661,315200,304539,No
NIE,Artificial Intelligence and Data Science,KCET,2023,51443,79696,18058,28017,177214,149197,No
PESCE,Computer Science and Engineering,KCET,2023,56940,92135,13923,13184,176182,162998,Yes
EastPoint,Robotics and Automation Engineering,COMEDK,2023,228810,63905,18477,12546,323738,311192,No
REVA,Artificial Intelligence and Data Science,KCET,2024,56648,62786,14303,19227,152964,133737,Yes
SDMCET,Robotics and Automation Engineering,COMEDK,2024,224025,70410,9239,23361,327035,303674,No
RIT,Civil Engineering,KCET,2023,57754,64377,9359,29468,160958,131490,No
REVA,Mechanical Engineering,KCET,2024,60501,78479,18656,11409,169045,157636,No
MSRIT,Chemical Engineering,COMEDK,2024,202366,89813,8507,17564,318250,300686,Yes
NCET,Computer Science and Engineering,COMEDK,2023,226593,67027,18386,14378,326384,312006,No
MSRIT,Aerospace Engineering,COMEDK,2023,184788,88390,19189,18388,310755,292367,Yes
AIT,Information Science and Engineering,KCET,2023,75927,87468,16411,13986,193792,179806,Yes
AIT,Chemical Engineering,COMEDK,2024,168097,87520,8671,19986,284274,264288,No
BMSIT,Chemical Engineering,KCET,2024,84359,89766,16471,16698,207294,190596,Yes
DSATM,Information Science and Engineering,KCET,2024,83007,84969,12078,10385,190439,180054,Yes
EastPoint,Artificial Intelligence and Data Science,COMEDK,2024,191984,71263,10097,15767,289111,273344,No
MSRIT,Information Science and Engineering,KCET,2023,74831,84229,16699,28526,204285,175759,Yes
SJBIT,Information Science and Engineering,KCET,2024,69288,66268,19232,27899,182687,154788,Yes
MVJCE,Computer Science and Engineering,COMEDK,2024,213030,69569,15772,15575,313946,298371,No
SJBCE,Robotics and Automation Engineering,KCET,2024,57739,82271,14565,18044,172619,154575,No
BIT,Aerospace Engineering,COMEDK,2023,227383,74827,8678,18098,328986,310888,No
PRES,Aerospace Engineering,KCET,2023,84480,84393,9767,17677,196317,178640,Yes
SIT,Robotics and Automation Engineering,COMEDK,2024,237110,85855,14132,16237,353334,337097,Yes
BMSIT,Robotics and Automation Engineering,COMEDK,2024,187975,72519,12765,13023,286282,273259,Yes
PESCE,Artificial Intelligence and Data Science,KCET,2023,50133,67775,16674,18971,153553,134582,Yes
BMSIT,Civil Engineering,KCET,2024,76563,81982,11076,11751,181372,169621,Yes
BITM,Aerospace Engineering,COMEDK,2024,218014,72419,13952,14098,318483,304385,Yes
NMIT,Computer Science and Engineering,KCET,2024,82473,73250,12248,21785,189756,167971,Yes
GMIT,Computer Science and Engineering,KCET,2023,75853,77694,13478,23973,190998,167025,No
GIT,Robotics and Automation Engineering,KCET,2024,75341,64183,10577,25562,175663,150101,Yes
DBIT,Data Science,KCET,2023,80487,69098,12037,29746,191368,161622,No
BMSCE,Robotics and Automation Engineering,KCET,2023,61694,84133,12760,12537,171124,158587,Yes
VemanaIT,Computer Science and Engineering,KCET,2023,57576,89786,8816,26867,183045,156178,No
JIT,Electrical and Electronics Engineering,KCET,2024,52204,91830,17719,18633,180386,161753,Yes
DBIT,Electrical and Electronics Engineering,KCET,2023,73361,61546,18238,16043,169188,153145,Yes
RVCE,Civil Engineering,COMEDK,2023,234019,77747,18410,29173,359349,330176,No
BMSIT,Information Science and Engineering,COMEDK,2023,247495,66771,12632,14486,341384,326898,No
NCET,Robotics and Automation Engineering,KCET,2023,54850,88723,17952,22348,183873,161525,No
KLEIT,Chemical Engineering,COMEDK,2023,214093,68946,12812,26439,322290,295851,No
DBIT,Aerospace Engineering,KCET,2024,82280,81905,8194,22866,195245,172379,No
ACU,Chemical Engineering,COMEDK,2023,234053,64140,19862,28874,346929,318055,Yes
DSATM,Electronics and Communication Engineering,KCET,2023,68594,87247,13999,25929,195769,169840,Yes
RNSIT,Robotics and Automation Engineering,COMEDK,2024,196579,63021,19737,16445,295782,279337,Yes
ACU,Aerospace Engineering,COMEDK,2024,186077,88958,12812,12068,299915,287847,No
JSSSTU,Biotechnology,COMEDK,2024,195544,66876,17473,26284,306177,279893,No
NHCE,Mechanical Engineering,COMEDK,2023,193566,87134,9563,28047,318310,290263,Yes
RVCE,Electronics and Communication Engineering,KCET,2023,52774,64400,19113,12092,148379,136287,Yes
BMSCE,Data Science,KCET,2024,67792,86105,9836,14148,177881,163733,Yes
NIE,Computer Science and Engineering,KCET,2024,54747,89862,12230,20296,177135,156839,No
AECMandya,Computer Science and Engineering,COMEDK,2023,163269,60906,11640,19375,255190,235815,Yes
RVCE,Robotics and Automation Engineering,KCET,2024,54444,84849,12773,27893,179959,152066,Yes
VemanaIT,Computer Science and Engineering,KCET,2024,62880,69605,18804,19123,170412,151289,Yes
RAIT,Mechanical Engineering,KCET,2024,61194,70834,15119,18185,165332,147147,No
BMIT,Information Science and Engineering,COMEDK,2024,222786,64726,9333,17248,314093,296845,No
JSSSTU,Civil Engineering,COMEDK,2024,209274,90105,8859,27000,335238,308238,Yes
BNMIT,Chemical Engineering,KCET,2024,74302,89424,8655,26172,198553,172381,No
DSCE,Data Science,COMEDK,2023,185915,85882,15641,20851,308289,287438,Yes
SDMIT,Data Science,COMEDK,2024,171458,88681,18951,17213,296303,279090,No
AIT,Artificial Intelligence and Data Science,KCET,2024,69709,80775,13858,10001,174343,164342,No
SJBIT,Computer Science and Engineering,COMEDK,2023,174413,78498,13696,10119,276726,266607,No
JSSSTU,Electronics and Communication Engineering,KCET,2023,78970,90459,16664,10580,196673,186093,No
BMIT,Computer Science and Engineering,COMEDK,2024,238401,80131,18168,17033,353733,336700,Yes
ACU,Robotics and Automation Engineering,KCET,2024,62901,78994,12869,22434,177198,154764,Yes
SDMIT,Data Science,COMEDK,2024,191014,73274,16824,14892,296004,281112,No
GMIT,Mechanical Engineering,KCET,2023,82277,64334,9671,18139,174421,156282,No
BNMIT,Civil Engineering,KCET,2024,73944,67428,19375,28195,188942,160747,Yes
VIT,Aerospace Engineering,COMEDK,2024,232030,74730,17308,13491,337559,324068,No
KLSGIT,Computer Science and Engineering,KCET,2023,81351,71695,14750,29296,197092,167796,Yes
VVCE,Aerospace Engineering,COMEDK,2023,162922,60814,15360,22675,261771,239096,Yes
ACU,Aerospace Engineering,COMEDK,2023,194490,75354,14022,11499,295365,283866,No
PESCE,Civil Engineering,COMEDK,2023,233686,63866,18453,17654,333659,316005,Yes
JIT,Robotics and Automation Engineering,KCET,2023,54154,83715,8723,21270,167862,146592,No
AECMandya,Information Science and Engineering,KCET,2024,59554,76541,15129,17160,168384,151224,Yes
HKBK,Mechanical Engineering,COMEDK,2023,231874,71135,16058,20710,339777,319067,Yes
ACU,Electronics and Communication Engineering,COMEDK,2023,216963,63330,19410,28604,328307,299703,No
RAIT,Electrical and Electronics Engineering,COMEDK,2024,195756,68468,17539,22430,304193,281763,Yes
GMIT,Biotechnology,COMEDK,2023,193871,82851,9367,26205,312294,286089,No
CITGubbi,Mechanical Engineering,KCET,2024,65152,75095,8882,24572,173701,149129,No
DSCE,Artificial Intelligence and Data Science,KCET,2024,59741,68567,11780,22684,162772,140088,No
NCET,Robotics and Automation Engineering,COMEDK,2024,184791,61719,13885,20510,280905,260395,No
AIT,Aerospace Engineering,COMEDK,2024,241858,74125,16008,27030,359021,331991,Yes
BIT,Data Science,KCET,2023,52133,87970,9383,22095,171581,149486,Yes
VIT,Biotechnology,COMEDK,2024,190854,79596,11264,17223,298937,281714,Yes
BMSCE,Electronics and Communication Engineering,COMEDK,2023,218826,77693,16663,11698,324880,313182,No
BMIT,Robotics and Automation Engineering,KCET,2023,52867,80719,16233,17792,167611,149819,No
RVCE,Robotics and Automation Engineering,COMEDK,2024,178908,88820,15640,19502,302870,283368,Yes
DSATM,Chemical Engineering,COMEDK,2023,170908,81014,12102,21095,285119,264024,No
EastPoint,Civil Engineering,COMEDK,2024,230099,69217,19252,29894,348462,318568,Yes
VIT,Robotics and Automation Engineering,KCET,2023,67127,69572,10411,25873,172983,147110,No
JIT,Aerospace Engineering,KCET,2023,68757,91865,12207,17328,190157,172829,No
MVJCE,Data Science,KCET,2023,76109,79679,9446,26365,191599,165234,No
KSIT,Robotics and Automation Engineering,COMEDK,2024,203953,72965,16930,14112,307960,293848,Yes
BMSCE,Chemical Engineering,KCET,2023,67417,63084,17010,15418,162929,147511,No
SDMIT,Artificial Intelligence and Data Science,COMEDK,2023,202194,78010,9585,21593,311382,289789,No
YKCE,Aerospace Engineering,COMEDK,2024,175116,67213,11782,10650,264761,254111,No
VVIT,Chemical Engineering,COMEDK,2024,244627,91141,10256,29439,375463,346024,Yes
NIE,Robotics and Automation Engineering,KCET,2024,55113,75260,16138,13186,159697,146511,Yes
NMIT,Biotechnology,KCET,2024,79857,94209,10595,21993,206654,184661,Yes
GIT,Biotechnology,COMEDK,2024,203985,79656,10911,22754,317306,294552,Yes
SIT,Mechanical Engineering,COMEDK,2024,214487,89412,15825,17438,337162,319724,Yes
KLSGIT,Civil Engineering,COMEDK,2023,233828,77604,14726,14701,340859,326158,No
SDMIT,Artificial Intelligence and Data Science,COMEDK,2024,183123,94247,19107,11541,308018,296477,Yes
BMIT,Information Science and Engineering,KCET,2023,65083,69048,19574,23929,177634,153705,No
NHCE,Electrical and Electronics Engineering,COMEDK,2024,192966,82181,15703,29355,320205,290850,No
KSIT,Aerospace Engineering,KCET,2023,77263,94873,19618,13636,205390,191754,Yes
KLSGIT,Computer Science and Engineering,COMEDK,2023,246797,72554,10659,12992,343002,330010,Yes
BITM,Data Science,COMEDK,2023,197268,81767,9327,28612,316974,288362,No
AIT,Information Science and Engineering,KCET,2024,82853,64244,13338,15343,175778,160435,Yes
MSRIT,Aerospace Engineering,KCET,2024,66728,86874,9121,15740,178463,162723,No
AITM,Robotics and Automation Engineering,KCET,2023,55061,92298,13946,10434,171739,161305,No
RNSIT,Data Science,COMEDK,2023,201344,87028,8195,23844,320411,296567,Yes
RNSIT,Data Science,KCET,2024,59975,91861,12898,13038,177772,164734,Yes
YKCE,Data Science,KCET,2024,54536,89990,10926,16533,171985,155452,Yes
EastPoint,Computer Science and Engineering,COMEDK,2023,248267,87294,13200,29291,378052,348761,No
AIT,Artificial Intelligence and Data Science,KCET,2024,54758,83240,14286,19263,171547,152284,No
SCEM,Information Science and Engineering,KCET,2024,71140,66415,13418,21376,172349,150973,Yes
SIT,Aerospace Engineering,KCET,2024,83391,84535,9801,18307,196034,177727,No
SJBIT,Data Science,COMEDK,2023,242382,62732,12752,21055,338921,317866,Yes
GMIT,Mechanical Engineering,COMEDK,2023,183196,60049,19994,29165,292404,263239,No
HKBK,Data Science,KCET,2024,64477,65579,8087,28442,166585,138143,Yes
RNSIT,Biotechnology,KCET,2023,62786,66942,15637,25305,170670,145365,Yes
BMIT,Chemical Engineering,KCET,2024,62071,63922,15726,11060,152779,141719,Yes
AEC,Artificial Intelligence and Data Science,KCET,2024,60988,92793,12023,25270,191074,165804,No
AIT,Chemical Engineering,KCET,2023,70531,64782,19981,11270,166564,155294,Yes
VSM,Computer Science and Engineering,COMEDK,2024,204650,79950,10274,29869,324743,294874,No
BNMIT,Electronics and Communication Engineering,COMEDK,2024,225406,65782,15316,17262,323766,306504,Yes
SIT,Mechanical Engineering,KCET,2024,81295,70467,10298,23263,185323,162060,Yes
PESU,Information Science and Engineering,KCET,2024,79980,69546,11031,27158,187715,160557,No
REVA,Robotics and Automation Engineering,KCET,2024,74890,76251,11976,12199,175316,163117,Yes
PESCE,Information Science and Engineering,COMEDK,2023,174029,87961,13203,22160,297353,275193,No
NMIT,Aerospace Engineering,COMEDK,2023,162569,85158,9593,20381,277701,257320,Yes
GIT,Chemical Engineering,KCET,2023,63672,64959,15427,28567,172625,144058,No
PRES,Data Science,KCET,2023,75283,76774,13833,16042,181932,165890,Yes
KSIT,Aerospace Engineering,KCET,2024,64602,78402,18921,25883,187808,161925,Yes
EastPoint,Civil Engineering,COMEDK,2023,197228,78402,19533,12033,307196,295163,Yes
YKCE,Electronics and Communication Engineering,KCET,2024,60291,68718,11446,26256,166711,140455,No
KSIT,Robotics and Automation Engineering,KCET,2023,82308,63318,11234,27721,184581,156860,No
CITGubbi,Biotechnology,COMEDK,2023,236609,72855,17680,19301,346445,327144,Yes
NMIT,Civil Engineering,KCET,2023,81687,76008,19147,20796,197638,176842,No
YKCE,Robotics and Automation Engineering,KCET,2023,59284,84346,16844,16971,177445,160474,No
JNNCE,Biotechnology,KCET,2024,84919,76925,11518,15110,188472,173362,No
CITGubbi,Electrical and Electronics Engineering,KCET,2024,84586,60588,19128,14343,178645,164302,No
MSRUAS,Information Science and Engineering,COMEDK,2023,221374,65327,17195,18691,322587,303896,Yes
GMIT,Mechanical Engineering,COMEDK,2024,199803,81293,15240,29141,325477,296336,Yes
RAIT,Artificial Intelligence and Data Science,COMEDK,2023,211325,86723,9588,18727,326363,307636,Yes
AIT,Aerospace Engineering,COMEDK,2023,240319,72094,12319,12921,337653,324732,No
PESCE,Electronics and Communication Engineering,COMEDK,2024,215283,79178,19268,20494,334223,313729,No
NMIT,Data Science,KCET,2024,59714,85299,16500,27504,189017,161513,Yes
KLEIT,Artificial Intelligence and Data Science,KCET,2023,59526,67557,10817,18951,156851,137900,Yes
JSSSTU,Computer Science and Engineering,COMEDK,2023,204004,83447,14054,14674,316179,301505,No
BITM,Biotechnology,COMEDK,2023,179310,81893,10375,23399,294977,271578,No
AEC,Electronics and Communication Engineering,COMEDK,2024,199568,81672,10486,29314,321040,291726,Yes
PRES,Data Science,COMEDK,2023,220524,68239,19599,14349,322711,308362,Yes
RVCE,Biotechnology,KCET,2023,76330,76906,13285,10061,176582,166521,Yes
MSRIT,Electronics and Communication Engineering,COMEDK,2024,176191,60601,17361,16691,270844,254153,Yes
NCET,Information Science and Engineering,COMEDK,2024,214650,71811,19686,28845,334992,306147,Yes
BMIT,Aerospace Engineering,KCET,2023,73481,83740,13122,16680,187023,170343,Yes
DrAIT,Electrical and Electronics Engineering,KCET,2024,61261,76977,11597,13716,163551,149835,No
NCET,Electrical and Electronics Engineering,KCET,2024,65003,74940,8244,20065,168252,148187,No
MSRUAS,Biotechnology,KCET,2024,74056,64038,19596,16873,174563,157690,Yes
SITM,Electronics and Communication Engineering,COMEDK,2023,234521,82006,13187,19971,349685,329714,No
SJBIT,Robotics and Automation Engineering,COMEDK,2024,246334,89912,10979,20671,367896,347225,No
YKCE,Information Science and Engineering,KCET,2023,75986,91147,13367,22497,202997,180500,Yes
DrAIT,Robotics and Automation Engineering,COMEDK,2024,163252,81553,18691,27229,290725,263496,Yes
MVJCE,Biotechnology,COMEDK,2023,244108,64544,19479,29219,357350,328131,Yes
GMIT,Chemical Engineering,COMEDK,2023,233518,85833,11350,28274,358975,330701,Yes
RNSIT,Data Science,KCET,2024,63358,88644,11699,25619,189320,163701,Yes
JNNCE,Computer Science and Engineering,KCET,2024,73176,72742,12165,20692,178775,158083,No
KLSGIT,Information Science and Engineering,KCET,2023,58604,93210,11767,28830,192411,163581,No
KLEIT,Computer Science and Engineering,KCET,2023,83028,76775,10955,19774,190532,170758,Yes
BIT,Artificial Intelligence and Data Science,KCET,2023,60624,91325,9111,16687,177747,161060,No
BMSCE,Electronics and Communication Engineering,COMEDK,2023,226466,62790,9394,16054,314704,298650,Yes
PESCE,Biotechnology,KCET,2023,53096,85028,14141,21122,173387,152265,No
BMIT,Aerospace Engineering,COMEDK,2024,222140,81898,8578,28307,340923,312616,Yes
PESU,Computer Science and Engineering,KCET,2023,70619,69293,12974,18428,171314,152886,Yes
DBIT,Mechanical Engineering,KCET,2024,84552,82098,14760,12191,193601,181410,Yes
NIE,Robotics and Automation Engineering,COMEDK,2024,171334,66556,17252,12469,267611,255142,Yes
VemanaIT,Aerospace Engineering,KCET,2023,52644,76262,16912,27986,173804,145818,No
JSSSTU,Aerospace Engineering,COMEDK,2024,234037,60773,16367,16445,327622,311177,No
SDMIT,Electronics and Communication Engineering,COMEDK,2024,183446,76876,8767,22688,291777,269089,No
JNNCE,Biotechnology,KCET,2024,53700,60522,18827,17446,150495,133049,Yes
BMSIT,Information Science and Engineering,COMEDK,2023,202834,93951,13170,10809,320764,309955,Yes
SDMIT,Biotechnology,KCET,2023,51154,74753,18058,29058,173023,143965,No
SJBCE,Mechanical Engineering,COMEDK,2023,248190,62074,8029,16828,335121,318293,Yes
NHCE,Civil Engineering,COMEDK,2024,180819,90012,18586,12877,302294,289417,No
GMIT,Robotics and Automation Engineering,KCET,2024,70678,83740,11256,29869,195543,165674,No
BMSCE,Information Science and Engineering,KCET,2023,59617,76003,16827,13193,165640,152447,Yes
GIT,Mechanical Engineering,COMEDK,2023,209365,68649,13744,23503,315261,291758,Yes
MSRUAS,Chemical Engineering,COMEDK,2024,177883,70030,12760,10888,271561,260673,No
PRES,Biotechnology,KCET,2023,84651,72706,17788,25208,200353,175145,No
VVCE,Mechanical Engineering,COMEDK,2024,189347,65005,15372,24869,294593,269724,No
VVIT,Data Science,COMEDK,2024,216709,63911,17542,27797,325959,298162,Yes
NIE,Information Science and Engineering,KCET,2024,75452,61050,19632,26306,182440,156134,No
VemanaIT,Electronics and Communication Engineering,KCET,2023,73567,62858,14712,13860,164997,151137,Yes
SDMIT,Computer Science and Engineering,COMEDK,2024,226043,72083,17729,11588,327443,315855,Yes
MVJCE,Electrical and Electronics Engineering,COMEDK,2024,211619,85032,15314,27298,339263,311965,No
HKBK,Computer Science and Engineering,COMEDK,2024,245036,70122,13565,26266,354989,328723,No
GIT,Aerospace Engineering,KCET,2024,77413,61969,17047,23236,179665,156429,Yes
CITGubbi,Information Science and Engineering,COMEDK,2024,215728,75511,14373,10132,315744,305612,Yes
VVCE,Information Science and Engineering,COMEDK,2023,228825,88093,17610,25181,359709,334528,Yes
AITM,Data Science,COMEDK,2023,216778,68711,12879,21374,319742,298368,No
RNSIT,Mechanical Engineering,KCET,2024,70438,62730,10451,20828,164447,143619,No
DBIT,Electronics and Communication Engineering,KCET,2024,83450,90455,8105,14266,196276,182010,Yes
BMSIT,Mechanical Engineering,KCET,2024,65584,86133,19335,23413,194465,171052,No
DSCE,Robotics and Automation Engineering,KCET,2024,51723,91184,16913,23385,183205,159820,No
NCET,Data Science,COMEDK,2023,243051,65512,13613,16866,339042,322176,Yes
GIT,Chemical Engineering,KCET,2024,72051,79623,16723,21216,189613,168397,No
NIE,Electrical and Electronics Engineering,COMEDK,2023,223741,65417,8346,18563,316067,297504,Yes
NHCE,Mechanical Engineering,KCET,2024,53289,85705,8731,12131,159856,147725,Yes
MSRIT,Civil Engineering,KCET,2024,84006,76737,13882,12785,187410,174625,Yes
RVCE,Mechanical Engineering,COMEDK,2023,190037,67611,13371,19090,290109,271019,No
BMSIT,Chemical Engineering,COMEDK,2023,179760,80208,10471,26695,297134,270439,No
KLEIT,Information Science and Engineering,COMEDK,2023,216412,88318,16839,25752,347321,321569,No
VSM,Computer Science and Engineering,COMEDK,2024,160162,85047,12165,29340,286714,257374,Yes
RVUNIV,Electrical and Electronics Engineering,COMEDK,2023,168206,66900,12001,20770,267877,247107,No
ACU,Mechanical Engineering,KCET,2024,67344,62846,11408,10432,152030,141598,No
VIT,Biotechnology,COMEDK,2023,164064,69583,8823,25375,267845,242470,Yes
SDMIT,Computer Science and Engineering,KCET,2024,80205,71128,10562,19533,181428,161895,Yes
VVIT,Information Science and Engineering,KCET,2024,73157,93757,16279,23794,206987,183193,No
SDMCET,Chemical Engineering,COMEDK,2023,194649,60083,11775,12605,279112,266507,Yes
DrAIT,Electrical and Electronics Engineering,KCET,2024,63835,61020,17991,21977,164823,142846,No
MSRUAS,Mechanical Engineering,COMEDK,2024,186693,93617,15218,18184,313712,295528,Yes
SDMCET,Biotechnology,COMEDK,2024,236282,82602,9807,15621,344312,328691,Yes
BNMIT,Aerospace Engineering,KCET,2024,82288,85411,13888,22357,203944,181587,Yes
PRES,Chemical Engineering,COMEDK,2024,242182,63060,19258,11091,335591,324500,Yes
AITM,Information Science and Engineering,KCET,2023,73233,88988,9559,10885,182665,171780,No
PESCE,Chemical Engineering,COMEDK,2023,214279,89982,14074,20925,339260,318335,No
DSATM,Electronics and Communication Engineering,KCET,2023,53176,83777,16068,17328,170349,153021,Yes
RVCE,Electrical and Electronics Engineering,COMEDK,2024,199658,72738,15934,11450,299780,288330,No
AIT,Civil Engineering,COMEDK,2023,235211,67965,15383,16669,335228,318559,No
BNMIT,Civil Engineering,COMEDK,2024,168884,72238,8584,25657,275363,249706,No
NIE,Data Science,COMEDK,2023,166582,87398,9973,20641,284594,263953,Yes
BMSCE,Mechanical Engineering,COMEDK,2024,218126,61075,14891,15061,309153,294092,Yes
SDMIT,Biotechnology,COMEDK,2023,168793,87291,8176,12949,277209,264260,Yes
JNNCE,Electrical and Electronics Engineering,COMEDK,2023,200435,92907,13202,19375,325919,306544,No
SDMCET,Information Science and Engineering,COMEDK,2023,196481,60910,8127,12449,277967,265518,No
KLEIT,Robotics and Automation Engineering,KCET,2024,81213,82571,15352,24231,203367,179136,Yes
VemanaIT,Mechanical Engineering,KCET,2023,75121,62354,16866,21854,176195,154341,Yes
SITM,Aerospace Engineering,COMEDK,2024,241376,68964,8510,22944,341794,318850,Yes
YKCE,Artificial Intelligence and Data Science,KCET,2024,60563,69310,13093,22090,165056,142966,No
RVUNIV,Aerospace Engineering,COMEDK,2023,192858,85007,19496,25621,322982,297361,Yes
PRES,Information Science and Engineering,KCET,2024,60449,67309,14485,12229,154472,142243,Yes
MVJCE,Civil Engineering,KCET,2023,50499,64779,16475,26180,157933,131753,No
REVA,Electrical and Electronics Engineering,KCET,2024,56547,85151,17357,24577,183632,159055,No
RIT,Biotechnology,COMEDK,2023,243771,83789,11891,11162,350613,339451,No
SJBCE,Electronics and Communication Engineering,COMEDK,2023,190420,85493,10006,13355,299274,285919,Yes
VVCE,Robotics and Automation Engineering,KCET,2023,71335,88739,16549,24898,201521,176623,Yes
KSIT,Chemical Engineering,KCET,2024,63418,66680,17195,15703,162996,147293,Yes
VVCE,Information Science and Engineering,COMEDK,2023,188908,60187,15496,14652,279243,264591,No
PESU,Chemical Engineering,KCET,2024,71609,82289,17117,24529,195544,171015,Yes
MSRUAS,Civil Engineering,COMEDK,2024,247796,73697,13752,29108,364353,335245,No
PESCE,Mechanical Engineering,KCET,2024,57894,71568,17065,24967,171494,146527,Yes
BMIT,Information Science and Engineering,COMEDK,2023,183563,72710,13930,24066,294269,270203,Yes
UVCE,Electronics and Communication Engineering,COMEDK,2023,170782,82537,11194,15373,279886,264513,Yes
VIT,Information Science and Engineering,COMEDK,2024,243232,76947,12766,20747,353692,332945,No
MSRIT,Mechanical Engineering,COMEDK,2023,196677,64880,18835,12328,292720,280392,Yes
VVCE,Electronics and Communication Engineering,KCET,2024,75317,80622,16893,13417,186249,172832,Yes
DSATM,Electrical and Electronics Engineering,COMEDK,2024,172569,65858,14429,21948,274804,252856,No
CMRIT,Chemical Engineering,COMEDK,2023,205693,66653,13084,22635,308065,285430,No
JIT,Chemical Engineering,KCET,2024,71666,92849,16986,24508,206009,181501,No
MSRUAS,Artificial Intelligence and Data Science,KCET,2024,71241,60294,17225,24580,173340,148760,No
BIT,Civil Engineering,COMEDK,2023,162285,74626,16600,22136,275647,253511,No
SDMCET,Biotechnology,COMEDK,2023,245008,80328,18833,19576,363745,344169,No
DSCE,Data Science,COMEDK,2023,246528,78359,14379,14693,353959,339266,No
NCET,Robotics and Automation Engineering,KCET,2023,80656,78183,9209,28005,196053,168048,Yes
VVCE,Artificial Intelligence and Data Science,KCET,2023,57213,89887,16212,27775,191087,163312,Yes
VemanaIT,Biotechnology,KCET,2023,80716,66528,10013,10467,167724,157257,No
NIE,Robotics and Automation Engineering,KCET,2023,70343,86530,16569,26665,200107,173442,No
DSCE,Robotics and Automation Engineering,COMEDK,2024,172369,66349,14185,14970,267873,252903,No
HKBK,Mechanical Engineering,COMEDK,2024,227246,86076,13354,20230,346906,326676,Yes
BITM,Mechanical Engineering,COMEDK,2023,184727,62774,9685,17703,274889,257186,No
BMSCE,Civil Engineering,COMEDK,2023,208781,66240,9045,23285,307351,284066,Yes
KSIT,Information Science and Engineering,COMEDK,2024,199072,87633,15230,25335,327270,301935,Yes
DSATM,Electronics and Communication Engineering,COMEDK,2024,191369,72348,18681,28990,311388,282398,No
CITGubbi,Aerospace Engineering,COMEDK,2023,188068,74428,17566,21715,301777,280062,No
GMIT,Chemical Engineering,KCET,2024,76079,63995,8493,20041,168608,148567,Yes
SDMIT,Aerospace Engineering,COMEDK,2024,177159,75151,10297,17899,280506,262607,No
AEC,Electronics and Communication Engineering,KCET,2023,53003,89700,8237,11919,162859,150940,No
SJBCE,Data Science,KCET,2024,72620,92785,15410,19397,200212,180815,Yes
SJBCE,Civil Engineering,KCET,2023,79906,63645,15803,18313,177667,159354,No
SDMIT,Artificial Intelligence and Data Science,KCET,2024,76553,73109,10536,12258,172456,160198,Yes
MSRIT,Artificial Intelligence and Data Science,COMEDK,2023,216075,83534,12020,11536,323165,311629,Yes
MSRUAS,Chemical Engineering,KCET,2023,77693,90447,12576,27164,207880,180716,Yes
BIT,Civil Engineering,KCET,2023,65752,66872,19207,21971,173802,151831,Yes
AITM,Biotechnology,KCET,2023,55554,83132,13368,24685,176739,152054,Yes
VSM,Data Science,COMEDK,2024,242704,86372,16609,18440,364125,345685,Yes
AEC,Artificial Intelligence and Data Science,COMEDK,2023,199593,80382,18416,13216,311607,298391,Yes
DrAIT,Chemical Engineering,KCET,2023,57282,69211,17859,18032,162384,144352,No
BIT,Chemical Engineering,KCET,2023,71171,73840,10738,11777,167526,155749,Yes
VIT,Civil Engineering,KCET,2024,80102,62956,13351,29956,186365,156409,No
YKCE,Robotics and Automation Engineering,COMEDK,2023,171297,93839,14226,16801,296163,279362,No
SCEM,Civil Engineering,KCET,2024,77489,67186,19990,23748,188413,164665,No
AECMandya,Artificial Intelligence and Data Science,COMEDK,2024,206753,87436,19354,25586,339129,313543,No
RVUNIV,Electronics and Communication Engineering,KCET,2024,71930,67212,10002,17022,166166,149144,Yes
NHCE,Computer Science and Engineering,COMEDK,2024,246275,70259,13843,16377,346754,330377,Yes
SDMCET,Robotics and Automation Engineering,COMEDK,2024,239588,67589,16873,13129,337179,324050,Yes
HKBK,Data Science,COMEDK,2024,227852,66819,19757,10958,325386,314428,Yes
VVIT,Information Science and Engineering,COMEDK,2023,188958,84728,12720,14663,301069,286406,No
BITM,Mechanical Engineering,KCET,2024,69988,69349,16489,17922,173748,155826,Yes
JIT,Civil Engineering,COMEDK,2023,239545,92275,11108,12832,355760,342928,No
PRES,Computer Science and Engineering,KCET,2023,54465,81208,17225,20722,173620,152898,No
CITGubbi,Information Science and Engineering,COMEDK,2023,245428,77722,14706,19390,357246,337856,Yes
VemanaIT,Data Science,COMEDK,2024,210277,87347,10692,28307,336623,308316,No
AEC,Mechanical Engineering,KCET,2024,55795,60239,12610,20080,148724,128644,Yes
VVIT,Electronics and Communication Engineering,COMEDK,2023,249133,67017,8153,22084,346387,324303,No
EastPoint,Biotechnology,COMEDK,2023,230196,90061,16464,19692,356413,336721,No
KSIT,Biotechnology,KCET,2024,60020,93472,12912,28612,195016,166404,Yes
NHCE,Biotechnology,KCET,2024,61567,85516,9992,25335,182410,157075,Yes
DrAIT,Biotechnology,KCET,2024,78435,76456,13320,20081,188292,168211,Yes
JIT,Computer Science and Engineering,COMEDK,2023,238746,93705,9366,20009,361826,341817,No
MSRIT,Chemical Engineering,KCET,2023,61413,83500,12704,29931,187548,157617,No
KLEIT,Robotics and Automation Engineering,KCET,2023,56715,70109,15259,19694,161777,142083,Yes
PRES,Artificial Intelligence and Data Science,KCET,2023,82931,71082,15940,26039,195992,169953,Yes
SDMIT,Artificial Intelligence and Data Science,COMEDK,2024,212758,91514,17112,12297,333681,321384,Yes
JNNCE,Biotechnology,KCET,2023,74567,90198,13612,11380,189757,178377,Yes
RNSIT,Electronics and Communication Engineering,COMEDK,2023,247656,60812,18734,15853,343055,327202,Yes
PESCE,Mechanical Engineering,COMEDK,2024,195369,71350,14248,21076,302043,280967,Yes
BNMIT,Computer Science and Engineering,KCET,2023,82286,65788,8650,25121,181845,156724,No
JIT,Robotics and Automation Engineering,COMEDK,2024,244981,74709,8854,10982,339526,328544,Yes
DBIT,Data Science,KCET,2024,71477,60242,18500,15602,165821,150219,No
BNMIT,Information Science and Engineering,KCET,2023,70768,66361,16062,12481,165672,153191,Yes
DSCE,Civil Engineering,KCET,2024,63622,75127,16965,12426,168140,155714,No
BMSIT,Computer Science and Engineering,KCET,2023,53935,67310,14116,16826,152187,135361,No
BMSCE,Aerospace Engineering,COMEDK,2024,164478,71615,8304,28763,273160,244397,Yes
DBIT,Computer Science and Engineering,COMEDK,2023,226202,83887,10491,10594,331174,320580,Yes
BMSIT,Electronics and Communication Engineering,KCET,2023,52153,76068,11958,14436,154615,140179,Yes
NHCE,Information Science and Engineering,KCET,2024,62936,93338,13084,22990,192348,169358,Yes
NCET,Chemical Engineering,KCET,2024,69071,72486,11106,24399,177062,152663,No
AITM,Robotics and Automation Engineering,COMEDK,2023,195574,72080,11863,29737,309254,279517,No
PESU,Aerospace Engineering,COMEDK,2024,176396,70082,16588,13568,276634,263066,No
AITM,Information Science and Engineering,COMEDK,2023,191007,77676,16242,13183,298108,284925,Yes
RIT,Computer Science and Engineering,KCET,2023,68481,86207,18279,21665,194632,172967,Yes
KSIT,Biotechnology,KCET,2023,75110,84667,11119,12215,183111,170896,Yes
MSRIT,Mechanical Engineering,KCET,2024,84492,74267,14363,18694,191816,173122,Yes
MSRUAS,Mechanical Engineering,COMEDK,2024,225124,92133,8073,21645,346975,325330,Yes
NIE,Chemical Engineering,COMEDK,2024,225022,94067,17571,14273,350933,336660,No
EastPoint,Aerospace Engineering,KCET,2024,66690,92665,12874,13647,185876,172229,Yes
BNMIT,Biotechnology,COMEDK,2023,249011,66281,15633,21531,352456,330925,No
RNSIT,Robotics and Automation Engineering,COMEDK,2024,177680,71911,11815,27173,288579,261406,Yes
SITM,Computer Science and Engineering,KCET,2023,75784,62126,13847,10793,162550,151757,Yes
KSIT,Electrical and Electronics Engineering,COMEDK,2024,191424,88251,14096,28321,322092,293771,No
RVCE,Aerospace Engineering,KCET,2024,54600,75025,8965,25755,164345,138590,No
EastPoint,Information Science and Engineering,COMEDK,2024,225040,67178,17610,20282,330110,309828,Yes
PRES,Information Science and Engineering,KCET,2024,56402,68509,18006,14123,157040,142917,Yes
KLSGIT,Aerospace Engineering,COMEDK,2024,204503,83763,8554,12284,309104,296820,No
NMIT,Chemical Engineering,KCET,2023,63766,87736,11444,13049,175995,162946,No
NHCE,Biotechnology,COMEDK,2023,172624,79002,14638,16075,282339,266264,Yes
GMIT,Chemical Engineering,COMEDK,2024,205169,81970,15047,12043,314229,302186,No
BMSCE,Artificial Intelligence and Data Science,KCET,2024,83298,93811,8159,16278,201546,185268,Yes
VVCE,Civil Engineering,KCET,2023,68048,84077,10244,15781,178150,162369,No
MSRUAS,Data Science,COMEDK,2024,176315,63144,15078,26481,281018,254537,No
NHCE,Mechanical Engineering,COMEDK,2024,194396,70610,15894,28384,309284,280900,Yes
SJBIT,Civil Engineering,COMEDK,2023,181389,86511,13461,24029,305390,281361,No
NIE,Data Science,COMEDK,2024,244017,76767,10477,20690,351951,331261,No
JIT,Mechanical Engineering,KCET,2023,67848,80162,13966,28428,190404,161976,No
MVJCE,Robotics and Automation Engineering,COMEDK,2023,245114,84403,15664,21298,366479,345181,Yes
YKCE,Chemical Engineering,COMEDK,2024,175073,88058,14383,12271,289785,277514,Yes
SJBCE,Data Science,KCET,2023,62812,62400,14732,23258,163202,139944,No
PESU,Computer Science and Engineering,KCET,2023,62255,82305,13654,12726,170940,158214,No
BNMIT,Mechanical Engineering,KCET,2023,54524,94273,17390,21104,187291,166187,No
KLSGIT,Data Science,KCET,2024,81268,81205,18885,15724,197082,181358,No
RNSIT,Data Science,KCET,2023,51088,84774,18675,28200,182737,154537,Yes
JSSSTU,Chemical Engineering,KCET,2024,71218,63410,12520,18353,165501,147148,No
DSCE,Computer Science and Engineering,KCET,2023,50524,67602,16125,18748,152999,134251,No
VVCE,Civil Engineering,COMEDK,2024,210451,83427,13105,17787,324770,306983,Yes
AIT,Electrical and Electronics Engineering,KCET,2023,61156,64061,8964,11736,145917,134181,No
VSM,Biotechnology,COMEDK,2024,207179,63845,15630,18084,304738,286654,Yes
UVCE,Information Science and Engineering,COMEDK,2024,180322,62592,10479,18611,272004,253393,Yes
KLSGIT,Artificial Intelligence and Data Science,KCET,2023,69910,94858,11059,21115,196942,175827,Yes
SITM,Robotics and Automation Engineering,COMEDK,2023,165106,69810,17695,21166,273777,252611,No
SDMCET,Data Science,KCET,2024,74066,83271,18791,26987,203115,176128,Yes
BMSCE,Artificial Intelligence and Data Science,KCET,2023,53706,71084,8523,24617,157930,133313,No
BNMIT,Mechanical Engineering,KCET,2024,68034,83678,15880,25336,192928,167592,No
JSSSTU,Artificial Intelligence and Data Science,COMEDK,2024,206606,67859,14216,19494,308175,288681,Yes
HKBK,Data Science,KCET,2023,80042,89105,13438,24376,206961,182585,No
AECMandya,Information Science and Engineering,KCET,2023,83380,81773,13919,29162,208234,179072,No
SCEM,Information Science and Engineering,KCET,2024,63787,75088,9527,22859,171261,148402,Yes
MSRIT,Computer Science and Engineering,COMEDK,2024,166758,86066,16628,19834,289286,269452,Yes
SDMCET,Robotics and Automation Engineering,COMEDK,2024,191402,67470,19376,15421,293669,278248,Yes
SJBIT,Chemical Engineering,COMEDK,2024,176049,77937,11039,15343,280368,265025,No
ACU,Computer Science and Engineering,COMEDK,2023,181900,89907,11639,23947,307393,283446,No
CITGubbi,Robotics and Automation Engineering,COMEDK,2024,185222,65143,19819,21832,292016,270184,Yes
VIT,Civil Engineering,KCET,2023,80474,60312,8006,18569,167361,148792,Yes
BNMIT,Civil Engineering,KCET,2024,64565,75155,17756,21664,179140,157476,No
SDMCET,Computer Science and Engineering,KCET,2024,74589,87606,9799,14403,186397,171994,No
AITM,Information Science and Engineering,KCET,2024,56524,70779,11541,16677,155521,138844,Yes
RAIT,Electrical and Electronics Engineering,COMEDK,2024,183138,74063,17134,11938,286273,274335,Yes
BMSCE,Mechanical Engineering,COMEDK,2023,244935,74104,11590,18478,349107,330629,No
BMSIT,Mechanical Engineering,KCET,2023,59221,91127,8393,12979,171720,158741,Yes
JSSSTU,Biotechnology,KCET,2024,52140,88447,15465,29797,185849,156052,No
CMRIT,Artificial Intelligence and Data Science,KCET,2023,84776,85616,19783,15033,205208,190175,No
RVCE,Artificial Intelligence and Data Science,KCET,2023,69603,71969,18130,29878,189580,159702,Yes
RIT,Electrical and Electronics Engineering,COMEDK,2023,214744,92587,10641,28360,346332,317972,No
NIE,Artificial Intelligence and Data Science,KCET,2024,69722,86764,8755,28691,193932,165241,Yes
GIT,Electrical and Electronics Engineering,KCET,2024,54441,70020,19149,25865,169475,143610,Yes
CITGubbi,Robotics and Automation Engineering,KCET,2024,76200,62929,15575,13914,168618,154704,Yes
VVCE,Robotics and Automation Engineering,COMEDK,2024,237110,67758,9472,11939,326279,314340,No
BIT,Mechanical Engineering,COMEDK,2024,185552,84881,11412,23256,305101,281845,No
JIT,Information Science and Engineering,KCET,2024,75200,85919,14038,23097,198254,175157,Yes
PESU,Biotechnology,COMEDK,2023,231092,60229,8978,18026,318325,300299,Yes
HKBK,Artificial Intelligence and Data Science,KCET,2023,59671,71437,18628,11158,160894,149736,Yes
SCEM,Electrical and Electronics Engineering,COMEDK,2024,183913,70779,12216,10441,277349,266908,No
VIT,Data Science,KCET,2024,51369,68147,12593,17679,149788,132109,Yes
CMRIT,Electrical and Electronics Engineering,KCET,2024,83245,62595,8829,21922,176591,154669,Yes
MSRIT,Civil Engineering,COMEDK,2023,249112,80405,18292,12653,360462,347809,No
NHCE,Information Science and Engineering,COMEDK,2024,205917,90713,13779,29141,339550,310409,No
BMSIT,Aerospace Engineering,KCET,2024,80908,91736,19050,16168,207862,191694,No
VIT,Biotechnology,KCET,2023,83950,90573,17678,28017,220218,192201,No
AIT,Robotics and Automation Engineering,COMEDK,2023,208280,60283,16675,28951,314189,285238,Yes
CMRIT,Civil Engineering,COMEDK,2023,194001,83406,15230,13389,306026,292637,Yes
PRES,Mechanical Engineering,KCET,2023,75857,71148,8168,25080,180253,155173,Yes
JSSSTU,Chemical Engineering,COMEDK,2024,214593,62431,13222,22652,312898,290246,No
VSM,Robotics and Automation Engineering,COMEDK,2023,173485,71246,12732,26199,283662,257463,Yes
EastPoint,Artificial Intelligence and Data Science,KCET,2023,62877,68266,15028,18527,164698,146171,Yes
NMIT,Chemical Engineering,COMEDK,2023,191644,73174,8596,11943,285357,273414,No
CITGubbi,Aerospace Engineering,COMEDK,2024,218722,84298,14952,22624,340596,317972,No
RIT,Electronics and Communication Engineering,COMEDK,2024,192613,60810,13483,22699,289605,266906,No
SCEM,Biotechnology,COMEDK,2023,244769,74245,14974,10214,344202,333988,No
MVJCE,Civil Engineering,KCET,2024,64731,84640,8072,26403,183846,157443,Yes
RVCE,Aerospace Engineering,COMEDK,2023,207059,83310,16890,13831,321090,307259,No
NMIT,Electronics and Communication Engineering,COMEDK,2024,165478,72745,13202,22706,274131,251425,No
YKCE,Artificial Intelligence and Data Science,COMEDK,2024,170975,93294,9166,18260,291695,273435,Yes
KLEIT,Aerospace Engineering,COMEDK,2023,239226,93130,16812,17019,366187,349168,Yes
MSRIT,Aerospace Engineering,COMEDK,2024,201840,81773,11443,24024,319080,295056,Yes
AEC,Chemical Engineering,KCET,2023,67600,61164,18634,15084,162482,147398,No
PESU,Computer Science and Engineering,KCET,2024,59506,63039,19419,12903,154867,141964,No
SDMCET,Mechanical Engineering,KCET,2024,72848,75788,15194,27396,191226,163830,No
AECMandya,Mechanical Engineering,COMEDK,2024,244538,83654,12977,15084,356253,341169,No
KSIT,Computer Science and Engineering,COMEDK,2024,193278,65306,10501,17086,286171,269085,No
KSIT,Biotechnology,COMEDK,2023,239554,80150,17079,12211,348994,336783,No
PESCE,Mechanical Engineering,KCET,2024,51309,87679,16568,15546,171102,155556,No
RNSIT,Information Science and Engineering,COMEDK,2023,195188,88162,10771,13980,308101,294121,No
RIT,Mechanical Engineering,KCET,2023,56753,64832,16700,10401,148686,138285,No
RVCE,Aerospace Engineering,COMEDK,2023,169572,78734,16307,27700,292313,264613,Yes
GMIT,Biotechnology,COMEDK,2024,195981,71475,17439,10478,295373,284895,Yes
GIT,Biotechnology,KCET,2023,54528,91620,12226,27006,185380,158374,No
SDMIT,Chemical Engineering,KCET,2024,63372,77831,10559,12132,163894,151762,Yes
SJBIT,Civil Engineering,COMEDK,2023,242858,72481,9524,19241,344104,324863,Yes
SIT,Data Science,KCET,2024,52020,70576,8533,21834,152963,131129,Yes
GIT,Computer Science and Engineering,COMEDK,2024,232103,61013,18199,11727,323042,311315,Yes
AITM,Aerospace Engineering,COMEDK,2023,174099,93078,19187,21075,307439,286364,Yes
NIE,Robotics and Automation Engineering,COMEDK,2024,178873,90861,16983,13151,299868,286717,No
AEC,Chemical Engineering,KCET,2024,68884,84557,10663,18705,182809,164104,Yes
CITGubbi,Biotechnology,COMEDK,2024,217240,61429,13721,18152,310542,292390,No
SJBIT,Robotics and Automation Engineering,COMEDK,2023,209944,69344,18010,14229,311527,297298,No
RAIT,Information Science and Engineering,COMEDK,2024,248883,70228,12212,15299,346622,331323,Yes
JNNCE,Electrical and Electronics Engineering,KCET,2023,80208,70573,9028,21711,181520,159809,Yes
BITM,Data Science,COMEDK,2023,228502,66333,9763,15489,320087,304598,No
PRES,Artificial Intelligence and Data Science,KCET,2024,66707,94879,9517,23080,194183,171103,Yes
NMIT,Aerospace Engineering,COMEDK,2023,188021,69792,18827,13457,290097,276640,No
RIT,Electrical and Electronics Engineering,KCET,2023,80182,91118,12198,25970,209468,183498,Yes
REVA,Artificial Intelligence and Data Science,KCET,2024,63033,86614,8361,20782,178790,158008,No
JNNCE,Electronics and Communication Engineering,KCET,2023,75794,62764,13995,29428,181981,152553,Yes
BNMIT,Artificial Intelligence and Data Science,KCET,2023,68158,88479,16557,12762,185956,173194,No
NHCE,Robotics and Automation Engineering,KCET,2024,82199,61856,18067,11902,174024,162122,No
JSSSTU,Civil Engineering,COMEDK,2024,246462,69576,14531,18704,349273,330569,No
BNMIT,Chemical Engineering,COMEDK,2023,166345,62136,10927,12713,252121,239408,Yes
SJBIT,Aerospace Engineering,KCET,2023,68677,86643,13526,16070,184916,168846,No
NCET,Chemical Engineering,KCET,2024,69519,94926,19737,27273,211455,184182,No
NMIT,Aerospace Engineering,KCET,2024,83984,83768,14336,25009,207097,182088,No
KLSGIT,Electrical and Electronics Engineering,KCET,2023,78142,87859,18779,11344,196124,184780,No
MVJCE,Chemical Engineering,KCET,2024,65870,78898,17917,20187,182872,162685,Yes
JNNCE,Chemical Engineering,KCET,2024,58735,89747,17790,14971,181243,166272,No
BNMIT,Aerospace Engineering,KCET,2024,53090,78210,10990,17889,160179,142290,No
NHCE,Data Science,COMEDK,2023,205730,88323,19288,24336,337677,313341,Yes
AEC,Electronics and Communication Engineering,KCET,2023,82257,73339,9570,29564,194730,165166,Yes
KLSGIT,Biotechnology,COMEDK,2023,239738,91613,15894,14439,361684,347245,No
MVJCE,Civil Engineering,COMEDK,2023,247258,88226,10000,20843,366327,345484,No
VVCE,Data Science,KCET,2024,60302,60339,13337,22695,156673,133978,No
NCET,Civil Engineering,COMEDK,2023,231827,84999,12202,16100,345128,329028,No
SDMCET,Biotechnology,KCET,2023,64701,66563,14312,26658,172234,145576,No
VVIT,Aerospace Engineering,COMEDK,2023,196146,84289,16432,14268,311135,296867,Yes
NIE,Computer Science and Engineering,KCET,2023,60286,68100,19177,24493,172056,147563,Yes
PESU,Electronics and Communication Engineering,COMEDK,2024,206994,76232,12284,13514,309024,295510,No
BMSCE,Aerospace Engineering,KCET,2023,53126,85648,15602,12379,166755,154376,Yes
PESU,Electronics and Communication Engineering,KCET,2023,53971,92020,15018,10851,171860,161009,No
VIT,Civil Engineering,KCET,2023,50707,64423,9652,16459,141241,124782,No
AEC,Aerospace Engineering,KCET,2024,79664,91279,15659,16441,203043,186602,No
SJBIT,Information Science and Engineering,COMEDK,2023,216066,70094,16133,11667,313960,302293,Yes
SIT,Information Science and Engineering,KCET,2024,62206,83157,14525,14011,173899,159888,Yes
KSIT,Aerospace Engineering,COMEDK,2024,182214,74128,8948,13738,279028,265290,Yes
VemanaIT,Biotechnology,KCET,2023,82024,88431,8504,22417,201376,178959,No
DBIT,Robotics and Automation Engineering,KCET,2023,56352,93979,9747,17100,177178,160078,Yes
VIT,Chemical Engineering,KCET,2024,52178,72718,18418,19472,162786,143314,No
DSCE,Computer Science and Engineering,KCET,2024,73198,75517,19133,14985,182833,167848,No
AEC,Information Science and Engineering,KCET,2023,76868,71530,8263,26753,183414,156661,No
SDMIT,Data Science,KCET,2024,55170,86090,10358,17654,169272,151618,Yes
BMSIT,Electronics and Communication Engineering,COMEDK,2024,223463,78637,19798,17386,339284,321898,No
JNNCE,Chemical Engineering,COMEDK,2023,181614,87253,18929,22441,310237,287796,Yes
NMIT,Artificial Intelligence and Data Science,KCET,2023,76760,65257,19652,15245,176914,161669,No
AIT,Data Science,KCET,2023,57616,73611,13768,16648,161643,144995,No
SDMCET,Artificial Intelligence and Data Science,KCET,2023,75854,67353,19559,20543,183309,162766,No
VIT,Civil Engineering,COMEDK,2024,168140,73952,13949,29957,285998,256041,Yes
AEC,Electrical and Electronics Engineering,COMEDK,2024,186149,90316,14720,25661,316846,291185,No
VSM,Robotics and Automation Engineering,COMEDK,2023,179500,85318,16258,14920,295996,281076,No
RNSIT,Computer Science and Engineering,COMEDK,2024,191258,80406,14808,14448,300920,286472,No
CMRIT,Electronics and Communication Engineering,KCET,2023,76019,67586,17115,20989,181709,160720,Yes
SDMCET,Civil Engineering,COMEDK,2024,218489,67362,10262,24753,320866,296113,Yes
REVA,Mechanical Engineering,COMEDK,2024,205955,84630,9228,22567,322380,299813,No
NCET,Mechanical Engineering,KCET,2023,63499,84578,15813,14204,178094,163890,No
VIT,Robotics and Automation Engineering,KCET,2023,64766,65978,10065,12505,153314,140809,No
DrAIT,Robotics and Automation Engineering,KCET,2024,81737,73638,8101,10557,174033,163476,No
SIT,Electrical and Electronics Engineering,COMEDK,2023,197580,76895,18804,11535,304814,293279,No
CITGubbi,Information Science and Engineering,COMEDK,2023,186408,92359,12199,14106,305072,290966,No
MVJCE,Data Science,KCET,2023,77373,71046,8060,17605,174084,156479,Yes
BNMIT,Chemical Engineering,COMEDK,2023,199024,67693,9457,29971,306145,276174,Yes
KLSGIT,Electronics and Communication Engineering,COMEDK,2023,182171,76428,12907,10573,282079,271506,Yes
VSM,Civil Engineering,COMEDK,2023,179278,85522,19484,23863,308147,284284,Yes
PESCE,Biotechnology,KCET,2023,56555,69980,14964,29449,170948,141499,Yes
VVCE,Computer Science and Engineering,COMEDK,2024,200563,64438,16018,19335,300354,281019,Yes
DSATM,Data Science,KCET,2023,55108,94828,13841,28160,191937,163777,No
NHCE,Chemical Engineering,COMEDK,2023,205232,70343,17658,12358,305591,293233,No
CITGubbi,Aerospace Engineering,COMEDK,2024,177767,91641,19804,29265,318477,289212,Yes
GIT,Computer Science and Engineering,COMEDK,2024,225640,88576,13908,27151,355275,328124,No
AITM,Aerospace Engineering,COMEDK,2024,170308,64563,16713,27849,279433,251584,Yes
BIT,Artificial Intelligence and Data Science,KCET,2023,80097,64843,12897,12916,170753,157837,No
GMIT,Electronics and Communication Engineering,KCET,2024,68807,80683,14504,12698,176692,163994,No
PESCE,Electrical and Electronics Engineering,COMEDK,2023,224653,68581,17099,18524,328857,310333,Yes
AEC,Electrical and Electronics Engineering,COMEDK,2023,241207,88386,16637,16114,362344,346230,Yes
MSRUAS,Aerospace Engineering,COMEDK,2024,192200,79736,8420,13594,293950,280356,No
VemanaIT,Electrical and Electronics Engineering,KCET,2023,73927,62110,15589,12127,163753,151626,Yes
BMIT,Electrical and Electronics Engineering,COMEDK,2024,228780,82139,8444,14200,333563,319363,Yes
MSRIT,Biotechnology,COMEDK,2024,223642,92879,16520,12173,345214,333041,No
PRES,Computer Science and Engineering,KCET,2024,54057,64212,8681,19747,146697,126950,Yes
MSRIT,Electrical and Electronics Engineering,COMEDK,2023,182876,79844,10791,29030,302541,273511,Yes
DSATM,Electronics and Communication Engineering,KCET,2023,56782,69866,15755,20941,163344,142403,No
PESCE,Mechanical Engineering,KCET,2023,57845,79373,19512,29520,186250,156730,No
JSSSTU,Computer Science and Engineering,KCET,2023,81117,68876,13324,10598,173915,163317,Yes
PRES,Artificial Intelligence and Data Science,KCET,2023,52570,73183,16354,26242,168349,142107,No
JSSSTU,Artificial Intelligence and Data Science,KCET,2023,81608,69573,9513,25252,185946,160694,No
AEC,Biotechnology,KCET,2023,66060,88183,10010,29888,194141,164253,Yes
RIT,Aerospace Engineering,COMEDK,2024,244281,65364,16069,15044,340758,325714,No
JNNCE,Computer Science and Engineering,COMEDK,2023,203300,77421,19098,29486,329305,299819,Yes
SJBIT,Mechanical Engineering,COMEDK,2023,182203,90256,16381,23306,312146,288840,Yes
RVUNIV,Mechanical Engineering,COMEDK,2024,192876,71051,14445,10943,289315,278372,Yes
CITGubbi,Information Science and Engineering,KCET,2024,63800,80372,17449,29711,191332,161621,Yes
DSATM,Aerospace Engineering,COMEDK,2023,238151,67158,9094,23911,338314,314403,No
MSRUAS,Data Science,KCET,2023,69948,92570,11570,21062,195150,174088,No
HKBK,Mechanical Engineering,KCET,2024,56037,93653,10828,27553,188071,160518,No
RAIT,Chemical Engineering,KCET,2024,50125,68212,17453,20196,155986,135790,No
DSCE,Chemical Engineering,COMEDK,2024,175446,80773,8721,18485,283425,264940,Yes
NHCE,Data Science,COMEDK,2024,215342,88885,12777,21818,338822,317004,Yes
KLSGIT,Information Science and Engineering,KCET,2024,53302,65461,12416,10465,141644,131179,Yes
SIT,Electronics and Communication Engineering,COMEDK,2024,193503,87928,14451,12320,308202,295882,No
RAIT,Civil Engineering,COMEDK,2023,209416,78098,15349,27125,329988,302863,Yes
PESCE,Data Science,COMEDK,2023,204980,93080,8334,27647,334041,306394,No
PRES,Electronics and Communication Engineering,KCET,2024,63322,79776,9978,28340,181416,153076,No
SDMIT,Computer Science and Engineering,COMEDK,2024,238512,94480,15822,10019,358833,348814,No
DBIT,Robotics and Automation Engineering,KCET,2023,68083,80835,15475,24470,188863,164393,No
AITM,Artificial Intelligence and Data Science,COMEDK,2023,197149,65283,15233,24503,302168,277665,No
JIT,Mechanical Engineering,COMEDK,2023,195561,73182,19687,11993,300423,288430,No
BMIT,Biotechnology,COMEDK,2024,162866,70783,9936,13332,256917,243585,No
JSSSTU,Computer Science and Engineering,KCET,2023,76618,66823,8727,24381,176549,152168,No
DSATM,Electrical and Electronics Engineering,COMEDK,2024,181728,60336,9959,13904,265927,252023,No
NIE,Data Science,KCET,2024,57074,87245,13792,24205,182316,158111,No
MSRUAS,Electronics and Communication Engineering,KCET,2024,65608,80331,15348,28335,189622,161287,No
VIT,Civil Engineering,KCET,2023,58902,70600,8597,23582,161681,138099,No
PRES,Aerospace Engineering,KCET,2023,55543,81202,8404,20868,166017,145149,Yes
JNNCE,Biotechnology,COMEDK,2023,241934,67627,9125,23984,342670,318686,No
DSCE,Electrical and Electronics Engineering,COMEDK,2023,245949,77694,19614,14917,358174,343257,No
NIE,Electronics and Communication Engineering,COMEDK,2024,165311,60424,17184,26475,269394,242919,No
NIE,Electrical and Electronics Engineering,KCET,2024,68120,66818,18278,25600,178816,153216,No
JIT,Information Science and Engineering,COMEDK,2024,224954,60622,10511,10323,306410,296087,No
ACU,Mechanical Engineering,KCET,2023,78073,72396,17790,13100,181359,168259,No
AEC,Computer Science and Engineering,KCET,2023,82580,64230,16870,15831,179511,163680,No
AEC,Chemical Engineering,COMEDK,2024,210916,64291,11412,13122,299741,286619,Yes
NCET,Biotechnology,COMEDK,2023,218060,80512,13960,11409,323941,312532,Yes
BMSCE,Computer Science and Engineering,KCET,2023,66974,63537,11016,25718,167245,141527,Yes
UVCE,Civil Engineering,KCET,2024,51858,71062,8569,13617,145106,131489,Yes
VVCE,Mechanical Engineering,COMEDK,2024,209663,86017,14505,17246,327431,310185,Yes
KLEIT,Mechanical Engineering,COMEDK,2024,194219,92490,13598,23694,324001,300307,Yes
KLSGIT,Electrical and Electronics Engineering,KCET,2024,79546,74504,9938,12013,176001,163988,No
HKBK,Electrical and Electronics Engineering,COMEDK,2024,181275,70513,12225,18198,282211,264013,No
AITM,Computer Science and Engineering,COMEDK,2023,246457,67386,19027,18859,351729,332870,Yes
VVIT,Robotics and Automation Engineering,COMEDK,2023,243044,70660,15250,13431,342385,328954,No
DrAIT,Electrical and Electronics Engineering,KCET,2024,67345,87117,9781,17170,181413,164243,Yes
VVIT,Biotechnology,KCET,2023,58975,63042,18104,28532,168653,140121,Yes
SJBIT,Data Science,KCET,2024,65931,94483,14655,21690,196759,175069,Yes
KLEIT,Aerospace Engineering,KCET,2023,69685,93465,13383,28645,205178,176533,Yes
CMRIT,Artificial Intelligence and Data Science,KCET,2023,50005,85562,14163,20093,169823,149730,No
BMIT,Electrical and Electronics Engineering,KCET,2023,55859,85108,18037,24074,183078,159004,No
HKBK,Robotics and Automation Engineering,COMEDK,2023,197794,74412,12646,18277,303129,284852,Yes
SIT,Information Science and Engineering,COMEDK,2024,244744,64269,10275,29914,349202,319288,Yes
KSIT,Data Science,COMEDK,2024,210083,93192,14884,15611,333770,318159,Yes
AEC,Biotechnology,COMEDK,2023,244841,70388,18152,23400,356781,333381,No
RAIT,Civil Engineering,KCET,2024,67402,63768,19789,29369,180328,150959,Yes
RVCE,Robotics and Automation Engineering,COMEDK,2024,187040,70622,9168,16160,282990,266830,No
AEC,Computer Science and Engineering,COMEDK,2024,169954,66510,19938,15514,271916,256402,No
VemanaIT,Information Science and Engineering,COMEDK,2024,234226,92230,18786,27312,372554,345242,Yes
MSRIT,Artificial Intelligence and Data Science,KCET,2024,57852,89044,11266,17749,175911,158162,Yes
VSM,Chemical Engineering,COMEDK,2024,168830,86215,14871,25882,295798,269916,Yes
RAIT,Civil Engineering,COMEDK,2024,184528,78837,8052,29702,301119,271417,No
RNSIT,Artificial Intelligence and Data Science,KCET,2023,60311,77018,17102,17710,172141,154431,Yes
BMIT,Information Science and Engineering,KCET,2023,81438,64710,18346,29949,194443,164494,Yes
CITGubbi,Civil Engineering,KCET,2023,51699,74158,15528,25604,166989,141385,Yes
YKCE,Information Science and Engineering,COMEDK,2023,172237,65131,15689,25150,278207,253057,Yes
PRES,Robotics and Automation Engineering,KCET,2024,63259,82884,19018,12599,177760,165161,Yes
AECMandya,Civil Engineering,KCET,2023,68270,86219,9898,17114,181501,164387,No
DSATM,Biotechnology,COMEDK,2024,220059,80633,13518,12091,326301,314210,No
SDMCET,Artificial Intelligence and Data Science,COMEDK,2024,233786,60430,11680,11394,317290,305896,No
MSRIT,Biotechnology,COMEDK,2024,191176,78466,14596,29744,313982,284238,No
SJBCE,Civil Engineering,KCET,2024,59244,83802,10888,25950,179884,153934,No
EastPoint,Data Science,COMEDK,2023,229922,60857,17958,12813,321550,308737,No
RNSIT,Electronics and Communication Engineering,COMEDK,2024,172632,90286,15143,25761,303822,278061,No
VVIT,Electrical and Electronics Engineering,KCET,2024,69372,81376,18303,10847,179898,169051,No
RVUNIV,Artificial Intelligence and Data Science,KCET,2023,80356,61202,14638,21533,177729,156196,No
KSIT,Civil Engineering,COMEDK,2024,173672,66983,17944,14911,273510,258599,Yes
RVCE,Electronics and Communication Engineering,KCET,2024,54182,65409,19796,13392,152779,139387,No
PESCE,Biotechnology,COMEDK,2024,188162,76041,18865,21249,304317,283068,No
RNSIT,Computer Science and Engineering,KCET,2023,54787,60838,19009,25087,159721,134634,Yes
PRES,Data Science,COMEDK,2023,172157,74548,12072,15435,274212,258777,No
JIT,Chemical Engineering,COMEDK,2024,168029,94775,10695,10012,283511,273499,Yes
UVCE,Aerospace Engineering,KCET,2023,79926,87216,15780,16253,199175,182922,Yes
JNNCE,Data Science,KCET,2024,50219,78402,12606,23794,165021,141227,Yes
JIT,Data Science,KCET,2024,61435,64270,17057,14614,157376,142762,No
DSATM,Data Science,KCET,2024,54775,61873,19110,21293,157051,135758,Yes
SIT,Computer Science and Engineering,COMEDK,2024,177853,88257,19337,10129,295576,285447,No
GIT,Electrical and Electronics Engineering,KCET,2023,82954,67155,19680,14532,184321,169789,No
VemanaIT,Robotics and Automation Engineering,COMEDK,2024,213966,75533,16231,28035,333765,305730,Yes
BITM,Mechanical Engineering,KCET,2024,82534,78083,12248,24802,197667,172865,No
GMIT,Civil Engineering,COMEDK,2023,235418,83615,8740,12434,340207,327773,Yes
RAIT,Computer Science and Engineering,COMEDK,2024,233536,74322,12959,14287,335104,320817,Yes
KLEIT,Chemical Engineering,COMEDK,2024,176504,72925,19880,26411,295720,269309,No
NHCE,Chemical Engineering,KCET,2023,74883,75782,13142,28159,191966,163807,No
KSIT,Chemical Engineering,COMEDK,2024,203495,84719,13903,18613,320730,302117,No
EastPoint,Aerospace Engineering,COMEDK,2024,185127,72371,15659,29622,302779,273157,No
AITM,Electronics and Communication Engineering,COMEDK,2024,177826,74167,11626,18966,282585,263619,No
SDMCET,Chemical Engineering,KCET,2023,77730,77852,18408,15497,189487,173990,Yes
AECMandya,Electrical and Electronics Engineering,COMEDK,2024,205293,70794,15555,15692,307334,291642,No
MSRUAS,Robotics and Automation Engineering,COMEDK,2024,204579,68916,17192,28378,319065,290687,Yes
UVCE,Mechanical Engineering,KCET,2024,55447,82589,18640,20850,177526,156676,Yes
MSRIT,Artificial Intelligence and Data Science,COMEDK,2024,211188,72299,12032,28714,324233,295519,Yes
VVIT,Aerospace Engineering,COMEDK,2024,195287,76802,17495,18136,307720,289584,Yes
ACU,Electrical and Electronics Engineering,COMEDK,2023,211453,71110,13109,23583,319255,295672,No
CMRIT,Electrical and Electronics Engineering,KCET,2023,83059,89980,11921,28263,213223,184960,No
VVCE,Biotechnology,COMEDK,2024,202070,91305,19314,15865,328554,312689,No
NHCE,Electronics and Communication Engineering,COMEDK,2023,220812,61317,9197,12334,303660,291326,No
AITM,Mechanical Engineering,KCET,2024,52219,82319,8585,20004,163127,143123,No
MSRIT,Data Science,KCET,2024,64438,92739,13219,20556,190952,170396,No
DSCE,Computer Science and Engineering,KCET,2024,58071,61544,9684,20914,150213,129299,Yes
AEC,Biotechnology,KCET,2024,77101,85658,15636,14668,193063,178395,No
PESCE,Computer Science and Engineering,KCET,2023,63915,92783,16794,10015,183507,173492,Yes
JIT,Electronics and Communication Engineering,COMEDK,2024,170350,68538,10946,23174,273008,249834,Yes
MSRIT,Electronics and Communication Engineering,KCET,2024,60939,87532,8853,25849,183173,157324,No
RIT,Civil Engineering,COMEDK,2024,189645,78188,19324,12208,299365,287157,No
AECMandya,Data Science,COMEDK,2024,221250,66049,8015,15002,310316,295314,No
NIE,Information Science and Engineering,COMEDK,2024,244735,62963,11032,28965,347695,318730,No
SJBIT,Electrical and Electronics Engineering,KCET,2023,79738,90819,8554,19127,198238,179111,Yes
PESCE,Computer Science and Engineering,KCET,2023,60087,83399,9385,20934,173805,152871,No
VSM,Data Science,COMEDK,2023,237453,77578,13937,23680,352648,328968,Yes
CMRIT,Computer Science and Engineering,COMEDK,2024,203289,86677,11228,14506,315700,301194,Yes
KLSGIT,Civil Engineering,KCET,2023,55021,78490,8243,21135,162889,141754,No
DrAIT,Aerospace Engineering,COMEDK,2023,211296,93468,16749,27699,349212,321513,Yes
ACU,Civil Engineering,KCET,2024,81254,75151,9285,26591,192281,165690,No
VSM,Robotics and Automation Engineering,COMEDK,2024,242958,82410,10094,21644,357106,335462,No
SCEM,Chemical Engineering,COMEDK,2024,218274,72142,8868,18588,317872,299284,No
HKBK,Electronics and Communication Engineering,KCET,2023,52984,60943,13412,11125,138464,127339,No
NIE,Civil Engineering,KCET,2024,52690,82397,8444,14259,157790,143531,Yes
BMSCE,Electrical and Electronics Engineering,COMEDK,2024,173679,94428,13822,25170,307099,281929,No
NHCE,Chemical Engineering,COMEDK,2024,226865,66187,17216,14391,324659,310268,No
AIT,Biotechnology,COMEDK,2023,219704,83371,11831,28098,343004,314906,Yes
REVA,Mechanical Engineering,COMEDK,2023,237080,82260,17830,14518,351688,337170,Yes
SDMIT,Mechanical Engineering,COMEDK,2023,167505,88952,13003,16502,285962,269460,No
JSSSTU,Electronics and Communication Engineering,KCET,2023,51543,76353,14665,11053,153614,142561,Yes
BMSCE,Biotechnology,COMEDK,2024,231554,83613,12333,25025,352525,327500,No
UVCE,Data Science,KCET,2024,52626,93650,13663,28651,188590,159939,No
HKBK,Mechanical Engineering,COMEDK,2023,224487,77272,15820,18672,336251,317579,Yes
DBIT,Electronics and Communication Engineering,COMEDK,2024,219639,72655,10284,19854,322432,302578,No
PESU,Computer Science and Engineering,KCET,2023,53150,88509,19511,10222,171392,161170,Yes
DBIT,Electronics and Communication Engineering,COMEDK,2024,223299,81851,10102,18838,334090,315252,Yes
RVUNIV,Information Science and Engineering,KCET,2024,75534,63294,11845,11395,162068,150673,No
DrAIT,Electrical and Electronics Engineering,COMEDK,2023,211938,74636,17681,29141,333396,304255,Yes
GMIT,Chemical Engineering,COMEDK,2024,188485,72101,18882,19876,299344,279468,No
NIE,Data Science,KCET,2023,82963,83930,11926,17342,196161,178819,Yes
SJBCE,Robotics and Automation Engineering,KCET,2024,51776,64140,15053,25009,155978,130969,No
PESU,Aerospace Engineering,COMEDK,2023,168964,89506,12341,27403,298214,270811,No
KSIT,Artificial Intelligence and Data Science,COMEDK,2023,209512,76633,19607,11286,317038,305752,No
VVCE,Information Science and Engineering,COMEDK,2023,178605,67318,13217,17426,276566,259140,No
AEC,Chemical Engineering,COMEDK,2023,204782,82829,13520,17215,318346,301131,No
MSRIT,Robotics and Automation Engineering,COMEDK,2024,175534,61896,15254,21296,273980,252684,Yes
SDMCET,Artificial Intelligence and Data Science,KCET,2023,69833,62294,9167,21783,163077,141294,Yes
SJBIT,Civil Engineering,COMEDK,2023,164785,91426,18226,26802,301239,274437,No
KLEIT,Mechanical Engineering,COMEDK,2024,213647,69294,18243,15311,316495,301184,No
BIT,Electronics and Communication Engineering,KCET,2024,56095,60356,13702,27607,157760,130153,Yes
AIT,Robotics and Automation Engineering,COMEDK,2024,175007,92962,11314,17033,296316,279283,Yes
BMSIT,Aerospace Engineering,COMEDK,2024,166799,61576,10337,14224,252936,238712,Yes
PESCE,Computer Science and Engineering,COMEDK,2023,191728,83350,16386,20653,312117,291464,Yes
RNSIT,Mechanical Engineering,COMEDK,2024,163520,62085,14972,19221,259798,240577,Yes
JSSSTU,Aerospace Engineering,COMEDK,2023,212250,66106,16192,25749,320297,294548,Yes
PESCE,Biotechnology,KCET,2024,82815,89561,14705,20583,207664,187081,No
BNMIT,Aerospace Engineering,COMEDK,2024,216789,90073,17164,27120,351146,324026,Yes
EastPoint,Computer Science and Engineering,COMEDK,2024,220094,82918,16212,13382,332606,319224,Yes
JSSSTU,Data Science,KCET,2024,61721,75235,9252,23194,169402,146208,Yes
GMIT,Chemical Engineering,COMEDK,2024,202020,83433,14436,27884,327773,299889,Yes
KLSGIT,Chemical Engineering,KCET,2024,79989,67575,17642,17312,182518,165206,No
RIT,Information Science and Engineering,KCET,2024,71056,77947,17960,19556,186519,166963,No
PESCE,Electronics and Communication Engineering,KCET,2024,53033,92010,17805,13109,175957,162848,No
DBIT,Civil Engineering,KCET,2024,65577,61660,14472,25337,167046,141709,No
UVCE,Electrical and Electronics Engineering,KCET,2023,71569,74771,13829,19275,179444,160169,Yes
AECMandya,Information Science and Engineering,KCET,2023,52475,62850,19154,23988,158467,134479,Yes
SIT,Robotics and Automation Engineering,COMEDK,2024,206777,77113,11659,13668,309217,295549,No
RNSIT,Data Science,KCET,2024,71247,63931,10717,15141,161036,145895,Yes
RAIT,Artificial Intelligence and Data Science,COMEDK,2024,195708,67846,16289,21871,301714,279843,Yes
AECMandya,Artificial Intelligence and Data Science,COMEDK,2024,178837,76161,14859,20488,290345,269857,No
VVIT,Data Science,COMEDK,2024,204842,67698,14215,24194,310949,286755,Yes
SDMIT,Data Science,COMEDK,2023,237262,64817,19963,22356,344398,322042,Yes
PESU,Artificial Intelligence and Data Science,COMEDK,2024,237645,88092,14713,25773,366223,340450,No
RVUNIV,Robotics and Automation Engineering,KCET,2024,57394,84015,18653,10098,170160,160062,Yes
PRES,Information Science and Engineering,COMEDK,2024,200919,79601,14782,20878,316180,295302,No
BMIT,Electronics and Communication Engineering,KCET,2024,68442,64446,8064,25715,166667,140952,No
JNNCE,Aerospace Engineering,COMEDK,2023,247958,60354,11446,16805,336563,319758,No
JIT,Aerospace Engineering,KCET,2024,50783,89521,9317,28242,177863,149621,Yes
UVCE,Information Science and Engineering,KCET,2023,77045,81197,9374,22972,190588,167616,Yes
UVCE,Artificial Intelligence and Data Science,KCET,2024,77736,64447,8600,24707,175490,150783,Yes
MSRUAS,Data Science,COMEDK,2024,243606,75056,8026,10806,337494,326688,Yes
CMRIT,Artificial Intelligence and Data Science,COMEDK,2024,176143,93101,16117,23016,308377,285361,Yes
BMIT,Electrical and Electronics Engineering,COMEDK,2023,174278,67855,10479,22613,275225,252612,Yes
NHCE,Data Science,KCET,2024,55610,73843,14528,20542,164523,143981,No
VVIT,Computer Science and Engineering,COMEDK,2023,211206,80142,13259,26566,331173,304607,No
NCET,Mechanical Engineering,COMEDK,2024,212329,65405,11243,28328,317305,288977,Yes
REVA,Robotics and Automation Engineering,KCET,2024,52405,77800,12493,27964,170662,142698,No
PRES,Data Science,KCET,2023,76836,80099,10886,19960,187781,167821,No
BMSCE,Mechanical Engineering,KCET,2024,68126,74029,15652,27780,185587,157807,Yes
BITM,Civil Engineering,KCET,2023,57406,90930,17486,16771,182593,165822,Yes
MVJCE,Data Science,COMEDK,2023,225945,66771,16886,11813,321415,309602,No
YKCE,Biotechnology,KCET,2024,57588,82537,13766,28236,182127,153891,No
BITM,Information Science and Engineering,KCET,2023,76559,88433,9255,16661,190908,174247,Yes
JSSSTU,Civil Engineering,COMEDK,2023,217447,94061,8308,28833,348649,319816,Yes
SCEM,Computer Science and Engineering,COMEDK,2024,160935,63145,18765,29497,272342,242845,No
MSRIT,Artificial Intelligence and Data Science,COMEDK,2024,184036,67546,10822,18281,280685,262404,No
BMSCE,Computer Science and Engineering,KCET,2023,71878,60712,19711,16000,168301,152301,Yes
AITM,Information Science and Engineering,COMEDK,2024,248952,91056,16222,21970,378200,356230,No
GMIT,Computer Science and Engineering,COMEDK,2023,208371,81909,12974,13915,317169,303254,Yes
SJBIT,Civil Engineering,KCET,2023,63473,79678,16544,29522,189217,159695,Yes
BNMIT,Artificial Intelligence and Data Science,KCET,2024,59468,84247,15162,27274,186151,158877,Yes
DrAIT,Artificial Intelligence and Data Science,COMEDK,2024,160618,87819,19316,18184,285937,267753,Yes
DrAIT,Civil Engineering,COMEDK,2023,189962,63303,12050,14092,279407,265315,Yes
EastPoint,Civil Engineering,COMEDK,2023,183633,89706,17487,29825,320651,290826,No
BMSIT,Aerospace Engineering,COMEDK,2023,223658,78321,19676,13983,335638,321655,Yes
DrAIT,Chemical Engineering,COMEDK,2024,200289,67593,10804,13177,291863,278686,Yes
SJBIT,Artificial Intelligence and Data Science,COMEDK,2024,217909,73260,19253,14380,324802,310422,Yes
GMIT,Aerospace Engineering,KCET,2024,79979,85018,16232,15062,196291,181229,Yes
SDMIT,Chemical Engineering,COMEDK,2023,209462,88245,17228,23381,338316,314935,Yes
SJBIT,Robotics and Automation Engineering,KCET,2024,56271,72669,13338,13160,155438,142278,No
DBIT,Chemical Engineering,KCET,2024,58433,63093,15604,10676,147806,137130,Yes
CMRIT,Electronics and Communication Engineering,KCET,2024,65854,92831,12099,14087,184871,170784,No
PESU,Electronics and Communication Engineering,KCET,2023,51557,77425,16331,13085,158398,145313,No
CMRIT,Civil Engineering,COMEDK,2024,175153,78878,13275,27233,294539,267306,No
SJBCE,Electronics and Communication Engineering,COMEDK,2023,188815,88760,16975,18445,312995,294550,Yes
DBIT,Chemical Engineering,COMEDK,2023,192473,78397,11171,11007,293048,282041,No
SITM,Data Science,COMEDK,2023,219456,93613,9902,10651,333622,322971,No
AECMandya,Chemical Engineering,KCET,2023,78165,91493,10831,13871,194360,180489,Yes
SITM,Information Science and Engineering,KCET,2024,77751,90555,8108,14350,190764,176414,Yes
PESCE,Aerospace Engineering,COMEDK,2024,165960,60341,18429,24803,269533,244730,Yes
KSIT,Computer Science and Engineering,KCET,2023,77056,78235,17023,12178,184492,172314,Yes
SITM,Robotics and Automation Engineering,KCET,2023,78277,90484,15917,22617,207295,184678,No
NCET,Robotics and Automation Engineering,KCET,2024,64583,91447,8168,20837,185035,164198,Yes
SJBIT,Computer Science and Engineering,KCET,2023,79029,88210,13480,19836,200555,180719,Yes
DSATM,Robotics and Automation Engineering,COMEDK,2023,209713,70329,18265,17480,315787,298307,Yes
NCET,Data Science,COMEDK,2023,177230,74930,15950,19618,287728,268110,No
NMIT,Computer Science and Engineering,COMEDK,2024,218324,61221,17428,20308,317281,296973,No
BNMIT,Aerospace Engineering,KCET,2023,53719,85733,11495,10374,161321,150947,Yes
SDMIT,Electrical and Electronics Engineering,KCET,2024,71309,84537,8894,13777,178517,164740,Yes
SJBCE,Aerospace Engineering,KCET,2024,76917,78802,10317,16774,182810,166036,Yes
MSRIT,Data Science,COMEDK,2023,241914,70019,16518,27761,356212,328451,No
KSIT,Computer Science and Engineering,KCET,2024,55472,94061,15370,13945,178848,164903,No
GMIT,Computer Science and Engineering,COMEDK,2024,209614,93025,9599,20527,332765,312238,Yes
HKBK,Civil Engineering,KCET,2023,58246,76910,8599,14253,158008,143755,No
GIT,Electrical and Electronics Engineering,KCET,2024,55097,68307,11303,28143,162850,134707,No
HKBK,Biotechnology,KCET,2024,53115,70436,12507,18398,154456,136058,Yes
JSSSTU,Information Science and Engineering,KCET,2024,55288,82696,16485,11304,165773,154469,No
REVA,Computer Science and Engineering,COMEDK,2023,195050,77498,13256,19726,305530,285804,No
DSCE,Civil Engineering,KCET,2023,65402,84391,14692,17557,182042,164485,No
VVIT,Aerospace Engineering,KCET,2024,59862,73919,15847,28884,178512,149628,Yes
SDMIT,Electrical and Electronics Engineering,COMEDK,2024,228194,81461,13140,14766,337561,322795,Yes
SJBIT,Information Science and Engineering,COMEDK,2023,241116,82345,10254,20638,354353,333715,Yes
RVUNIV,Data Science,COMEDK,2023,247629,84984,16352,14646,363611,348965,Yes
GMIT,Robotics and Automation Engineering,COMEDK,2024,247769,85411,18174,16555,367909,351354,No
GIT,Chemical Engineering,COMEDK,2024,199664,66628,8320,29070,303682,274612,No
VSM,Artificial Intelligence and Data Science,KCET,2023,80987,74499,16623,15835,187944,172109,No
PRES,Electronics and Communication Engineering,COMEDK,2024,199875,62898,15604,22238,300615,278377,No
VVIT,Mechanical Engineering,COMEDK,2024,247511,64018,17597,28428,357554,329126,Yes
AIT,Computer Science and Engineering,KCET,2024,73751,70391,17548,10505,172195,161690,No
NCET,Chemical Engineering,COMEDK,2023,241887,65552,11180,18107,336726,318619,Yes
RVCE,Artificial Intelligence and Data Science,KCET,2023,72011,88439,13374,26542,200366,173824,Yes
YKCE,Biotechnology,COMEDK,2023,228132,62426,12890,26295,329743,303448,No
JSSSTU,Data Science,KCET,2024,76572,78524,14826,19454,189376,169922,Yes
SCEM,Robotics and Automation Engineering,KCET,2024,80185,73673,11578,18634,184070,165436,Yes
UVCE,Mechanical Engineering,KCET,2023,53959,94276,18308,14597,181140,166543,Yes
CITGubbi,Civil Engineering,COMEDK,2024,229609,67721,18392,18335,334057,315722,No
DrAIT,Electrical and Electronics Engineering,KCET,2023,70435,78856,17295,12406,178992,166586,No
BMSCE,Data Science,COMEDK,2024,238809,91307,14491,16491,361098,344607,No
MVJCE,Computer Science and Engineering,KCET,2024,76224,67325,11768,20005,175322,155317,No
DSCE,Electronics and Communication Engineering,KCET,2023,75963,92408,17967,18830,205168,186338,No
SCEM,Aerospace Engineering,KCET,2024,71158,68535,17068,22600,179361,156761,No
NCET,Civil Engineering,KCET,2024,84954,65454,14846,20685,185939,165254,No
RVCE,Artificial Intelligence and Data Science,COMEDK,2024,176524,71423,11503,14152,273602,259450,Yes
CITGubbi,Artificial Intelligence and Data Science,KCET,2023,56556,65250,14477,27956,164239,136283,No
SCEM,Chemical Engineering,COMEDK,2023,222117,61774,16015,18550,318456,299906,Yes
SCEM,Information Science and Engineering,KCET,2023,55989,94159,11348,28898,190394,161496,No
BIT,Computer Science and Engineering,COMEDK,2023,226720,64301,18455,19905,329381,309476,No
JSSSTU,Civil Engineering,KCET,2024,70472,74105,8454,26250,179281,153031,Yes
DBIT,Civil Engineering,KCET,2023,51326,79707,14324,23939,169296,145357,No
CMRIT,Electronics and Communication Engineering,KCET,2024,71352,62931,17573,27360,179216,151856,Yes
DrAIT,Biotechnology,COMEDK,2024,161207,70246,18980,15735,266168,250433,Yes
JSSSTU,Computer Science and Engineering,COMEDK,2024,192960,89383,16019,27611,325973,298362,Yes
NHCE,Chemical Engineering,KCET,2023,72783,74341,14760,15075,176959,161884,No
CMRIT,Data Science,COMEDK,2024,188687,88786,17662,23407,318542,295135,Yes
DSCE,Information Science and Engineering,KCET,2023,78498,72298,11924,17399,180119,162720,Yes
PESCE,Chemical Engineering,COMEDK,2024,235596,71448,17118,21845,346007,324162,No
NIE,Information Science and Engineering,KCET,2024,82792,62087,13604,17963,176446,158483,No
YKCE,Computer Science and Engineering,KCET,2024,56807,84268,17044,13374,171493,158119,No
REVA,Data Science,COMEDK,2024,201388,60201,10230,28984,300803,271819,Yes
REVA,Mechanical Engineering,KCET,2023,69829,64421,17378,10846,162474,151628,No
BMSCE,Electronics and Communication Engineering,COMEDK,2024,241833,85520,15320,17494,360167,342673,No
BNMIT,Mechanical Engineering,KCET,2023,81753,94561,17126,26417,219857,193440,No
VVIT,Computer Science and Engineering,COMEDK,2024,202868,74272,16588,24921,318649,293728,No
NIE,Computer Science and Engineering,KCET,2023,82687,92620,12104,18384,205795,187411,No
BMSIT,Data Science,COMEDK,2023,188902,84076,13657,11934,298569,286635,No
KLEIT,Data Science,COMEDK,2024,234735,65062,9161,19097,328055,308958,No
KLEIT,Mechanical Engineering,KCET,2024,81673,61329,14443,13343,170788,157445,No
VVCE,Robotics and Automation Engineering,COMEDK,2023,211660,94336,19093,25583,350672,325089,Yes
DrAIT,Chemical Engineering,KCET,2024,57666,90151,12169,11538,171524,159986,No
KSIT,Aerospace Engineering,KCET,2023,63453,71498,19918,10613,165482,154869,Yes
GMIT,Computer Science and Engineering,KCET,2023,66622,72192,13218,12574,164606,152032,No
KSIT,Information Science and Engineering,COMEDK,2024,191956,84750,11375,26333,314414,288081,No
SJBIT,Artificial Intelligence and Data Science,COMEDK,2023,230633,68253,15102,18885,332873,313988,No
DBIT,Biotechnology,COMEDK,2023,207183,64452,18666,11191,301492,290301,Yes
REVA,Civil Engineering,COMEDK,2023,209724,72421,15920,26606,324671,298065,No
AITM,Electronics and Communication Engineering,KCET,2024,73208,88812,18292,25887,206199,180312,Yes
UVCE,Information Science and Engineering,KCET,2024,57355,71450,12052,20112,160969,140857,No
BMSIT,Chemical Engineering,KCET,2024,76489,73276,18403,24581,192749,168168,Yes
NHCE,Mechanical Engineering,KCET,2024,62921,73827,17074,27635,181457,153822,Yes
DSATM,Electrical and Electronics Engineering,KCET,2023,68980,80601,15741,26858,192180,165322,No
RVCE,Chemical Engineering,COMEDK,2024,215006,66845,15189,18922,315962,297040,No
EastPoint,Information Science and Engineering,COMEDK,2023,182627,69672,18965,11619,282883,271264,Yes
RVUNIV,Civil Engineering,COMEDK,2024,198102,79971,10527,19664,308264,288600,Yes
SCEM,Electrical and Electronics Engineering,KCET,2023,59918,77055,16654,21289,174916,153627,No
NCET,Chemical Engineering,COMEDK,2024,214342,77661,13827,17762,323592,305830,Yes
BNMIT,Mechanical Engineering,COMEDK,2024,229158,64535,10514,18976,323183,304207,No
SDMIT,Electrical and Electronics Engineering,COMEDK,2024,224056,66507,8365,18421,317349,298928,Yes
GMIT,Mechanical Engineering,COMEDK,2023,163050,76500,15499,14178,269227,255049,Yes
SJBIT,Biotechnology,KCET,2023,68095,92359,10674,24028,195156,171128,Yes
AECMandya,Biotechnology,COMEDK,2023,172266,87274,19848,11298,290686,279388,Yes
EastPoint,Electronics and Communication Engineering,COMEDK,2023,215620,66441,14192,29135,325388,296253,Yes
NCET,Robotics and Automation Engineering,KCET,2024,83331,63978,14447,22814,184570,161756,No
CITGubbi,Civil Engineering,KCET,2023,56139,92552,12408,15917,177016,161099,No
JSSSTU,Chemical Engineering,KCET,2024,66615,65906,11673,18284,162478,144194,Yes
SIT,Information Science and Engineering,COMEDK,2023,187931,87379,19517,28142,322969,294827,Yes
JIT,Electrical and Electronics Engineering,KCET,2024,67606,74898,15239,11228,168971,157743,No
DrAIT,Computer Science and Engineering,KCET,2023,68293,85855,9766,17911,181825,163914,No
RIT,Electronics and Communication Engineering,COMEDK,2024,200206,80098,15994,13411,309709,296298,No
PESU,Electronics and Communication Engineering,COMEDK,2024,192481,77322,12755,19880,302438,282558,No
RAIT,Electronics and Communication Engineering,KCET,2023,50544,69941,16105,28500,165090,136590,No
AITM,Mechanical Engineering,KCET,2024,58115,91243,11142,28752,189252,160500,Yes
MSRIT,Information Science and Engineering,KCET,2023,75982,68902,17528,20113,182525,162412,No
JSSSTU,Robotics and Automation Engineering,COMEDK,2023,206998,66108,8739,20543,302388,281845,No
DBIT,Electrical and Electronics Engineering,COMEDK,2023,227012,80313,10483,22033,339841,317808,Yes
SJBIT,Chemical Engineering,KCET,2024,57669,68321,18851,24411,169252,144841,Yes
BMIT,Biotechnology,KCET,2024,74652,80807,18563,11710,185732,174022,Yes
SIT,Civil Engineering,KCET,2023,67626,92440,19633,11551,191250,179699,No
AECMandya,Electrical and Electronics Engineering,KCET,2024,56088,69606,8943,28430,163067,134637,No
JIT,Mechanical Engineering,COMEDK,2023,215787,60556,17925,17742,312010,294268,No
VSM,Mechanical Engineering,KCET,2023,54030,94080,9870,15488,173468,157980,Yes
YKCE,Robotics and Automation Engineering,KCET,2023,81958,84294,9979,20581,196812,176231,No
PESU,Data Science,KCET,2024,56560,94100,14474,14339,179473,165134,No
VSM,Civil Engineering,KCET,2024,74655,87209,14183,26299,202346,176047,Yes
GIT,Computer Science and Engineering,COMEDK,2023,163616,82410,9923,21130,277079,255949,Yes
SJBCE,Electronics and Communication Engineering,KCET,2024,70434,77254,16596,23289,187573,164284,Yes
EastPoint,Mechanical Engineering,KCET,2024,74827,91365,16266,11289,193747,182458,No
DrAIT,Electronics and Communication Engineering,KCET,2023,57854,80751,19424,28504,186533,158029,Yes
UVCE,Artificial Intelligence and Data Science,COMEDK,2023,234956,84823,9235,15001,344015,329014,No
SDMIT,Artificial Intelligence and Data Science,KCET,2024,83632,92425,8543,24683,209283,184600,No
JSSSTU,Aerospace Engineering,KCET,2023,77582,79478,9259,26960,193279,166319,Yes
PESCE,Artificial Intelligence and Data Science,COMEDK,2023,163337,75019,11522,24063,273941,249878,No
BITM,Robotics and Automation Engineering,COMEDK,2023,206194,90203,9187,29109,334693,305584,Yes
DBIT,Civil Engineering,KCET,2023,84927,87626,10645,16950,200148,183198,Yes
BMSCE,Aerospace Engineering,COMEDK,2024,236978,64786,12498,27787,342049,314262,No
CMRIT,Data Science,COMEDK,2023,236793,65552,9456,15204,327005,311801,No
BITM,Electrical and Electronics Engineering,COMEDK,2023,168525,68730,16656,17736,271647,253911,Yes
RAIT,Chemical Engineering,COMEDK,2023,206171,76500,9095,19195,310961,291766,Yes
RVCE,Information Science and Engineering,COMEDK,2023,222433,92713,16369,26851,358366,331515,Yes
DSCE,Data Science,COMEDK,2024,192329,93080,12302,10761,308472,297711,No
NMIT,Biotechnology,COMEDK,2023,209107,88517,15834,18320,331778,313458,Yes
SDMCET,Chemical Engineering,KCET,2023,55105,83963,15031,23621,177720,154099,Yes
PRES,Electronics and Communication Engineering,KCET,2024,76030,76000,9723,19543,181296,161753,Yes
VVCE,Electronics and Communication Engineering,COMEDK,2023,170588,66919,15734,29245,282486,253241,No
PESCE,Data Science,COMEDK,2023,228100,80350,9241,27300,344991,317691,Yes
RAIT,Electronics and Communication Engineering,KCET,2024,62208,69341,19805,14752,166106,151354,Yes
RNSIT,Computer Science and Engineering,KCET,2024,69620,79386,10759,16830,176595,159765,No
SCEM,Mechanical Engineering,COMEDK,2024,199332,88603,13900,29258,331093,301835,No
VSM,Electronics and Communication Engineering,KCET,2024,60252,77170,17394,29988,184804,154816,Yes
BMSCE,Artificial Intelligence and Data Science,KCET,2024,59537,87640,8866,15199,171242,156043,No
VemanaIT,Mechanical Engineering,COMEDK,2023,206071,91199,11985,23420,332675,309255,No
RAIT,Information Science and Engineering,COMEDK,2023,163598,88258,15796,12132,279784,267652,No
PESCE,Electrical and Electronics Engineering,KCET,2024,80136,76382,8496,12275,177289,165014,No
BIT,Civil Engineering,KCET,2024,82617,60399,12761,20557,176334,155777,Yes
DBIT,Artificial Intelligence and Data Science,KCET,2023,75491,73285,10338,24817,183931,159114,No
RNSIT,Aerospace Engineering,KCET,2023,80768,88326,12570,16172,197836,181664,No
AITM,Electrical and Electronics Engineering,COMEDK,2024,218149,64612,16591,13793,313145,299352,Yes
SIT,Mechanical Engineering,COMEDK,2023,243159,94935,17643,28492,384229,355737,Yes
AITM,Mechanical Engineering,KCET,2024,67940,67280,14939,18845,169004,150159,No
AEC,Artificial Intelligence and Data Science,COMEDK,2023,219988,82165,14666,10268,327087,316819,Yes
PESCE,Civil Engineering,KCET,2024,53684,65525,17709,21627,158545,136918,Yes
CMRIT,Information Science and Engineering,KCET,2024,57052,89953,9517,27214,183736,156522,No
BITM,Computer Science and Engineering,COMEDK,2024,172653,71157,17942,15440,277192,261752,No
RAIT,Artificial Intelligence and Data Science,COMEDK,2023,203512,70575,11885,22081,308053,285972,No
CITGubbi,Robotics and Automation Engineering,KCET,2024,57904,61471,12757,25916,158048,132132,No
GMIT,Robotics and Automation Engineering,COMEDK,2024,192165,93980,17304,16655,320104,303449,No
NMIT,Chemical Engineering,COMEDK,2024,178000,62562,16723,11961,269246,257285,No
DrAIT,Electrical and Electronics Engineering,KCET,2023,82391,75581,12070,16511,186553,170042,Yes
BMSCE,Aerospace Engineering,COMEDK,2023,206082,87405,15352,11098,319937,308839,No
VVIT,Information Science and Engineering,KCET,2023,66824,74615,11470,28302,181211,152909,Yes
MSRIT,Computer Science and Engineering,KCET,2024,59312,86322,9682,21907,177223,155316,No
JNNCE,Artificial Intelligence and Data Science,KCET,2023,62733,80046,8871,26788,178438,151650,Yes
JNNCE,Information Science and Engineering,COMEDK,2023,210316,69075,19720,14372,313483,299111,Yes
RIT,Data Science,COMEDK,2024,172419,84124,9501,13519,279563,266044,Yes
NCET,Information Science and Engineering,COMEDK,2024,173288,72838,12614,15601,274341,258740,No
VVIT,Data Science,KCET,2023,50384,70937,8929,27006,157256,130250,Yes
SJBCE,Artificial Intelligence and Data Science,KCET,2023,60950,82228,17526,23851,184555,160704,No
AECMandya,Data Science,KCET,2023,70581,85366,15706,22046,193699,171653,Yes
SDMCET,Civil Engineering,KCET,2023,71649,70633,13807,17513,173602,156089,No
VSM,Chemical Engineering,KCET,2023,57890,79295,14898,12686,164769,152083,No
EastPoint,Mechanical Engineering,KCET,2024,64745,77976,8564,16274,167559,151285,Yes
BIT,Biotechnology,KCET,2023,52380,70917,14747,12161,150205,138044,No
HKBK,Biotechnology,COMEDK,2024,180318,87952,16913,21933,307116,285183,No
RNSIT,Information Science and Engineering,COMEDK,2024,193860,94554,11893,11967,312274,300307,No
VSM,Mechanical Engineering,KCET,2024,78248,77165,10310,23570,189293,165723,No
BIT,Biotechnology,COMEDK,2023,182242,93043,10383,21658,307326,285668,No
CITGubbi,Robotics and Automation Engineering,KCET,2023,57979,76115,10682,16577,161353,144776,No
CITGubbi,Electrical and Electronics Engineering,KCET,2024,74187,67781,11056,20424,173448,153024,Yes
DSCE,Chemical Engineering,KCET,2024,72242,75400,8652,26289,182583,156294,No
YKCE,Electronics and Communication Engineering,KCET,2024,68840,83946,10899,27404,191089,163685,No
SITM,Information Science and Engineering,KCET,2023,66096,82815,14597,13393,176901,163508,No
PESU,Artificial Intelligence and Data Science,KCET,2024,76334,73762,17032,13104,180232,167128,No
BMSIT,Electronics and Communication Engineering,KCET,2023,61137,92137,10907,12682,176863,164181,Yes
RNSIT,Aerospace Engineering,KCET,2024,55153,62449,19811,21574,158987,137413,Yes
VVIT,Robotics and Automation Engineering,COMEDK,2023,234167,88089,12071,14624,348951,334327,Yes
KSIT,Information Science and Engineering,COMEDK,2024,236126,66470,10931,18651,332178,313527,Yes
SJBIT,Civil Engineering,KCET,2024,59349,76695,18616,26430,181090,154660,No
RVUNIV,Information Science and Engineering,KCET,2023,78982,84410,17223,15486,196101,180615,No
GMIT,Information Science and Engineering,COMEDK,2024,238895,68276,11887,18273,337331,319058,No
SIT,Computer Science and Engineering,KCET,2024,63415,85162,18070,24005,190652,166647,No
SDMCET,Robotics and Automation Engineering,KCET,2023,53513,71780,17537,29711,172541,142830,No
KLEIT,Artificial Intelligence and Data Science,KCET,2024,75086,78164,15532,22808,191590,168782,No
NHCE,Artificial Intelligence and Data Science,KCET,2024,52341,63155,19262,24968,159726,134758,Yes
SDMCET,Electrical and Electronics Engineering,KCET,2024,54185,66678,11008,17401,149272,131871,Yes
AECMandya,Mechanical Engineering,COMEDK,2023,184063,92903,10969,13033,300968,287935,Yes
GIT,Robotics and Automation Engineering,COMEDK,2024,244919,73333,19886,21714,359852,338138,Yes
SJBCE,Data Science,COMEDK,2023,239034,61631,17340,24704,342709,318005,Yes
NMIT,Information Science and Engineering,KCET,2023,57658,61512,12634,15184,146988,131804,Yes
MSRUAS,Biotechnology,KCET,2024,63888,66683,18865,29387,178823,149436,No
RNSIT,Data Science,COMEDK,2023,223305,74539,9759,27735,335338,307603,No
REVA,Computer Science and Engineering,COMEDK,2024,178230,84377,18648,15236,296491,281255,No
CITGubbi,Civil Engineering,KCET,2023,81519,74582,9982,14518,180601,166083,No
RVCE,Aerospace Engineering,KCET,2023,79707,86180,14960,20899,201746,180847,Yes
CITGubbi,Biotechnology,COMEDK,2023,231783,76131,14445,25697,348056,322359,Yes
AECMandya,Electronics and Communication Engineering,COMEDK,2024,245515,65031,18884,17241,346671,329430,No
AIT,Mechanical Engineering,COMEDK,2023,187540,78229,18106,12569,296444,283875,Yes
AECMandya,Data Science,COMEDK,2024,235601,80897,8100,10536,335134,324598,No
BIT,Civil Engineering,COMEDK,2024,182838,74920,9683,27614,295055,267441,No
CITGubbi,Biotechnology,COMEDK,2024,242278,76822,14271,29548,362919,333371,Yes
KLSGIT,Biotechnology,KCET,2024,53554,80248,8290,16669,158761,142092,Yes
MVJCE,Robotics and Automation Engineering,KCET,2024,69001,72592,17931,29918,189442,159524,Yes
BITM,Robotics and Automation Engineering,KCET,2023,75797,68630,11427,14988,170842,155854,Yes
BIT,Electrical and Electronics Engineering,KCET,2023,81856,73426,9535,11274,176091,164817,No
MVJCE,Mechanical Engineering,COMEDK,2023,187362,63134,10140,22025,282661,260636,Yes
RNSIT,Biotechnology,COMEDK,2024,221039,68155,13460,22144,324798,302654,No
VVCE,Computer Science and Engineering,KCET,2024,67964,69536,19405,26339,183244,156905,No
PESCE,Computer Science and Engineering,COMEDK,2024,190344,69468,10887,24804,295503,270699,Yes
SITM,Mechanical Engineering,COMEDK,2024,176604,72477,16962,25585,291628,266043,Yes
BMSIT,Aerospace Engineering,KCET,2024,82299,89671,10775,16552,199297,182745,Yes
GIT,Artificial Intelligence and Data Science,COMEDK,2023,242659,71757,11923,23416,349755,326339,Yes
VemanaIT,Information Science and Engineering,KCET,2024,53930,63295,18394,12410,148029,135619,Yes
SDMCET,Electronics and Communication Engineering,COMEDK,2024,220449,77633,18857,23165,340104,316939,Yes
KLEIT,Mechanical Engineering,COMEDK,2023,170778,67125,15568,14957,268428,253471,No
NMIT,Information Science and Engineering,COMEDK,2024,190970,90070,14235,23268,318543,295275,Yes
VIT,Artificial Intelligence and Data Science,COMEDK,2023,198130,66906,11491,29627,306154,276527,Yes
MSRUAS,Electronics and Communication Engineering,KCET,2024,71390,72011,10311,11320,165032,153712,Yes
SIT,Robotics and Automation Engineering,KCET,2024,79695,88345,18456,29805,216301,186496,Yes
BMSCE,Data Science,COMEDK,2023,247681,60576,12543,16762,337562,320800,Yes
RAIT,Aerospace Engineering,KCET,2024,77248,66361,12768,14905,171282,156377,Yes
RIT,Electronics and Communication Engineering,COMEDK,2023,165024,62786,11577,26019,265406,239387,No
AEC,Chemical Engineering,KCET,2024,66338,82648,18991,19723,187700,167977,Yes
BNMIT,Aerospace Engineering,KCET,2023,57625,82581,8931,16454,165591,149137,Yes
RIT,Aerospace Engineering,KCET,2024,84226,93077,14058,12266,203627,191361,No
GMIT,Electrical and Electronics Engineering,KCET,2023,65189,74556,16189,25237,181171,155934,Yes
RVCE,Robotics and Automation Engineering,KCET,2023,64956,83032,19596,18231,185815,167584,Yes
AITM,Mechanical Engineering,COMEDK,2023,178618,80794,18883,18087,296382,278295,No
YKCE,Mechanical Engineering,COMEDK,2024,169081,86233,15912,24497,295723,271226,Yes
SIT,Artificial Intelligence and Data Science,KCET,2024,70960,66231,11580,15290,164061,148771,No
KLSGIT,Aerospace Engineering,COMEDK,2024,240319,72384,10886,14503,338092,323589,No
DSATM,Aerospace Engineering,KCET,2024,59761,84057,17354,17462,178634,161172,Yes
PRES,Aerospace Engineering,COMEDK,2023,177520,74123,14386,13149,279178,266029,No
SCEM,Computer Science and Engineering,KCET,2023,84500,92307,13244,19549,209600,190051,Yes
PRES,Mechanical Engineering,COMEDK,2024,245668,64442,13035,22066,345211,323145,Yes
AITM,Electrical and Electronics Engineering,KCET,2024,83374,73420,9913,10298,177005,166707,Yes
VIT,Electronics and Communication Engineering,KCET,2024,76308,75333,12764,17415,181820,164405,Yes
VVIT,Chemical Engineering,COMEDK,2023,165829,78607,19238,23330,287004,263674,Yes
DSCE,Chemical Engineering,KCET,2023,82474,89855,14185,19495,206009,186514,No
SCEM,Data Science,KCET,2024,84336,60868,16302,22359,183865,161506,Yes
UVCE,Chemical Engineering,COMEDK,2023,222569,74393,14756,21950,333668,311718,No
SJBIT,Aerospace Engineering,COMEDK,2023,238395,92031,11379,26076,367881,341805,Yes
JSSSTU,Chemical Engineering,KCET,2024,72876,62908,10773,28557,175114,146557,Yes
JIT,Biotechnology,KCET,2024,60913,60529,11496,21110,154048,132938,Yes
VIT,Electrical and Electronics Engineering,KCET,2024,54594,71130,18192,22142,166058,143916,Yes
VSM,Chemical Engineering,COMEDK,2024,223256,91361,18513,14862,347992,333130,Yes
RVUNIV,Data Science,KCET,2023,52321,91652,15863,29248,189084,159836,No
CMRIT,Data Science,KCET,2023,84618,73947,11499,21282,191346,170064,Yes
KSIT,Information Science and Engineering,COMEDK,2023,232558,62442,11457,12601,319058,306457,Yes
SIT,Civil Engineering,KCET,2024,74899,60015,16220,24635,175769,151134,Yes
SJBIT,Aerospace Engineering,KCET,2024,50147,72760,11696,16065,150668,134603,Yes
GIT,Mechanical Engineering,KCET,2024,77137,64337,18842,27965,188281,160316,Yes
SDMIT,Information Science and Engineering,COMEDK,2023,234469,86237,12654,20525,353885,333360,No
VVIT,Aerospace Engineering,COMEDK,2024,207236,80025,17314,19748,324323,304575,No
GIT,Chemical Engineering,COMEDK,2023,185042,65750,19076,25540,295408,269868,Yes
BMIT,Data Science,COMEDK,2024,188284,78500,13518,24350,304652,280302,Yes
GMIT,Aerospace Engineering,COMEDK,2023,175406,76503,17616,29233,298758,269525,Yes
VVIT,Electronics and Communication Engineering,COMEDK,2023,174845,61931,8261,12354,257391,245037,Yes
BITM,Electrical and Electronics Engineering,KCET,2024,71201,63764,14088,18649,167702,149053,No
RIT,Chemical Engineering,COMEDK,2024,243765,66343,19323,18646,348077,329431,Yes
VemanaIT,Electrical and Electronics Engineering,COMEDK,2023,162523,75682,17933,18946,275084,256138,No
SITM,Civil Engineering,KCET,2024,52514,74688,12150,28314,167666,139352,No
SJBCE,Civil Engineering,KCET,2024,52324,75476,12876,19316,159992,140676,No
AITM,Civil Engineering,KCET,2023,76023,64892,15173,11434,167522,156088,No
RVUNIV,Computer Science and Engineering,COMEDK,2023,193716,81179,19462,16130,310487,294357,Yes
RIT,Artificial Intelligence and Data Science,KCET,2024,61302,63121,14761,23768,162952,139184,No
DBIT,Civil Engineering,COMEDK,2024,190524,86918,17628,16734,311804,295070,Yes
MVJCE,Aerospace Engineering,COMEDK,2023,185010,78779,15796,18721,298306,279585,No
HKBK,Chemical Engineering,COMEDK,2023,200403,63149,18419,29454,311425,281971,No
SJBIT,Aerospace Engineering,KCET,2023,62667,70491,10491,13249,156898,143649,Yes
HKBK,Computer Science and Engineering,COMEDK,2023,163717,64882,10355,19475,258429,238954,No
VVCE,Artificial Intelligence and Data Science,KCET,2023,66352,86939,18514,16047,187852,171805,No
YKCE,Computer Science and Engineering,COMEDK,2023,236823,85527,14251,24774,361375,336601,No
HKBK,Robotics and Automation Engineering,COMEDK,2023,233000,81353,9820,24829,349002,324173,Yes
SDMCET,Mechanical Engineering,KCET,2024,57815,74497,8922,16928,158162,141234,Yes
SCEM,Artificial Intelligence and Data Science,COMEDK,2024,223608,68549,11202,18457,321816,303359,No
SDMIT,Artificial Intelligence and Data Science,COMEDK,2023,175197,67958,16433,16066,275654,259588,No
SIT,Electronics and Communication Engineering,KCET,2023,64169,84618,13969,14501,177257,162756,Yes
EastPoint,Civil Engineering,COMEDK,2024,248066,83684,13723,11767,357240,345473,Yes
BMSIT,Artificial Intelligence and Data Science,COMEDK,2024,227306,81550,13679,24123,346658,322535,Yes
KLEIT,Information Science and Engineering,KCET,2024,75972,81525,16147,10260,183904,173644,Yes
REVA,Information Science and Engineering,KCET,2024,78028,63496,19336,22482,183342,160860,Yes
SJBCE,Biotechnology,KCET,2023,64987,61021,19309,11987,157304,145317,No
EastPoint,Data Science,KCET,2023,82497,75729,17591,20266,196083,175817,No
VIT,Artificial Intelligence and Data Science,KCET,2023,66750,66015,8989,19122,160876,141754,No
SDMIT,Electrical and Electronics Engineering,KCET,2023,50228,83116,8738,17927,160009,142082,Yes
DrAIT,Artificial Intelligence and Data Science,COMEDK,2023,204310,86986,11957,18299,321552,303253,Yes
SJBIT,Electronics and Communication Engineering,KCET,2024,65052,76515,17806,22734,182107,159373,Yes
VIT,Electronics and Communication Engineering,COMEDK,2023,179473,68334,17186,27009,292002,264993,No
BNMIT,Civil Engineering,COMEDK,2023,235838,87681,13017,22053,358589,336536,Yes
DBIT,Computer Science and Engineering,COMEDK,2024,170559,92516,9991,26612,299678,273066,Yes
AECMandya,Computer Science and Engineering,KCET,2023,80376,91378,8285,13992,194031,180039,Yes
HKBK,Electronics and Communication Engineering,COMEDK,2023,231127,94842,9022,12014,347005,334991,No
GMIT,Information Science and Engineering,COMEDK,2023,173994,62556,13173,20803,270526,249723,Yes
AEC,Biotechnology,COMEDK,2024,203317,90184,12727,22416,328644,306228,Yes
JIT,Biotechnology,KCET,2023,68835,86081,11720,19278,185914,166636,No
DSCE,Mechanical Engineering,COMEDK,2024,176167,88269,15694,11790,291920,280130,Yes
RIT,Robotics and Automation Engineering,COMEDK,2023,235109,61918,19126,23737,339890,316153,No
PRES,Computer Science and Engineering,KCET,2023,65679,91587,12816,26311,196393,170082,Yes
BITM,Aerospace Engineering,KCET,2024,78311,73661,17798,20996,190766,169770,Yes
REVA,Biotechnology,KCET,2024,66889,68188,19586,28763,183426,154663,Yes
VVIT,Electrical and Electronics Engineering,COMEDK,2024,233012,63443,16499,14407,327361,312954,No
NHCE,Data Science,COMEDK,2023,195670,76296,8625,24968,305559,280591,Yes
RAIT,Data Science,COMEDK,2023,199825,89056,13921,16439,319241,302802,No
CMRIT,Information Science and Engineering,COMEDK,2024,208034,79155,8987,29052,325228,296176,Yes
REVA,Electronics and Communication Engineering,KCET,2024,75075,80188,9316,17213,181792,164579,No
SDMCET,Electrical and Electronics Engineering,COMEDK,2023,248909,86425,9047,29958,374339,344381,Yes
JSSSTU,Chemical Engineering,COMEDK,2023,186693,77779,15797,27471,307740,280269,No
BMIT,Aerospace Engineering,COMEDK,2023,164461,74211,15962,27285,281919,254634,No
DBIT,Aerospace Engineering,COMEDK,2023,193982,73646,12268,14836,294732,279896,No
REVA,Data Science,KCET,2024,61097,60169,19784,16738,157788,141050,Yes
AECMandya,Electronics and Communication Engineering,KCET,2024,74395,85767,18239,28805,207206,178401,No
DSATM,Data Science,KCET,2024,58184,93628,14649,18513,184974,166461,Yes
JSSSTU,Electronics and Communication Engineering,COMEDK,2024,174680,93559,11031,24816,304086,279270,Yes
PESU,Biotechnology,KCET,2023,64689,65968,14694,11469,156820,145351,Yes
PESU,Robotics and Automation Engineering,COMEDK,2024,166467,91523,16506,19967,294463,274496,No
KSIT,Chemical Engineering,KCET,2023,60376,86422,13628,19443,179869,160426,Yes
VIT,Electrical and Electronics Engineering,COMEDK,2023,249257,83949,15145,27051,375402,348351,Yes
BMIT,Artificial Intelligence and Data Science,KCET,2023,51895,62775,18648,19560,152878,133318,No
NCET,Artificial Intelligence and Data Science,COMEDK,2023,167617,61020,16734,23340,268711,245371,No
SITM,Biotechnology,COMEDK,2023,235168,63964,14738,16004,329874,313870,Yes
ACU,Computer Science and Engineering,COMEDK,2024,191380,81379,14703,16454,303916,287462,No
GMIT,Civil Engineering,COMEDK,2024,208105,74234,16612,10147,309098,298951,Yes
RVUNIV,Mechanical Engineering,COMEDK,2023,246571,80730,17271,23215,367787,344572,No
PESU,Aerospace Engineering,KCET,2023,75434,86112,12279,22251,196076,173825,Yes
KLEIT,Aerospace Engineering,KCET,2023,69928,78530,18838,19724,187020,167296,Yes
ACU,Mechanical Engineering,COMEDK,2024,173946,93295,13501,21001,301743,280742,No
SITM,Computer Science and Engineering,KCET,2024,50399,73256,17604,28841,170100,141259,Yes
RVUNIV,Electrical and Electronics Engineering,KCET,2023,54489,91988,9664,21390,177531,156141,No
KLEIT,Data Science,KCET,2023,68132,84116,16775,17826,186849,169023,No
PRES,Civil Engineering,COMEDK,2024,211644,66400,19346,10858,308248,297390,No
NCET,Aerospace Engineering,KCET,2024,72083,88017,15421,21513,197034,175521,No
DSATM,Aerospace Engineering,KCET,2023,62405,75960,15515,14635,168515,153880,No
PESCE,Robotics and Automation Engineering,KCET,2024,53695,66826,18955,20055,159531,139476,Yes
MSRUAS,Information Science and Engineering,COMEDK,2023,208584,88547,9095,27451,333677,306226,Yes
NHCE,Biotechnology,KCET,2023,71630,81255,16278,14354,183517,169163,Yes
JSSSTU,Chemical Engineering,COMEDK,2023,181786,82649,18507,20590,303532,282942,No
BNMIT,Robotics and Automation Engineering,COMEDK,2024,228431,90948,13702,16714,349795,333081,Yes
SJBCE,Robotics and Automation Engineering,COMEDK,2023,185186,76844,13315,14875,290220,275345,No
BMSCE,Biotechnology,COMEDK,2024,166433,84601,12106,28632,291772,263140,No
BIT,Information Science and Engineering,COMEDK,2023,232101,89748,14234,23073,359156,336083,No
BMIT,Electronics and Communication Engineering,KCET,2024,62284,91674,17548,22865,194371,171506,No
GMIT,Civil Engineering,KCET,2024,83381,73422,16771,17615,191189,173574,Yes
SDMCET,Information Science and Engineering,KCET,2023,50309,87276,9032,13028,159645,146617,Yes
NMIT,Electrical and Electronics Engineering,KCET,2024,67963,92834,12458,18144,191399,173255,Yes
BMSCE,Electrical and Electronics Engineering,COMEDK,2023,232221,84977,17184,20161,354543,334382,Yes
RIT,Electronics and Communication Engineering,COMEDK,2024,207362,76812,14510,22305,320989,298684,Yes
PESU,Biotechnology,COMEDK,2024,175061,89455,8486,19997,292999,273002,Yes
SDMIT,Mechanical Engineering,KCET,2023,77598,63213,14951,21512,177274,155762,No
SIT,Civil Engineering,KCET,2023,82725,83268,13571,21760,201324,179564,Yes
KSIT,Data Science,KCET,2023,58126,62876,14264,18871,154137,135266,Yes
SCEM,Electrical and Electronics Engineering,COMEDK,2023,233303,63638,15231,11153,323325,312172,No
DrAIT,Data Science,KCET,2024,83218,83395,14089,18556,199258,180702,Yes
YKCE,Computer Science and Engineering,KCET,2024,76886,64979,8021,20139,170025,149886,Yes
RVUNIV,Chemical Engineering,COMEDK,2023,208593,77701,11781,16081,314156,298075,No
YKCE,Computer Science and Engineering,KCET,2023,80135,63788,13936,28954,186813,157859,Yes
YKCE,Mechanical Engineering,COMEDK,2023,177458,86253,9136,23899,296746,272847,No
BIT,Artificial Intelligence and Data Science,COMEDK,2023,199814,77520,16345,29299,322978,293679,Yes
REVA,Electronics and Communication Engineering,KCET,2024,75077,76555,8284,15988,175904,159916,Yes
KSIT,Chemical Engineering,COMEDK,2023,239445,65195,15996,27329,347965,320636,Yes
AIT,Chemical Engineering,KCET,2024,76882,93112,8462,28327,206783,178456,No
CMRIT,Biotechnology,COMEDK,2023,213514,85564,10404,23401,332883,309482,Yes
RVUNIV,Biotechnology,KCET,2024,82778,85327,16079,16039,200223,184184,No
GMIT,Aerospace Engineering,COMEDK,2023,229095,80463,14094,25540,349192,323652,Yes
RIT,Electrical and Electronics Engineering,KCET,2023,51234,67211,13822,25031,157298,132267,Yes
CMRIT,Civil Engineering,KCET,2024,62764,80322,13528,24625,181239,156614,Yes
BITM,Biotechnology,KCET,2023,84004,60824,12519,12856,170203,157347,Yes
BMIT,Electronics and Communication Engineering,COMEDK,2023,181679,85530,14864,28158,310231,282073,No
CITGubbi,Electronics and Communication Engineering,KCET,2023,58686,64655,8119,26737,158197,131460,Yes
RAIT,Information Science and Engineering,KCET,2024,52576,73565,17083,21038,164262,143224,Yes
VIT,Robotics and Automation Engineering,COMEDK,2023,208085,72606,11796,19480,311967,292487,Yes
ACU,Biotechnology,COMEDK,2023,197304,92744,11721,18526,320295,301769,Yes
NMIT,Aerospace Engineering,KCET,2023,60014,81061,10120,18483,169678,151195,No
VVCE,Electronics and Communication Engineering,COMEDK,2024,168839,70361,8512,27100,274812,247712,No
DSCE,Artificial Intelligence and Data Science,COMEDK,2023,167649,60692,9591,16482,254414,237932,Yes
SJBCE,Robotics and Automation Engineering,KCET,2023,70048,91776,13408,21597,196829,175232,No
KLEIT,Data Science,KCET,2023,76954,71386,17454,24020,189814,165794,Yes
VemanaIT,Mechanical Engineering,KCET,2023,72261,67566,17114,15664,172605,156941,No
RAIT,Data Science,COMEDK,2024,186700,67926,13154,17680,285460,267780,Yes
NMIT,Electronics and Communication Engineering,KCET,2024,66289,69409,13547,26783,176028,149245,Yes
SITM,Robotics and Automation Engineering,COMEDK,2024,223464,70793,19199,21916,335372,313456,No
JNNCE,Computer Science and Engineering,COMEDK,2023,175462,93370,14864,18094,301790,283696,Yes
BMSIT,Computer Science and Engineering,COMEDK,2024,226163,70213,13386,22879,332641,309762,No
AITM,Chemical Engineering,KCET,2023,75850,93162,18082,26522,213616,187094,Yes
RNSIT,Robotics and Automation Engineering,COMEDK,2023,203886,90426,11674,13594,319580,305986,Yes
VSM,Electrical and Electronics Engineering,COMEDK,2024,215980,60693,16116,27234,320023,292789,Yes
HKBK,Mechanical Engineering,KCET,2024,67544,81664,18101,17965,185274,167309,Yes
PRES,Aerospace Engineering,COMEDK,2024,217609,77931,18819,17692,332051,314359,No
JSSSTU,Information Science and Engineering,KCET,2024,82063,65154,18298,23767,189282,165515,Yes
PRES,Mechanical Engineering,COMEDK,2023,214596,69135,16533,20088,320352,300264,Yes
JIT,Aerospace Engineering,KCET,2024,73845,64124,13914,22556,174439,151883,No
RVUNIV,Chemical Engineering,COMEDK,2023,227485,74750,12644,20650,335529,314879,No
UVCE,Electrical and Electronics Engineering,COMEDK,2024,180035,63018,12216,29772,285041,255269,No
VSM,Information Science and Engineering,KCET,2023,83295,70894,15176,24174,193539,169365,Yes
DrAIT,Aerospace Engineering,COMEDK,2024,231872,78825,12984,27573,351254,323681,No
AITM,Information Science and Engineering,COMEDK,2023,230326,88926,9267,16861,345380,328519,No
KLEIT,Aerospace Engineering,COMEDK,2024,235911,71757,13949,22478,344095,321617,Yes
BMSIT,Artificial Intelligence and Data Science,COMEDK,2024,168095,83832,19601,25936,297464,271528,No
BNMIT,Data Science,COMEDK,2024,227558,75111,12122,16220,331011,314791,Yes
AITM,Data Science,KCET,2024,83132,68123,16542,27443,195240,167797,Yes
AITM,Computer Science and Engineering,KCET,2023,51727,83166,13416,11857,160166,148309,No
DSCE,Information Science and Engineering,KCET,2024,53429,70936,8996,23256,156617,133361,No
UVCE,Electronics and Communication Engineering,COMEDK,2023,232435,71454,10777,19566,334232,314666,No
JIT,Aerospace Engineering,COMEDK,2023,246079,83882,16561,28125,374647,346522,No
KSIT,Aerospace Engineering,COMEDK,2024,192598,65556,15088,14319,287561,273242,Yes
AEC,Artificial Intelligence and Data Science,KCET,2023,52320,87299,10364,13471,163454,149983,No
JSSSTU,Electronics and Communication Engineering,KCET,2024,60355,76863,12983,14525,164726,150201,No
RAIT,Biotechnology,KCET,2023,67612,76943,15699,15661,175915,160254,Yes
DSCE,Chemical Engineering,KCET,2024,54497,64521,16637,22172,157827,135655,Yes
MSRIT,Artificial Intelligence and Data Science,COMEDK,2024,216340,76625,10234,28893,332092,303199,No
JSSSTU,Data Science,KCET,2023,64419,61258,8815,11337,145829,134492,Yes
SJBIT,Mechanical Engineering,KCET,2024,77721,93631,8005,23309,202666,179357,No
BMSIT,Chemical Engineering,KCET,2023,65737,82878,17477,15952,182044,166092,No
SIT,Data Science,COMEDK,2024,164022,71392,18285,15869,269568,253699,Yes
SJBCE,Electronics and Communication Engineering,COMEDK,2024,232656,74343,10390,26836,344225,317389,No
AIT,Mechanical Engineering,KCET,2024,77257,61510,8349,23826,170942,147116,No
MSRIT,Robotics and Automation Engineering,COMEDK,2023,230933,76530,10292,11778,329533,317755,Yes
RVUNIV,Biotechnology,KCET,2023,61225,73046,13129,27271,174671,147400,No
MSRIT,Artificial Intelligence and Data Science,COMEDK,2023,171314,84962,11312,24103,291691,267588,No
CITGubbi,Electronics and Communication Engineering,KCET,2023,70625,82836,15825,25552,194838,169286,No
KLEIT,Robotics and Automation Engineering,KCET,2023,77463,60178,10139,14099,161879,147780,Yes
RVCE,Biotechnology,COMEDK,2023,197001,84282,11233,10967,303483,292516,No
PESU,Computer Science and Engineering,COMEDK,2023,182194,87596,9115,19696,298601,278905,No
MSRIT,Data Science,COMEDK,2023,224868,63384,18172,24754,331178,306424,No
JIT,Chemical Engineering,KCET,2023,64298,61215,18136,28888,172537,143649,Yes
RVCE,Data Science,COMEDK,2023,216636,65551,11310,21670,315167,293497,No
RAIT,Computer Science and Engineering,KCET,2023,60220,63863,10295,25361,159739,134378,No
AIT,Biotechnology,COMEDK,2024,235894,61990,18493,13101,329478,316377,Yes
BMSCE,Aerospace Engineering,KCET,2023,79054,83137,19547,21209,202947,181738,No
NIE,Biotechnology,COMEDK,2024,240934,71332,15647,21179,349092,327913,Yes
BITM,Artificial Intelligence and Data Science,COMEDK,2024,241361,88869,13029,23793,367052,343259,Yes
BMIT,Computer Science and Engineering,KCET,2023,74011,67628,19111,25103,185853,160750,Yes
SJBIT,Chemical Engineering,KCET,2024,63476,78658,19209,16703,178046,161343,Yes
CITGubbi,Electronics and Communication Engineering,KCET,2024,82287,83898,16795,11250,194230,182980,Yes
ACU,Electronics and Communication Engineering,KCET,2023,50586,74792,12238,17830,155446,137616,Yes
VemanaIT,Electronics and Communication Engineering,COMEDK,2023,234215,90735,13449,18052,356451,338399,Yes
AIT,Information Science and Engineering,KCET,2024,80019,84034,14506,21868,200427,178559,Yes
RVCE,Electronics and Communication Engineering,COMEDK,2023,171021,90934,15012,28287,305254,276967,No
REVA,Mechanical Engineering,KCET,2023,84874,79414,8464,21086,193838,172752,Yes
PESCE,Information Science and Engineering,COMEDK,2023,161171,90566,8337,13640,273714,260074,Yes
JIT,Aerospace Engineering,KCET,2024,76796,66352,16209,19233,178590,159357,Yes
MSRUAS,Civil Engineering,KCET,2024,84958,66366,8470,28001,187795,159794,Yes
RIT,Robotics and Automation Engineering,KCET,2024,69949,66196,9954,22936,169035,146099,Yes
MVJCE,Chemical Engineering,KCET,2023,77787,89474,15979,16834,200074,183240,Yes
SCEM,Information Science and Engineering,COMEDK,2023,174169,71381,17360,17949,280859,262910,No
BITM,Artificial Intelligence and Data Science,KCET,2023,53387,63041,15237,20829,152494,131665,Yes
MSRIT,Information Science and Engineering,COMEDK,2023,210373,91696,16364,12427,330860,318433,No
RVUNIV,Biotechnology,COMEDK,2023,161817,77849,19678,28332,287676,259344,Yes
MSRIT,Data Science,COMEDK,2024,195133,73621,15162,13626,297542,283916,Yes
NIE,Artificial Intelligence and Data Science,KCET,2023,67484,94798,18678,26274,207234,180960,Yes
SDMIT,Computer Science and Engineering,COMEDK,2024,206601,91411,10612,17547,326171,308624,Yes
DSATM,Aerospace Engineering,KCET,2023,82746,81485,14646,19418,198295,178877,No
JNNCE,Electrical and Electronics Engineering,COMEDK,2023,209235,77797,14204,12693,313929,301236,Yes
RNSIT,Chemical Engineering,COMEDK,2023,223045,86584,14490,27377,351496,324119,Yes
HKBK,Information Science and Engineering,KCET,2023,56425,81343,11755,20152,169675,149523,Yes
AITM,Biotechnology,KCET,2024,56987,86690,13141,17602,174420,156818,Yes
CITGubbi,Electronics and Communication Engineering,COMEDK,2023,211909,92427,12928,13058,330322,317264,Yes
BMSCE,Robotics and Automation Engineering,COMEDK,2024,205119,65911,17207,19187,307424,288237,No
BMSCE,Biotechnology,COMEDK,2023,193754,75787,19527,22962,312030,289068,Yes
BMSIT,Artificial Intelligence and Data Science,KCET,2023,72463,64555,16863,13152,167033,153881,No
DBIT,Aerospace Engineering,COMEDK,2024,200172,66588,11016,24834,302610,277776,No
CITGubbi,Data Science,COMEDK,2024,172032,71498,19908,15617,279055,263438,No
VVCE,Chemical Engineering,COMEDK,2024,160844,73140,19908,24786,278678,253892,No
DSCE,Biotechnology,KCET,2024,84103,81824,15494,23365,204786,181421,No
JNNCE,Data Science,COMEDK,2024,205554,87250,11197,17431,321432,304001,No
SIT,Computer Science and Engineering,COMEDK,2023,180359,75627,14552,18700,289238,270538,Yes
UVCE,Electrical and Electronics Engineering,COMEDK,2023,242280,90277,12367,24614,369538,344924,Yes
RVUNIV,Civil Engineering,COMEDK,2024,162144,69726,11084,27698,270652,242954,No
SITM,Artificial Intelligence and Data Science,COMEDK,2024,161828,75685,16880,22716,277109,254393,No
SJBIT,Information Science and Engineering,KCET,2024,56584,78495,11181,29937,176197,146260,No
PRES,Chemical Engineering,KCET,2024,74347,85390,14900,20154,194791,174637,No
RIT,Data Science,COMEDK,2024,218407,91271,11904,19325,340907,321582,Yes
VSM,Mechanical Engineering,KCET,2023,55911,60022,10144,29714,155791,126077,No
RNSIT,Biotechnology,KCET,2023,74764,84674,11807,12477,183722,171245,No
AEC,Biotechnology,KCET,2023,77828,74513,13938,12042,178321,166279,Yes
PRES,Electronics and Communication Engineering,KCET,2024,58441,79446,11864,22922,172673,149751,No
UVCE,Computer Science and Engineering,COMEDK,2023,218730,66783,8942,20291,314746,294455,Yes
GIT,Civil Engineering,COMEDK,2024,239684,73341,16640,15347,345012,329665,No
BIT,Civil Engineering,COMEDK,2024,211462,68670,9493,27638,317263,289625,No
DBIT,Biotechnology,KCET,2023,70245,78206,16236,27768,192455,164687,No
SJBIT,Computer Science and Engineering,KCET,2024,62354,82546,17508,16060,178468,162408,No
RIT,Civil Engineering,KCET,2023,58131,86405,12779,14137,171452,157315,No
SJBIT,Artificial Intelligence and Data Science,KCET,2024,71557,72165,14927,10800,169449,158649,No
REVA,Computer Science and Engineering,COMEDK,2024,213668,76335,14825,16181,321009,304828,Yes
KSIT,Information Science and Engineering,COMEDK,2023,205961,81325,12179,25682,325147,299465,Yes
REVA,Data Science,COMEDK,2023,223377,75195,15381,17039,330992,313953,No
RVCE,Robotics and Automation Engineering,KCET,2023,72186,86512,15607,29289,203594,174305,No
VemanaIT,Biotechnology,KCET,2023,82537,92527,17299,18331,210694,192363,No
GMIT,Mechanical Engineering,COMEDK,2024,203178,68430,17526,22471,311605,289134,No
MVJCE,Biotechnology,KCET,2023,69553,67496,14369,28637,180055,151418,Yes
BNMIT,Robotics and Automation Engineering,KCET,2023,77061,68651,9817,15977,171506,155529,Yes
VVIT,Data Science,KCET,2024,69276,60119,10201,23252,162848,139596,No
RAIT,Civil Engineering,COMEDK,2024,227362,65085,10601,16278,319326,303048,Yes
AITM,Computer Science and Engineering,KCET,2024,57406,74002,8604,18617,158629,140012,No
SDMCET,Artificial Intelligence and Data Science,COMEDK,2024,221990,71696,15143,28061,336890,308829,No
KLSGIT,Information Science and Engineering,KCET,2024,72312,92271,8952,14697,188232,173535,Yes
SITM,Artificial Intelligence and Data Science,KCET,2023,65631,71537,8428,14776,160372,145596,Yes
YKCE,Information Science and Engineering,KCET,2023,61996,72990,10402,27814,173202,145388,No
PRES,Biotechnology,COMEDK,2023,216709,90543,14609,13884,335745,321861,Yes
EastPoint,Chemical Engineering,COMEDK,2023,192233,73754,8079,25965,300031,274066,No
SITM,Electrical and Electronics Engineering,KCET,2023,75750,69500,9334,12940,167524,154584,Yes
GIT,Chemical Engineering,KCET,2023,68797,80677,12413,19663,181550,161887,Yes
RAIT,Biotechnology,COMEDK,2024,205519,94814,16561,20059,336953,316894,No
JSSSTU,Computer Science and Engineering,KCET,2024,67915,74199,11083,24178,177375,153197,Yes
UVCE,Robotics and Automation Engineering,KCET,2024,51810,94664,13456,17250,177180,159930,Yes
GMIT,Computer Science and Engineering,KCET,2023,84208,92850,11364,20207,208629,188422,No
RVUNIV,Computer Science and Engineering,KCET,2023,54263,63356,16352,27708,161679,133971,Yes
DSCE,Information Science and Engineering,KCET,2024,79558,60453,14851,15858,170720,154862,No
VVIT,Data Science,COMEDK,2023,193352,75141,14056,14812,297361,282549,Yes
VSM,Artificial Intelligence and Data Science,KCET,2023,74840,84844,14956,17049,191689,174640,No
KLEIT,Chemical Engineering,KCET,2023,83460,76065,9316,20602,189443,168841,Yes
KLSGIT,Biotechnology,KCET,2023,70664,88182,14770,12460,186076,173616,No
AEC,Civil Engineering,KCET,2023,63268,78852,14297,13894,170311,156417,No
GMIT,Mechanical Engineering,KCET,2024,50628,76949,11361,20022,158960,138938,No
CITGubbi,Mechanical Engineering,COMEDK,2024,242199,86574,10856,23690,363319,339629,No
AITM,Electronics and Communication Engineering,COMEDK,2023,171387,64466,9235,11876,256964,245088,Yes
ACU,Electrical and Electronics Engineering,COMEDK,2024,199709,77567,17173,28862,323311,294449,Yes
VVCE,Artificial Intelligence and Data Science,KCET,2023,75046,64199,12315,12067,163627,151560,No
HKBK,Information Science and Engineering,COMEDK,2023,160694,61221,11615,16504,250034,233530,No
SJBIT,Electronics and Communication Engineering,KCET,2024,75132,70294,8354,23446,177226,153780,Yes
MVJCE,Chemical Engineering,KCET,2023,67693,76635,9437,18397,172162,153765,No
GIT,Biotechnology,COMEDK,2023,192347,72433,18307,27729,310816,283087,Yes
VSM,Electrical and Electronics Engineering,KCET,2023,81711,87899,17400,18477,205487,187010,Yes
ACU,Civil Engineering,COMEDK,2024,199595,92872,8847,14232,315546,301314,Yes
KLSGIT,Electrical and Electronics Engineering,COMEDK,2024,246455,88368,13820,26324,374967,348643,No
RIT,Aerospace Engineering,KCET,2023,79532,81293,18846,15333,195004,179671,No
BMIT,Data Science,KCET,2023,69599,70642,10160,20099,170500,150401,No
PESCE,Electronics and Communication Engineering,COMEDK,2023,218618,83529,15181,11523,328851,317328,Yes
MSRIT,Mechanical Engineering,KCET,2024,83479,75513,8408,17757,185157,167400,Yes
EastPoint,Electrical and Electronics Engineering,KCET,2024,50466,90641,10369,29871,181347,151476,Yes
JSSSTU,Chemical Engineering,COMEDK,2024,241074,61640,16086,17679,336479,318800,Yes
SDMIT,Data Science,COMEDK,2023,227333,61358,9720,18300,316711,298411,No
JSSSTU,Mechanical Engineering,COMEDK,2024,193502,77168,10578,23187,304435,281248,Yes
MSRUAS,Computer Science and Engineering,KCET,2023,53346,68266,17965,18267,157844,139577,No
BIT,Artificial Intelligence and Data Science,COMEDK,2023,248265,75585,16925,15595,356370,340775,Yes
CITGubbi,Information Science and Engineering,KCET,2023,74622,66122,10632,29864,181240,151376,Yes
BIT,Data Science,KCET,2023,58955,61747,11063,24343,156108,131765,Yes
NIE,Civil Engineering,KCET,2023,81836,72814,14012,26723,195385,168662,Yes
NHCE,Electrical and Electronics Engineering,COMEDK,2023,200554,78285,13774,21059,313672,292613,Yes
DSATM,Data Science,COMEDK,2023,228697,75846,10296,26948,341787,314839,Yes
NHCE,Chemical Engineering,KCET,2024,73999,85516,18705,11214,189434,178220,Yes
BMSCE,Data Science,COMEDK,2023,232889,91109,11259,22860,358117,335257,Yes
PRES,Robotics and Automation Engineering,KCET,2023,81635,86501,14250,14353,196739,182386,No
PESU,Information Science and Engineering,KCET,2024,68339,92875,14585,27168,202967,175799,No
PESU,Robotics and Automation Engineering,COMEDK,2024,162808,64011,8528,18569,253916,235347,No
MSRUAS,Mechanical Engineering,COMEDK,2023,237647,72353,9558,28095,347653,319558,Yes
MSRIT,Electronics and Communication Engineering,COMEDK,2023,221605,94631,19922,13984,350142,336158,Yes
REVA,Artificial Intelligence and Data Science,COMEDK,2023,225017,78698,16629,18118,338462,320344,Yes
JNNCE,Robotics and Automation Engineering,COMEDK,2023,216371,70150,17468,29155,333144,303989,No
RAIT,Civil Engineering,KCET,2023,82364,63277,18007,22680,186328,163648,Yes
SITM,Aerospace Engineering,KCET,2024,74938,71908,13312,21153,181311,160158,No
BNMIT,Artificial Intelligence and Data Science,KCET,2023,84067,68308,17062,10066,179503,169437,No
VIT,Robotics and Automation Engineering,COMEDK,2023,189167,75301,17743,14974,297185,282211,No
DBIT,Computer Science and Engineering,KCET,2023,74501,81808,10422,13792,180523,166731,Yes
JSSSTU,Computer Science and Engineering,COMEDK,2024,174542,79685,17570,26537,298334,271797,No
NCET,Robotics and Automation Engineering,KCET,2023,69543,76170,14597,28375,188685,160310,No
BMSIT,Robotics and Automation Engineering,COMEDK,2024,189503,72286,14283,13711,289783,276072,Yes
DrAIT,Computer Science and Engineering,COMEDK,2023,168872,62240,12298,28275,271685,243410,No
VVCE,Information Science and Engineering,COMEDK,2024,173945,65847,13234,13723,266749,253026,Yes
SDMCET,Mechanical Engineering,KCET,2024,72287,74914,15431,27806,190438,162632,No
SJBCE,Chemical Engineering,COMEDK,2024,174646,89565,8054,13506,285771,272265,Yes
PESU,Data Science,COMEDK,2023,184301,69276,18607,13398,285582,272184,No
SIT,Information Science and Engineering,COMEDK,2024,207488,88752,12514,24231,332985,308754,Yes
VSM,Electronics and Communication Engineering,KCET,2024,82398,73347,15342,20134,191221,171087,Yes
PRES,Civil Engineering,COMEDK,2023,170155,90229,9756,10725,280865,270140,Yes
RAIT,Artificial Intelligence and Data Science,COMEDK,2023,198157,66604,18698,14895,298354,283459,No
PRES,Aerospace Engineering,COMEDK,2023,174651,83657,16162,10389,284859,274470,No
SJBIT,Computer Science and Engineering,KCET,2023,79491,78564,10223,11551,179829,168278,Yes
PESCE,Mechanical Engineering,KCET,2023,69256,80725,17961,12522,180464,167942,Yes
VSM,Aerospace Engineering,COMEDK,2023,214300,79609,9249,28778,331936,303158,No
JSSSTU,Electronics and Communication Engineering,COMEDK,2023,217962,86773,8584,17912,331231,313319,No
SCEM,Information Science and Engineering,COMEDK,2023,192201,88729,13085,10860,304875,294015,No
VIT,Biotechnology,COMEDK,2023,245712,94700,15979,23907,380298,356391,Yes
NCET,Aerospace Engineering,COMEDK,2023,173793,64445,19319,24830,282387,257557,No
DSATM,Robotics and Automation Engineering,COMEDK,2024,228513,68609,11728,23155,332005,308850,No
BMSIT,Data Science,COMEDK,2023,210323,73653,8967,28379,321322,292943,No
RIT,Biotechnology,COMEDK,2023,203149,75301,11996,22811,313257,290446,Yes
AIT,Biotechnology,KCET,2024,70076,84343,12076,23754,190249,166495,No
AIT,Mechanical Engineering,COMEDK,2024,189275,78367,11312,23959,302913,278954,Yes
JIT,Aerospace Engineering,COMEDK,2024,171429,85798,15024,19676,291927,272251,Yes
YKCE,Biotechnology,COMEDK,2023,246501,61014,17238,14203,338956,324753,No
ACU,Aerospace Engineering,KCET,2024,74801,73072,13176,27159,188208,161049,No
SDMIT,Artificial Intelligence and Data Science,KCET,2024,70198,73978,17019,15423,176618,161195,Yes
VVCE,Electronics and Communication Engineering,KCET,2024,59001,74980,10661,20593,165235,144642,No
PESCE,Aerospace Engineering,KCET,2023,78367,73393,16251,17133,185144,168011,Yes
ACU,Electrical and Electronics Engineering,COMEDK,2024,223825,74835,9832,22318,330810,308492,Yes
PESCE,Electrical and Electronics Engineering,COMEDK,2023,186485,64842,13255,24851,289433,264582,Yes
JNNCE,Electrical and Electronics Engineering,COMEDK,2023,181220,77293,15124,17925,291562,273637,Yes
KLSGIT,Computer Science and Engineering,KCET,2023,58445,79834,15578,27132,180989,153857,Yes
BIT,Electronics and Communication Engineering,KCET,2023,82124,68097,14454,10477,175152,164675,Yes
CMRIT,Data Science,KCET,2023,56548,66890,9170,21935,154543,132608,Yes
BMSCE,Data Science,COMEDK,2023,198362,79228,13181,13279,304050,290771,Yes
GMIT,Biotechnology,KCET,2023,72614,62304,13578,19369,167865,148496,No
DrAIT,Electrical and Electronics Engineering,COMEDK,2023,223751,64143,15360,21100,324354,303254,No
KLEIT,Computer Science and Engineering,COMEDK,2023,229940,62743,19503,21299,333485,312186,Yes
BNMIT,Computer Science and Engineering,KCET,2024,71054,70173,10143,26687,178057,151370,Yes
AECMandya,Electronics and Communication Engineering,KCET,2024,56036,94033,14580,13022,177671,164649,Yes
JSSSTU,Computer Science and Engineering,KCET,2024,56556,83677,19309,10172,169714,159542,No
AEC,Data Science,COMEDK,2023,202091,83777,17640,12683,316191,303508,Yes
VIT,Aerospace Engineering,KCET,2024,64980,63667,14704,17603,160954,143351,No
YKCE,Mechanical Engineering,KCET,2023,77344,81598,14852,21045,194839,173794,No
AITM,Mechanical Engineering,KCET,2023,74560,80877,14291,16015,185743,169728,Yes
YKCE,Chemical Engineering,COMEDK,2023,230926,88199,14588,14979,348692,333713,No
SIT,Electronics and Communication Engineering,KCET,2024,65264,82587,9356,28274,185481,157207,Yes
SCEM,Mechanical Engineering,KCET,2024,82370,66499,13032,14108,176009,161901,Yes
JNNCE,Mechanical Engineering,KCET,2024,61712,64122,14576,12816,153226,140410,No
AEC,Artificial Intelligence and Data Science,COMEDK,2023,249417,71906,19093,20330,360746,340416,Yes
KLEIT,Computer Science and Engineering,COMEDK,2024,179872,84324,15368,23286,302850,279564,Yes
MSRUAS,Data Science,KCET,2024,76712,81983,19890,15883,194468,178585,No
MSRIT,Robotics and Automation Engineering,KCET,2024,53773,90144,14489,29106,187512,158406,Yes
SJBIT,Information Science and Engineering,COMEDK,2024,246298,69524,19879,23585,359286,335701,Yes
RVUNIV,Robotics and Automation Engineering,KCET,2023,81341,77126,12813,26748,198028,171280,No
RAIT,Data Science,COMEDK,2023,245456,69840,12322,12693,340311,327618,Yes
DSCE,Data Science,COMEDK,2024,240896,67294,11289,25739,345218,319479,No
KLEIT,Data Science,COMEDK,2023,181044,80202,17940,28144,307330,279186,No
VIT,Information Science and Engineering,KCET,2024,78007,73233,12354,21949,185543,163594,Yes
RAIT,Mechanical Engineering,KCET,2024,73021,64635,15842,22475,175973,153498,Yes
ACU,Robotics and Automation Engineering,KCET,2024,56200,92994,14716,25249,189159,163910,Yes
AECMandya,Civil Engineering,KCET,2023,80794,69839,9184,14096,173913,159817,Yes
NIE,Electrical and Electronics Engineering,KCET,2024,67124,86916,19499,28977,202516,173539,Yes
PRES,Biotechnology,KCET,2024,65675,78114,16091,10431,170311,159880,No
NMIT,Mechanical Engineering,COMEDK,2023,211243,60478,18578,25430,315729,290299,Yes
JSSSTU,Electronics and Communication Engineering,KCET,2023,58838,85009,18192,17280,179319,162039,Yes
ACU,Chemical Engineering,COMEDK,2023,214480,88059,14928,16580,334047,317467,Yes
CMRIT,Biotechnology,KCET,2023,67701,69116,14661,15268,166746,151478,Yes
NMIT,Biotechnology,KCET,2024,54553,76941,13078,17680,162252,144572,Yes
DBIT,Biotechnology,COMEDK,2024,242735,76446,19855,16287,355323,339036,No
BMSCE,Computer Science and Engineering,KCET,2024,80425,75582,10862,22136,189005,166869,No
BNMIT,Information Science and Engineering,KCET,2023,84572,71255,11826,27210,194863,167653,No
VSM,Civil Engineering,KCET,2023,70411,73373,11750,29577,185111,155534,No
JSSSTU,Mechanical Engineering,COMEDK,2024,185919,61238,17424,22857,287438,264581,No
KSIT,Civil Engineering,COMEDK,2023,192000,78886,12509,13548,296943,283395,No
PESU,Electrical and Electronics Engineering,COMEDK,2024,217847,93772,14583,25910,352112,326202,Yes
MVJCE,Computer Science and Engineering,KCET,2024,77222,62703,18024,28465,186414,157949,Yes
BITM,Chemical Engineering,KCET,2024,57562,61615,8160,13917,141254,127337,Yes
SCEM,Electronics and Communication Engineering,KCET,2024,71380,66724,10575,10622,159301,148679,Yes
AITM,Aerospace Engineering,COMEDK,2023,174638,93305,19150,25115,312208,287093,No
BMSIT,Computer Science and Engineering,KCET,2024,83043,70848,12620,13819,180330,166511,No
SJBCE,Mechanical Engineering,COMEDK,2023,227006,60254,11365,10584,309209,298625,No
KLSGIT,Biotechnology,COMEDK,2023,177664,69418,8030,10911,266023,255112,No
SDMCET,Civil Engineering,COMEDK,2023,197474,60189,15150,27585,300398,272813,Yes
KLSGIT,Data Science,KCET,2023,65831,87392,8614,24733,186570,161837,Yes
AIT,Computer Science and Engineering,KCET,2023,82469,66710,12057,17130,178366,161236,No
AITM,Electrical and Electronics Engineering,KCET,2023,84801,94547,14641,13790,207779,193989,Yes
NMIT,Artificial Intelligence and Data Science,COMEDK,2024,175356,79755,16497,22267,293875,271608,Yes
NHCE,Mechanical Engineering,COMEDK,2024,183225,79829,9949,27883,300886,273003,Yes
PESCE,Chemical Engineering,KCET,2023,50438,68577,12743,25822,157580,131758,Yes
GIT,Aerospace Engineering,COMEDK,2023,220384,63388,9846,27199,320817,293618,No
VIT,Artificial Intelligence and Data Science,COMEDK,2024,214184,85390,8621,10418,318613,308195,No
JIT,Electrical and Electronics Engineering,COMEDK,2024,192407,82320,10019,20250,304996,284746,No
BNMIT,Robotics and Automation Engineering,COMEDK,2023,242394,78055,11830,22500,354779,332279,Yes
AEC,Biotechnology,COMEDK,2024,168624,63475,15043,15786,262928,247142,No
BNMIT,Electronics and Communication Engineering,COMEDK,2023,223401,85983,13394,15012,337790,322778,No
VVCE,Information Science and Engineering,COMEDK,2024,181400,79428,18295,25156,304279,279123,Yes
VIT,Electronics and Communication Engineering,KCET,2024,83071,84193,12774,13447,193485,180038,Yes
HKBK,Civil Engineering,KCET,2023,77778,61316,18386,26305,183785,157480,Yes
MSRIT,Computer Science and Engineering,KCET,2023,54171,87198,19402,23464,184235,160771,Yes
NIE,Data Science,KCET,2024,52959,64039,14177,20874,152049,131175,No
SIT,Electrical and Electronics Engineering,COMEDK,2023,164210,61515,8801,20809,255335,234526,Yes
PRES,Information Science and Engineering,COMEDK,2024,177222,69748,9219,15802,271991,256189,Yes
KLSGIT,Robotics and Automation Engineering,COMEDK,2024,174176,92295,11466,12221,290158,277937,Yes
VIT,Electrical and Electronics Engineering,COMEDK,2023,220040,63569,18893,20312,322814,302502,Yes
MVJCE,Electrical and Electronics Engineering,COMEDK,2024,185951,68761,9246,19077,283035,263958,Yes
PRES,Information Science and Engineering,COMEDK,2023,210414,78728,15070,21483,325695,304212,No
KLEIT,Artificial Intelligence and Data Science,COMEDK,2023,188193,83055,18026,12578,301852,289274,Yes
EastPoint,Data Science,KCET,2023,68460,74705,12039,29321,184525,155204,Yes
RNSIT,Electronics and Communication Engineering,COMEDK,2023,171089,75445,11216,14805,272555,257750,No
BMIT,Biotechnology,COMEDK,2023,164255,66827,15186,14742,261010,246268,No
SJBCE,Artificial Intelligence and Data Science,KCET,2024,61615,83187,19431,20449,184682,164233,Yes
EastPoint,Robotics and Automation Engineering,COMEDK,2023,162784,69677,17724,24975,275160,250185,Yes
KLSGIT,Artificial Intelligence and Data Science,KCET,2023,52426,93956,8011,25908,180301,154393,No
VemanaIT,Robotics and Automation Engineering,COMEDK,2023,245133,62063,13576,18366,339138,320772,No
PRES,Data Science,KCET,2024,83078,61688,18427,14805,177998,163193,No
SIT,Biotechnology,COMEDK,2023,178997,76329,15521,25560,296407,270847,No
AIT,Civil Engineering,KCET,2023,51112,64283,14796,23995,154186,130191,Yes
SDMCET,Robotics and Automation Engineering,COMEDK,2024,188231,72099,9050,12820,282200,269380,No
BMIT,Biotechnology,KCET,2023,52032,71587,16070,13273,152962,139689,Yes
SJBCE,Robotics and Automation Engineering,KCET,2024,76246,75915,13580,29443,195184,165741,No
AEC,Mechanical Engineering,KCET,2023,52030,76035,17595,19061,164721,145660,No
VemanaIT,Civil Engineering,COMEDK,2024,186505,79484,12921,13014,291924,278910,No
EastPoint,Biotechnology,COMEDK,2024,183552,62435,14316,20901,281204,260303,No
CITGubbi,Civil Engineering,COMEDK,2024,215961,85300,13097,14082,328440,314358,No
DSATM,Information Science and Engineering,COMEDK,2023,227029,62822,19649,12274,321774,309500,Yes
DSATM,Robotics and Automation Engineering,COMEDK,2023,175953,89642,19864,28306,313765,285459,No
DSATM,Civil Engineering,COMEDK,2023,227323,90785,10480,12915,341503,328588,No
KSIT,Computer Science and Engineering,COMEDK,2024,166759,90299,16460,26743,300261,273518,No
EastPoint,Mechanical Engineering,KCET,2023,65922,71506,10881,19256,167565,148309,No
VVIT,Biotechnology,COMEDK,2023,195913,74876,19352,23765,313906,290141,Yes
KLEIT,Artificial Intelligence and Data Science,KCET,2024,83565,60501,10831,26724,181621,154897,Yes
ACU,Data Science,KCET,2023,81215,79662,11078,15833,187788,171955,Yes
UVCE,Information Science and Engineering,KCET,2024,66335,65025,15281,19824,166465,146641,Yes
RVUNIV,Electronics and Communication Engineering,COMEDK,2024,219924,75800,8929,21102,325755,304653,Yes
VVIT,Mechanical Engineering,KCET,2023,75729,80239,14360,24913,195241,170328,Yes
SJBCE,Artificial Intelligence and Data Science,COMEDK,2023,211906,94556,9308,24204,339974,315770,No
ACU,Aerospace Engineering,KCET,2023,70004,85050,12871,15745,183670,167925,No
AECMandya,Biotechnology,KCET,2024,67266,78979,15502,18692,180439,161747,Yes
GMIT,Information Science and Engineering,COMEDK,2023,174315,68982,10411,23863,277571,253708,No
BMSCE,Civil Engineering,KCET,2024,55338,74648,17205,16521,163712,147191,Yes
AECMandya,Civil Engineering,COMEDK,2023,243034,94077,18666,29814,385591,355777,Yes
MVJCE,Computer Science and Engineering,COMEDK,2023,222097,63283,9412,10432,305224,294792,Yes
AITM,Chemical Engineering,KCET,2023,78082,80411,10213,15772,184478,168706,No
RVCE,Biotechnology,COMEDK,2024,246771,66580,15767,21794,350912,329118,Yes
NMIT,Data Science,KCET,2023,65471,91398,18317,15399,190585,175186,No
PRES,Civil Engineering,COMEDK,2023,224953,77446,13235,22081,337715,315634,No
RAIT,Chemical Engineering,COMEDK,2023,165293,82213,8376,25234,281116,255882,Yes
AEC,Mechanical Engineering,COMEDK,2023,244460,68821,15933,29091,358305,329214,Yes
UVCE,Chemical Engineering,KCET,2024,57410,64879,15082,28973,166344,137371,No
SJBCE,Computer Science and Engineering,COMEDK,2023,244584,66397,9351,21697,342029,320332,No
EastPoint,Mechanical Engineering,KCET,2023,55725,94333,10123,24325,184506,160181,No
SJBCE,Mechanical Engineering,COMEDK,2024,183954,67627,19263,23595,294439,270844,Yes
EastPoint,Artificial Intelligence and Data Science,KCET,2023,72631,72254,13174,24794,182853,158059,Yes
RAIT,Biotechnology,COMEDK,2023,172046,73547,11413,27195,284201,257006,No
DSCE,Information Science and Engineering,KCET,2023,54913,73355,9455,12989,150712,137723,No
NHCE,Information Science and Engineering,COMEDK,2023,230821,82073,12106,25668,350668,325000,Yes
RNSIT,Chemical Engineering,COMEDK,2023,175438,66112,9666,17711,268927,251216,Yes
YKCE,Information Science and Engineering,COMEDK,2024,220652,74988,12402,27302,335344,308042,No
GIT,Computer Science and Engineering,KCET,2024,65085,65670,17284,12365,160404,148039,No
SJBIT,Data Science,KCET,2023,74637,68349,10407,29602,182995,153393,No
VemanaIT,Robotics and Automation Engineering,KCET,2024,81656,94969,18672,20557,215854,195297,Yes
KLEIT,Electronics and Communication Engineering,KCET,2023,54102,63767,11441,13452,142762,129310,Yes
GIT,Artificial Intelligence and Data Science,KCET,2023,56558,79766,15349,13249,164922,151673,Yes
VIT,Data Science,COMEDK,2024,203911,85376,18738,12146,320171,308025,Yes
GIT,Artificial Intelligence and Data Science,KCET,2024,77051,77775,12101,28992,195919,166927,Yes
AECMandya,Mechanical Engineering,KCET,2023,71982,89342,18536,16353,196213,179860,No
VemanaIT,Computer Science and Engineering,KCET,2023,54532,72078,10655,19590,156855,137265,No
JNNCE,Data Science,KCET,2023,61973,86370,17487,26774,192604,165830,No
SJBIT,Computer Science and Engineering,COMEDK,2024,217865,71889,15503,24636,329893,305257,No
REVA,Electronics and Communication Engineering,KCET,2024,80319,81070,10327,24892,196608,171716,No
SDMCET,Data Science,KCET,2024,54692,94478,15362,11392,175924,164532,Yes
PESCE,Information Science and Engineering,KCET,2024,51655,85077,18764,10329,165825,155496,Yes
SIT,Electronics and Communication Engineering,COMEDK,2023,220325,75638,18352,29416,343731,314315,Yes
VVIT,Robotics and Automation Engineering,KCET,2023,68123,72473,18627,16853,176076,159223,Yes
SITM,Aerospace Engineering,KCET,2024,66967,65956,9982,24442,167347,142905,No
YKCE,Data Science,COMEDK,2024,192710,76469,9523,26059,304761,278702,Yes
VVIT,Electrical and Electronics Engineering,KCET,2023,81401,86838,10468,11858,190565,178707,No
JNNCE,Electrical and Electronics Engineering,KCET,2024,50586,62839,13164,12373,138962,126589,Yes
SDMCET,Information Science and Engineering,KCET,2024,76883,92151,13683,10949,193666,182717,No
BITM,Electrical and Electronics Engineering,COMEDK,2023,168920,81345,8318,24976,283559,258583,Yes
KLEIT,Civil Engineering,COMEDK,2024,217404,67681,9037,29264,323386,294122,No
SITM,Data Science,COMEDK,2023,174638,93679,12451,26604,307372,280768,No
SJBIT,Biotechnology,COMEDK,2023,248475,61521,8598,11314,329908,318594,Yes
HKBK,Chemical Engineering,COMEDK,2023,209753,76771,8519,29149,324192,295043,No
GIT,Electronics and Communication Engineering,KCET,2024,75264,66436,10558,17125,169383,152258,Yes
NHCE,Aerospace Engineering,COMEDK,2024,234417,88985,11551,29894,364847,334953,No
RNSIT,Information Science and Engineering,COMEDK,2024,246643,94304,16220,18946,376113,357167,No
RAIT,Electronics and Communication Engineering,COMEDK,2024,210118,73949,15179,19930,319176,299246,Yes
VemanaIT,Civil Engineering,KCET,2024,64707,72538,11042,11023,159310,148287,Yes
NHCE,Artificial Intelligence and Data Science,COMEDK,2023,210334,86500,10539,19916,327289,307373,No
BMSIT,Data Science,KCET,2023,74488,65717,8689,26160,175054,148894,No
SJBIT,Artificial Intelligence and Data Science,COMEDK,2023,221809,70829,14446,11148,318232,307084,No
NCET,Mechanical Engineering,COMEDK,2023,187920,75607,12601,11720,287848,276128,No
PESU,Chemical Engineering,KCET,2023,84960,89191,10797,13497,198445,184948,No
BMSCE,Robotics and Automation Engineering,COMEDK,2024,188623,86286,18659,26822,320390,293568,Yes
PESCE,Electrical and Electronics Engineering,COMEDK,2024,224208,91240,12926,20461,348835,328374,Yes
PRES,Biotechnology,COMEDK,2024,225937,84176,18427,28277,356817,328540,No
PESCE,Robotics and Automation Engineering,COMEDK,2023,240038,85184,10524,25845,361591,335746,No
DSATM,Biotechnology,COMEDK,2023,170693,93644,15082,15559,294978,279419,No
SJBCE,Computer Science and Engineering,COMEDK,2024,163911,71734,10092,23445,269182,245737,No
MVJCE,Information Science and Engineering,COMEDK,2024,198923,63526,12834,17146,292429,275283,No
JNNCE,Mechanical Engineering,KCET,2024,78590,75394,8467,19398,181849,162451,Yes
BMSIT,Electronics and Communication Engineering,COMEDK,2023,209043,85968,14540,12471,322022,309551,No
BITM,Artificial Intelligence and Data Science,COMEDK,2024,188253,93175,18211,24723,324362,299639,No
AIT,Data Science,KCET,2023,54504,60779,12204,13822,141309,127487,No
BITM,Computer Science and Engineering,COMEDK,2023,233039,68608,9546,20826,332019,311193,No
VVIT,Electronics and Communication Engineering,COMEDK,2024,179083,62449,12641,28364,282537,254173,No
NCET,Electronics and Communication Engineering,KCET,2024,58180,79426,16837,12581,167024,154443,No
MSRIT,Electronics and Communication Engineering,COMEDK,2024,162886,61756,12885,20850,258377,237527,No
JNNCE,Data Science,KCET,2024,72236,76459,14168,19463,182326,162863,Yes
UVCE,Mechanical Engineering,COMEDK,2024,242752,80460,16250,14066,353528,339462,No
SJBCE,Data Science,KCET,2024,52725,74903,17066,26436,171130,144694,No
PESU,Electronics and Communication Engineering,COMEDK,2024,172108,78116,12701,22273,285198,262925,Yes
ACU,Information Science and Engineering,COMEDK,2024,222949,94936,14480,19998,352363,332365,No
RAIT,Electrical and Electronics Engineering,COMEDK,2024,207881,67638,11806,25336,312661,287325,No
NCET,Robotics and Automation Engineering,KCET,2023,73662,93583,19183,15908,202336,186428,Yes
RVUNIV,Electronics and Communication Engineering,COMEDK,2023,177760,70156,15892,14224,278032,263808,Yes
PRES,Civil Engineering,COMEDK,2024,182744,94679,15413,19881,312717,292836,Yes
HKBK,Mechanical Engineering,KCET,2024,66233,63717,9721,19525,159196,139671,No
UVCE,Information Science and Engineering,KCET,2023,58238,75417,18720,18990,171365,152375,No
PESU,Information Science and Engineering,KCET,2023,76467,85973,18085,29586,210111,180525,No
NHCE,Civil Engineering,COMEDK,2023,172670,87923,18209,23702,302504,278802,Yes
VemanaIT,Computer Science and Engineering,COMEDK,2024,206781,87289,19259,12498,325827,313329,Yes
SDMCET,Information Science and Engineering,KCET,2023,76220,93701,18589,25887,214397,188510,No
NCET,Electronics and Communication Engineering,KCET,2024,84699,63508,17689,22314,188210,165896,Yes
DBIT,Artificial Intelligence and Data Science,COMEDK,2023,185002,68278,9540,23300,286120,262820,Yes
VVCE,Electrical and Electronics Engineering,COMEDK,2024,237354,70449,19548,17983,345334,327351,No
BMSCE,Robotics and Automation Engineering,COMEDK,2023,172802,79993,13355,28890,295040,266150,No
ACU,Mechanical Engineering,COMEDK,2024,221886,61886,10726,20444,314942,294498,No
RAIT,Chemical Engineering,KCET,2024,68569,84292,10500,11789,175150,163361,No
BMIT,Civil Engineering,COMEDK,2024,201768,85907,9455,18267,315397,297130,Yes
VIT,Robotics and Automation Engineering,KCET,2024,56777,85803,8147,18475,169202,150727,Yes
BIT,Information Science and Engineering,KCET,2024,68862,93533,18967,11226,192588,181362,No
RVCE,Chemical Engineering,KCET,2023,68264,84409,8694,25410,186777,161367,No
DBIT,Data Science,KCET,2024,64967,61360,16833,21869,165029,143160,Yes
EastPoint,Biotechnology,KCET,2024,79207,88263,14445,17158,199073,181915,No
NHCE,Artificial Intelligence and Data Science,COMEDK,2023,229470,71728,17638,24505,343341,318836,No
MVJCE,Electrical and Electronics Engineering,KCET,2024,73766,72031,16778,10219,172794,162575,No
CMRIT,Mechanical Engineering,KCET,2023,76510,79237,16616,11355,183718,172363,No
AECMandya,Electronics and Communication Engineering,KCET,2024,79178,81506,13742,27436,201862,174426,Yes
HKBK,Information Science and Engineering,KCET,2024,52460,77679,8336,11747,150222,138475,Yes
REVA,Information Science and Engineering,KCET,2024,59351,70644,18006,21170,169171,148001,No
AEC,Artificial Intelligence and Data Science,KCET,2023,67693,67353,17340,14572,166958,152386,Yes
MSRIT,Biotechnology,COMEDK,2023,190061,71298,18792,17354,297505,280151,Yes
AIT,Robotics and Automation Engineering,COMEDK,2024,190091,74988,11733,14260,291072,276812,Yes
NHCE,Mechanical Engineering,KCET,2024,53860,88102,17843,14918,174723,159805,No
SJBCE,Electronics and Communication Engineering,COMEDK,2023,179179,71454,11190,19758,281581,261823,Yes
JIT,Artificial Intelligence and Data Science,COMEDK,2024,237666,87565,10771,15933,351935,336002,No
AEC,Data Science,KCET,2024,65255,60828,16165,24599,166847,142248,No
SDMCET,Mechanical Engineering,KCET,2023,78724,84366,13199,16255,192544,176289,No
PRES,Civil Engineering,COMEDK,2024,199524,70915,17349,28955,316743,287788,Yes
YKCE,Artificial Intelligence and Data Science,KCET,2024,71468,68488,16858,23265,180079,156814,No
JIT,Electronics and Communication Engineering,COMEDK,2024,198574,68106,8410,10195,285285,275090,No
HKBK,Artificial Intelligence and Data Science,COMEDK,2023,248487,72684,18474,12540,352185,339645,Yes
AEC,Robotics and Automation Engineering,KCET,2023,64160,82858,10341,20443,177802,157359,Yes
HKBK,Chemical Engineering,KCET,2024,66988,69719,9858,26967,173532,146565,No
AECMandya,Chemical Engineering,KCET,2023,73970,70713,12692,22785,180160,157375,Yes
BIT,Biotechnology,KCET,2023,70138,66012,19799,24727,180676,155949,Yes
BMIT,Information Science and Engineering,COMEDK,2023,219263,61650,16968,19207,317088,297881,No
MSRIT,Computer Science and Engineering,COMEDK,2024,168471,66128,18891,21573,275063,253490,Yes
NMIT,Artificial Intelligence and Data Science,KCET,2023,66136,65678,8707,29205,169726,140521,No
PRES,Electronics and Communication Engineering,KCET,2023,76702,69857,14432,27457,188448,160991,Yes
UVCE,Data Science,KCET,2023,72298,92098,19513,15502,199411,183909,Yes
RNSIT,Information Science and Engineering,COMEDK,2023,179411,62197,19775,18944,280327,261383,No
BIT,Artificial Intelligence and Data Science,KCET,2024,52278,66047,10466,26478,155269,128791,No
ACU,Artificial Intelligence and Data Science,COMEDK,2023,161414,75156,11383,22109,270062,247953,Yes
SDMCET,Artificial Intelligence and Data Science,COMEDK,2023,171089,77616,12474,28766,289945,261179,Yes
BMSIT,Information Science and Engineering,COMEDK,2023,185399,67651,10359,10241,273650,263409,No
SDMIT,Aerospace Engineering,KCET,2023,68945,89458,12861,12450,183714,171264,Yes
BMSCE,Electrical and Electronics Engineering,COMEDK,2024,167344,94050,9940,20886,292220,271334,No
BIT,Robotics and Automation Engineering,COMEDK,2023,235635,62351,13842,19503,331331,311828,No
NMIT,Data Science,KCET,2024,72203,94100,8943,20416,195662,175246,Yes
HKBK,Electrical and Electronics Engineering,COMEDK,2023,248930,78925,18806,21751,368412,346661,No
PRES,Robotics and Automation Engineering,KCET,2023,56549,80419,10785,17195,164948,147753,No
PESU,Electrical and Electronics Engineering,COMEDK,2024,238235,70698,16799,21683,347415,325732,Yes
AITM,Data Science,COMEDK,2023,175819,63900,14483,10355,264557,254202,No
DBIT,Information Science and Engineering,COMEDK,2024,164357,72327,19417,25516,281617,256101,Yes
SDMIT,Data Science,KCET,2024,75083,83691,18648,10064,187486,177422,No
DSCE,Electrical and Electronics Engineering,KCET,2024,55469,65213,13275,14729,148686,133957,Yes
SCEM,Artificial Intelligence and Data Science,KCET,2024,63117,61850,8537,28204,161708,133504,No
CITGubbi,Artificial Intelligence and Data Science,COMEDK,2024,160798,69995,8006,17013,255812,238799,No
NIE,Biotechnology,COMEDK,2023,196569,85355,10489,11527,303940,292413,Yes
SIT,Electronics and Communication Engineering,KCET,2024,57526,84184,14434,23048,179192,156144,No
SDMIT,Aerospace Engineering,COMEDK,2023,174515,60348,17336,26503,278702,252199,Yes
YKCE,Electrical and Electronics Engineering,COMEDK,2024,169323,87765,17904,24548,299540,274992,No
PESCE,Civil Engineering,COMEDK,2023,171437,85198,19621,15991,292247,276256,Yes
YKCE,Mechanical Engineering,COMEDK,2023,228134,66852,18879,11567,325432,313865,Yes
SDMCET,Aerospace Engineering,COMEDK,2023,184584,86039,17054,22828,310505,287677,No
SIT,Data Science,COMEDK,2024,239364,67913,19263,24398,350938,326540,No
BNMIT,Chemical Engineering,COMEDK,2023,210624,94158,17258,14349,336389,322040,No
SITM,Civil Engineering,KCET,2023,59536,72762,14232,20916,167446,146530,No
BITM,Computer Science and Engineering,KCET,2024,62508,89692,18749,12416,183365,170949,No
SJBIT,Information Science and Engineering,KCET,2023,68013,78488,17124,26697,190322,163625,Yes
BMSCE,Computer Science and Engineering,COMEDK,2023,180412,91822,10980,22689,305903,283214,Yes
AECMandya,Information Science and Engineering,KCET,2024,54812,94397,10039,25049,184297,159248,No
EastPoint,Aerospace Engineering,COMEDK,2023,194384,94277,13884,26892,329437,302545,No
NMIT,Electrical and Electronics Engineering,COMEDK,2024,216875,88263,14825,10318,330281,319963,Yes
YKCE,Aerospace Engineering,COMEDK,2023,213466,82559,14128,15378,325531,310153,No
GIT,Data Science,KCET,2024,65470,72790,16184,29111,183555,154444,No
KLEIT,Computer Science and Engineering,COMEDK,2024,247363,70539,12661,16637,347200,330563,No
BNMIT,Computer Science and Engineering,COMEDK,2024,163437,75841,8211,26660,274149,247489,Yes
YKCE,Biotechnology,COMEDK,2023,165879,62152,9398,12769,250198,237429,No
DBIT,Computer Science and Engineering,KCET,2024,51137,87069,9775,23173,171154,147981,No
UVCE,Electronics and Communication Engineering,COMEDK,2024,235457,87989,16434,23325,363205,339880,Yes
NHCE,Electronics and Communication Engineering,KCET,2023,63450,85691,19072,20489,188702,168213,No
KLSGIT,Data Science,COMEDK,2024,162975,72752,10632,25302,271661,246359,No
NCET,Data Science,KCET,2023,79601,85472,9933,11216,186222,175006,No
AEC,Computer Science and Engineering,COMEDK,2023,231631,90325,8341,14353,344650,330297,Yes
VVCE,Data Science,KCET,2023,79728,72081,15061,10243,177113,166870,Yes
CMRIT,Robotics and Automation Engineering,COMEDK,2023,225869,62331,13791,29976,331967,301991,Yes
ACU,Information Science and Engineering,COMEDK,2023,192984,60302,10750,14939,278975,264036,No
ACU,Electronics and Communication Engineering,KCET,2024,50861,68822,18253,29194,167130,137936,No
BNMIT,Electronics and Communication Engineering,KCET,2024,67532,88260,15160,25876,196828,170952,Yes
RVCE,Aerospace Engineering,COMEDK,2023,205435,68234,16233,12318,302220,289902,No
AITM,Data Science,KCET,2024,61312,72633,16019,14523,164487,149964,Yes
UVCE,Data Science,KCET,2023,70164,77695,9814,28741,186414,157673,Yes
SJBIT,Biotechnology,COMEDK,2024,193416,76937,18216,22617,311186,288569,No
KSIT,Information Science and Engineering,KCET,2023,54983,76471,9484,24858,165796,140938,Yes
PRES,Civil Engineering,COMEDK,2023,239003,86321,9618,14333,349275,334942,No
ACU,Chemical Engineering,KCET,2023,65900,88412,10109,29676,194097,164421,Yes
SCEM,Electronics and Communication Engineering,KCET,2024,73595,91030,19460,29377,213462,184085,Yes
PESCE,Information Science and Engineering,COMEDK,2024,242194,91820,19052,27113,380179,353066,Yes
KLEIT,Electronics and Communication Engineering,KCET,2023,63292,88127,19195,11678,182292,170614,Yes
BNMIT,Electronics and Communication Engineering,COMEDK,2024,208305,64638,12045,12001,296989,284988,Yes
AIT,Computer Science and Engineering,KCET,2024,64039,69331,13288,11375,158033,146658,No
SJBCE,Mechanical Engineering,COMEDK,2024,176934,86690,16300,17266,297190,279924,Yes
DSATM,Data Science,KCET,2023,70152,81371,15928,17148,184599,167451,No
VemanaIT,Aerospace Engineering,COMEDK,2023,174143,74576,14377,25406,288502,263096,No
JIT,Electronics and Communication Engineering,COMEDK,2024,243422,60946,8945,17355,330668,313313,No
NMIT,Robotics and Automation Engineering,COMEDK,2023,239075,64021,8778,28469,340343,311874,Yes
SCEM,Biotechnology,KCET,2023,66212,60260,8552,29496,164520,135024,Yes
SDMIT,Chemical Engineering,KCET,2024,59663,79696,19298,21282,179939,158657,Yes
EastPoint,Data Science,COMEDK,2023,194209,64346,16289,29839,304683,274844,No
VVCE,Civil Engineering,COMEDK,2023,233683,62821,9672,13117,319293,306176,No
YKCE,Chemical Engineering,COMEDK,2024,231053,79674,13800,13877,338404,324527,Yes
SCEM,Data Science,KCET,2024,56474,61146,19442,22533,159595,137062,Yes
VemanaIT,Biotechnology,KCET,2024,83135,65624,17253,21082,187094,166012,No
BNMIT,Information Science and Engineering,COMEDK,2023,166647,71848,18370,24110,280975,256865,Yes
AIT,Chemical Engineering,COMEDK,2023,226170,89980,13999,20417,350566,330149,No
NCET,Data Science,KCET,2023,57114,89665,14865,15867,177511,161644,Yes
AECMandya,Aerospace Engineering,COMEDK,2023,185135,87886,13612,14610,301243,286633,No
SIT,Biotechnology,COMEDK,2023,229520,61228,11469,25782,327999,302217,No
BMSIT,Chemical Engineering,COMEDK,2024,228551,68097,10593,26140,333381,307241,Yes
MSRUAS,Information Science and Engineering,KCET,2023,67092,84519,15397,29827,196835,167008,No
BIT,Aerospace Engineering,KCET,2024,57586,78933,12967,29502,178988,149486,No
NMIT,Mechanical Engineering,KCET,2024,62986,94342,19412,26822,203562,176740,No
AIT,Chemical Engineering,COMEDK,2023,167526,61426,12972,21015,262939,241924,Yes
CITGubbi,Robotics and Automation Engineering,COMEDK,2023,200433,78985,12235,11035,302688,291653,No
BMSCE,Information Science and Engineering,KCET,2024,60064,75283,18740,12884,166971,154087,Yes
EastPoint,Data Science,KCET,2023,53975,74592,13123,23511,165201,141690,Yes
SDMCET,Electronics and Communication Engineering,COMEDK,2023,170013,81867,19081,20128,291089,270961,Yes
ACU,Chemical Engineering,COMEDK,2023,186920,90492,17714,29320,324446,295126,No
BNMIT,Computer Science and Engineering,COMEDK,2023,217883,83113,10201,18846,330043,311197,No
KLEIT,Robotics and Automation Engineering,KCET,2024,71391,60749,13036,28539,173715,145176,Yes
PESCE,Information Science and Engineering,KCET,2024,56559,77137,19998,27544,181238,153694,Yes
BMSIT,Aerospace Engineering,COMEDK,2024,184673,75727,19230,22515,302145,279630,Yes
SJBCE,Electronics and Communication Engineering,KCET,2023,70534,94266,8497,24195,197492,173297,Yes
SJBIT,Aerospace Engineering,COMEDK,2023,166609,77990,10261,27831,282691,254860,Yes
PESU,Mechanical Engineering,KCET,2023,69447,86191,15156,28148,198942,170794,No
DSCE,Computer Science and Engineering,KCET,2023,83058,80868,13050,24570,201546,176976,No
MSRUAS,Information Science and Engineering,COMEDK,2023,219720,94166,17092,29493,360471,330978,No
KLEIT,Robotics and Automation Engineering,KCET,2024,61689,70684,16314,21109,169796,148687,Yes
DSATM,Aerospace Engineering,COMEDK,2023,212362,74209,15184,18603,320358,301755,No
VVCE,Chemical Engineering,COMEDK,2024,200569,72402,15124,18601,306696,288095,Yes
YKCE,Civil Engineering,COMEDK,2023,236065,60493,9386,11340,317284,305944,No
CMRIT,Electrical and Electronics Engineering,COMEDK,2023,198132,89706,15591,19632,323061,303429,No
BMSCE,Electrical and Electronics Engineering,COMEDK,2024,230639,66431,15957,24085,337112,313027,Yes
SITM,Computer Science and Engineering,COMEDK,2023,204448,69588,12018,24848,310902,286054,Yes
GIT,Artificial Intelligence and Data Science,KCET,2023,78761,89720,11862,22788,203131,180343,Yes
MSRIT,Information Science and Engineering,KCET,2024,73623,60970,18366,27785,180744,152959,No
REVA,Information Science and Engineering,COMEDK,2024,187688,64101,9511,19395,280695,261300,Yes
VemanaIT,Chemical Engineering,KCET,2024,59125,84221,10732,25996,180074,154078,Yes
NCET,Robotics and Automation Engineering,KCET,2023,65125,66485,12331,27431,171372,143941,Yes
BITM,Data Science,KCET,2024,66787,78048,13532,17674,176041,158367,No
SDMIT,Electronics and Communication Engineering,COMEDK,2024,182090,84407,8694,18869,294060,275191,Yes
VVIT,Computer Science and Engineering,COMEDK,2024,161659,92573,10456,10259,274947,264688,No
MVJCE,Electronics and Communication Engineering,KCET,2023,63465,71011,13394,23295,171165,147870,Yes
AIT,Chemical Engineering,COMEDK,2023,184255,94746,12630,10625,302256,291631,Yes
CMRIT,Robotics and Automation Engineering,KCET,2023,53234,83801,13091,17280,167406,150126,No
SJBCE,Biotechnology,COMEDK,2024,206965,88449,13576,16821,325811,308990,No
NMIT,Information Science and Engineering,KCET,2024,56719,71907,15043,15659,159328,143669,Yes
SDMIT,Electronics and Communication Engineering,COMEDK,2024,227098,74262,16287,20857,338504,317647,No
PRES,Mechanical Engineering,KCET,2024,66366,71628,15676,21675,175345,153670,Yes
EastPoint,Chemical Engineering,KCET,2024,59886,94881,16457,15413,186637,171224,Yes
MSRUAS,Artificial Intelligence and Data Science,KCET,2023,51581,73399,14133,23220,162333,139113,No
CITGubbi,Mechanical Engineering,COMEDK,2024,224925,78399,19803,22007,345134,323127,No
KLSGIT,Computer Science and Engineering,KCET,2024,65388,87717,12927,17740,183772,166032,Yes
HKBK,Civil Engineering,COMEDK,2023,220013,83481,16590,29504,349588,320084,Yes
NCET,Information Science and Engineering,COMEDK,2024,189351,83483,20000,17660,310494,292834,No
MSRIT,Electrical and Electronics Engineering,COMEDK,2023,219638,79020,19356,19272,337286,318014,No
SDMIT,Biotechnology,KCET,2024,83360,65277,8214,19936,176787,156851,Yes
RIT,Robotics and Automation Engineering,COMEDK,2024,207467,87292,11694,29358,335811,306453,Yes
AECMandya,Electrical and Electronics Engineering,COMEDK,2024,228195,77875,16441,21430,343941,322511,No
SIT,Biotechnology,KCET,2023,72590,94775,16473,17245,201083,183838,Yes
BMSIT,Data Science,COMEDK,2024,204721,86947,13306,25247,330221,304974,No
CMRIT,Chemical Engineering,KCET,2024,82946,86887,10207,26072,206112,180040,No
VemanaIT,Electronics and Communication Engineering,COMEDK,2024,167054,65318,18709,29920,281001,251081,No
YKCE,Information Science and Engineering,COMEDK,2024,201200,61451,14197,16477,293325,276848,Yes
PRES,Mechanical Engineering,KCET,2024,55363,81779,9046,13180,159368,146188,No
RVUNIV,Electrical and Electronics Engineering,COMEDK,2024,185295,68766,14774,27225,296060,268835,Yes
BMSIT,Mechanical Engineering,COMEDK,2024,206393,60307,12448,19577,298725,279148,No
PESCE,Electronics and Communication Engineering,COMEDK,2024,161986,72877,10215,10323,255401,245078,Yes
SCEM,Data Science,COMEDK,2024,204960,84723,17783,14469,321935,307466,No
NMIT,Robotics and Automation Engineering,KCET,2024,78570,62151,10677,28622,180020,151398,Yes
GMIT,Artificial Intelligence and Data Science,COMEDK,2024,180595,93571,15207,19605,308978,289373,Yes
GIT,Electronics and Communication Engineering,KCET,2024,74526,66702,13078,28510,182816,154306,No
SIT,Electrical and Electronics Engineering,KCET,2024,77949,85082,14106,16117,193254,177137,No
NMIT,Robotics and Automation Engineering,KCET,2024,62630,81661,16246,19738,180275,160537,Yes
RVCE,Chemical Engineering,COMEDK,2024,196664,70224,12836,19799,299523,279724,Yes
ACU,Civil Engineering,COMEDK,2024,205197,71593,17155,16064,310009,293945,No
NCET,Electrical and Electronics Engineering,COMEDK,2023,222245,80652,15462,10269,328628,318359,No
SJBIT,Aerospace Engineering,KCET,2023,50844,60746,13276,24974,149840,124866,Yes
PESCE,Computer Science and Engineering,KCET,2024,80686,79837,8297,27494,196314,168820,No
GMIT,Electrical and Electronics Engineering,COMEDK,2023,237081,89394,10219,21547,358241,336694,Yes
DrAIT,Information Science and Engineering,COMEDK,2023,189665,62704,13525,25677,291571,265894,Yes
EastPoint,Electrical and Electronics Engineering,COMEDK,2024,230422,82577,14764,25632,353395,327763,Yes
BNMIT,Civil Engineering,COMEDK,2024,180354,92404,8521,24852,306131,281279,Yes
EastPoint,Aerospace Engineering,KCET,2023,71040,65065,12707,11603,160415,148812,No
REVA,Chemical Engineering,COMEDK,2024,191173,88054,12652,25296,317175,291879,Yes
DSATM,Information Science and Engineering,COMEDK,2024,247517,90956,18360,27610,384443,356833,Yes
NMIT,Electronics and Communication Engineering,KCET,2024,78421,90664,16978,28706,214769,186063,Yes
NCET,Electrical and Electronics Engineering,KCET,2024,63969,66489,8651,29486,168595,139109,Yes
BMIT,Electronics and Communication Engineering,COMEDK,2023,222916,66825,16820,11073,317634,306561,No
REVA,Electrical and Electronics Engineering,COMEDK,2024,180797,90680,16418,23752,311647,287895,Yes
KLSGIT,Biotechnology,KCET,2024,54347,60595,15380,24542,154864,130322,No
AITM,Electronics and Communication Engineering,KCET,2023,50298,92628,19525,21039,183490,162451,No
JNNCE,Chemical Engineering,KCET,2023,74679,63333,14234,12254,164500,152246,Yes
PRES,Civil Engineering,KCET,2024,52650,66930,17130,22292,159002,136710,Yes
SITM,Electrical and Electronics Engineering,KCET,2024,51859,81107,15297,13449,161712,148263,Yes
VVCE,Chemical Engineering,KCET,2024,81008,81532,16375,22268,201183,178915,No
BMSIT,Aerospace Engineering,COMEDK,2024,242143,76059,8531,28364,355097,326733,Yes
AEC,Information Science and Engineering,KCET,2023,80269,62830,14061,26549,183709,157160,Yes
BMIT,Mechanical Engineering,COMEDK,2023,169836,92397,12556,29196,303985,274789,Yes
VVIT,Computer Science and Engineering,KCET,2023,66253,60531,9616,23828,160228,136400,No
PESU,Mechanical Engineering,KCET,2024,68918,70608,9356,24206,173088,148882,No
MVJCE,Information Science and Engineering,COMEDK,2023,222491,74529,8931,13750,319701,305951,No
NCET,Mechanical Engineering,KCET,2024,67974,88244,19171,22534,197923,175389,No
CITGubbi,Electrical and Electronics Engineering,KCET,2024,65689,86409,15827,23631,191556,167925,Yes
PESU,Robotics and Automation Engineering,KCET,2023,52954,71867,17205,14447,156473,142026,No
BMIT,Robotics and Automation Engineering,KCET,2023,71435,70578,8498,22585,173096,150511,No
SJBCE,Mechanical Engineering,KCET,2023,53730,92113,9895,10924,166662,155738,Yes
DSATM,Mechanical Engineering,KCET,2023,70036,92312,12248,24466,199062,174596,No
BMSCE,Computer Science and Engineering,KCET,2024,70507,60418,15350,15769,162044,146275,No
AEC,Chemical Engineering,COMEDK,2024,169179,87642,17662,10480,284963,274483,No
HKBK,Civil Engineering,COMEDK,2023,174025,76790,19452,13910,284177,270267,No
BITM,Electrical and Electronics Engineering,COMEDK,2024,204885,88058,18305,21437,332685,311248,Yes
SCEM,Civil Engineering,COMEDK,2023,170259,77224,9537,17151,274171,257020,Yes
KLEIT,Electronics and Communication Engineering,KCET,2024,74595,91355,16515,17313,199778,182465,Yes
BMIT,Robotics and Automation Engineering,COMEDK,2023,210521,81557,10398,27185,329661,302476,Yes
JIT,Data Science,COMEDK,2024,232072,80615,8142,17491,338320,320829,Yes
KLEIT,Data Science,KCET,2024,70981,88296,14235,29436,202948,173512,Yes
SIT,Aerospace Engineering,COMEDK,2023,229724,71545,8526,26039,335834,309795,Yes
MVJCE,Robotics and Automation Engineering,KCET,2024,69946,66328,13652,16333,166259,149926,No
RVCE,Data Science,COMEDK,2023,224587,91966,13151,26509,356213,329704,Yes
VemanaIT,Civil Engineering,COMEDK,2024,200219,78232,10059,15334,303844,288510,No
SJBIT,Artificial Intelligence and Data Science,COMEDK,2023,220816,65261,15231,12238,313546,301308,No
VVCE,Computer Science and Engineering,KCET,2023,66408,66289,13879,13164,159740,146576,No
AIT,Computer Science and Engineering,COMEDK,2023,225445,92478,10557,14688,343168,328480,Yes
SITM,Artificial Intelligence and Data Science,KCET,2023,60520,79139,10498,24909,175066,150157,Yes
BNMIT,Computer Science and Engineering,COMEDK,2023,215910,70432,10144,21092,317578,296486,Yes
SDMCET,Robotics and Automation Engineering,KCET,2024,84198,92623,17304,20549,214674,194125,No
HKBK,Electronics and Communication Engineering,KCET,2024,53326,87845,14584,17171,172926,155755,No
PRES,Information Science and Engineering,KCET,2024,78294,91883,14824,20238,205239,185001,Yes
VVCE,Robotics and Automation Engineering,COMEDK,2023,244423,81335,19139,16622,361519,344897,Yes
VVCE,Civil Engineering,KCET,2024,72213,79183,15978,21012,188386,167374,No
PESCE,Mechanical Engineering,KCET,2023,52701,72564,19694,23993,168952,144959,Yes
HKBK,Information Science and Engineering,KCET,2024,75223,90971,15791,10137,192122,181985,Yes
BMSCE,Information Science and Engineering,KCET,2023,84526,75225,19717,26169,205637,179468,Yes
CMRIT,Robotics and Automation Engineering,COMEDK,2024,224067,69221,9831,17520,320639,303119,No
PESU,Robotics and Automation Engineering,COMEDK,2024,246075,71502,13242,16373,347192,330819,Yes
KLSGIT,Information Science and Engineering,KCET,2024,65686,69801,14702,24753,174942,150189,Yes
SIT,Electronics and Communication Engineering,COMEDK,2023,164674,89142,17822,29160,300798,271638,Yes
SJBCE,Biotechnology,COMEDK,2024,229670,60055,19726,29294,338745,309451,No
SITM,Electronics and Communication Engineering,KCET,2023,60451,74450,18723,10164,163788,153624,Yes
NIE,Robotics and Automation Engineering,COMEDK,2023,231973,64370,9208,21451,327002,305551,No
AEC,Biotechnology,KCET,2023,72841,73542,14398,12790,173571,160781,Yes
BITM,Artificial Intelligence and Data Science,KCET,2023,52422,72871,9158,27368,161819,134451,No
JIT,Data Science,KCET,2023,63872,90955,8157,12589,175573,162984,Yes
JNNCE,Mechanical Engineering,KCET,2023,74950,76407,12541,25832,189730,163898,Yes
AITM,Information Science and Engineering,COMEDK,2023,185054,67493,17835,16012,286394,270382,No
DSCE,Electronics and Communication Engineering,COMEDK,2023,166468,82989,11139,14760,275356,260596,No
RVCE,Aerospace Engineering,KCET,2023,70557,61879,13682,16648,162766,146118,Yes
SJBIT,Chemical Engineering,KCET,2024,77723,88593,11587,20124,198027,177903,No
RNSIT,Civil Engineering,COMEDK,2024,201339,74851,15408,10831,302429,291598,No
RVCE,Civil Engineering,COMEDK,2024,233212,93841,15795,12948,355796,342848,Yes
DSATM,Robotics and Automation Engineering,COMEDK,2024,188633,87457,14567,11652,302309,290657,Yes
RNSIT,Electrical and Electronics Engineering,COMEDK,2024,241137,72423,16634,19600,349794,330194,No
MVJCE,Electronics and Communication Engineering,COMEDK,2024,222396,67331,16085,17596,323408,305812,No
JIT,Computer Science and Engineering,KCET,2024,57364,80847,9112,20304,167627,147323,No
RVCE,Civil Engineering,KCET,2024,79947,88711,14925,17007,200590,183583,No
PESU,Computer Science and Engineering,KCET,2024,69941,65392,8674,21136,165143,144007,Yes
SCEM,Data Science,COMEDK,2023,193690,90281,8778,18294,311043,292749,No
SDMIT,Chemical Engineering,KCET,2023,73233,83165,8832,15835,181065,165230,Yes
DSATM,Data Science,KCET,2024,63378,71966,16209,10827,162380,151553,No
RVCE,Chemical Engineering,COMEDK,2024,188498,71520,13430,14756,288204,273448,Yes
GMIT,Information Science and Engineering,COMEDK,2023,226374,74802,16716,28149,346041,317892,No
BMIT,Robotics and Automation Engineering,COMEDK,2023,218319,86117,11250,17746,333432,315686,Yes
PESCE,Civil Engineering,KCET,2023,81350,62026,17940,20267,181583,161316,Yes
EastPoint,Civil Engineering,KCET,2023,50414,89042,9486,25096,174038,148942,Yes
NCET,Information Science and Engineering,KCET,2024,72480,64372,8264,25220,170336,145116,Yes
PESU,Computer Science and Engineering,COMEDK,2023,164722,63619,12514,11150,252005,240855,Yes
VIT,Robotics and Automation Engineering,KCET,2023,66655,79919,10878,29365,186817,157452,Yes
BMIT,Computer Science and Engineering,KCET,2023,54528,78055,19563,25219,177365,152146,No
VVCE,Biotechnology,KCET,2023,66794,68816,16398,26108,178116,152008,Yes
SITM,Chemical Engineering,KCET,2024,60314,62283,12979,24658,160234,135576,Yes
BIT,Civil Engineering,COMEDK,2024,170524,60567,17969,24205,273265,249060,No
JIT,Aerospace Engineering,KCET,2023,52092,65015,15248,10231,142586,132355,Yes
YKCE,Robotics and Automation Engineering,COMEDK,2024,213490,94347,9818,10946,328601,317655,No
VVCE,Artificial Intelligence and Data Science,KCET,2024,74642,88385,12029,17435,192491,175056,No
KSIT,Electronics and Communication Engineering,COMEDK,2023,238194,83345,11086,15249,347874,332625,Yes
RIT,Aerospace Engineering,KCET,2024,57239,85360,11921,14000,168520,154520,Yes
JSSSTU,Aerospace Engineering,KCET,2024,56390,89544,9054,22982,177970,154988,Yes
AEC,Robotics and Automation Engineering,COMEDK,2024,242422,75401,18719,10212,346754,336542,Yes
PESU,Artificial Intelligence and Data Science,COMEDK,2024,238469,84134,13249,17578,353430,335852,Yes
DSCE,Biotechnology,KCET,2023,77369,87166,19378,16825,200738,183913,No
RNSIT,Chemical Engineering,COMEDK,2024,211389,83966,10834,10652,316841,306189,Yes
RIT,Electronics and Communication Engineering,KCET,2024,63870,61406,18987,27504,171767,144263,No
SDMCET,Information Science and Engineering,COMEDK,2023,211279,61066,13869,16809,303023,286214,No
GIT,Civil Engineering,COMEDK,2023,161281,79588,18210,19343,278422,259079,Yes
DSCE,Electronics and Communication Engineering,COMEDK,2024,233701,74256,10813,22981,341751,318770,No
MSRIT,Mechanical Engineering,COMEDK,2024,223547,91242,11771,11908,338468,326560,Yes
YKCE,Robotics and Automation Engineering,KCET,2024,73686,75241,8306,28713,185946,157233,Yes
SDMCET,Information Science and Engineering,KCET,2023,72477,70296,16285,14863,173921,159058,No
BIT,Biotechnology,KCET,2024,54182,73771,8903,16573,153429,136856,No
SJBCE,Electrical and Electronics Engineering,KCET,2024,54496,72451,11100,26732,164779,138047,No
DrAIT,Information Science and Engineering,KCET,2023,71842,67667,8885,14958,163352,148394,Yes
VSM,Computer Science and Engineering,KCET,2024,78098,77498,19897,22090,197583,175493,No
RVCE,Information Science and Engineering,KCET,2023,53790,67538,13172,25178,159678,134500,Yes
NMIT,Data Science,COMEDK,2024,241117,94609,10814,20249,366789,346540,No
JNNCE,Chemical Engineering,KCET,2023,64401,73940,10342,10805,159488,148683,No
CMRIT,Data Science,KCET,2023,58832,88111,16155,26035,189133,163098,Yes
BMIT,Electrical and Electronics Engineering,COMEDK,2023,164042,70616,11578,13768,260004,246236,Yes
BNMIT,Chemical Engineering,COMEDK,2024,241521,82112,15899,24171,363703,339532,No
JSSSTU,Electrical and Electronics Engineering,KCET,2024,51948,90582,16916,19270,178716,159446,No
NMIT,Robotics and Automation Engineering,KCET,2024,80921,91279,16508,24952,213660,188708,Yes
AECMandya,Artificial Intelligence and Data Science,COMEDK,2024,245720,94450,17031,13650,370851,357201,No
EastPoint,Biotechnology,KCET,2023,77739,68877,9307,14892,170815,155923,No
YKCE,Robotics and Automation Engineering,COMEDK,2023,196197,91018,12691,22352,322258,299906,Yes
VIT,Electrical and Electronics Engineering,COMEDK,2024,201201,61023,10042,14033,286299,272266,Yes
SJBIT,Chemical Engineering,COMEDK,2023,195464,70706,12796,11255,290221,278966,No
RVUNIV,Aerospace Engineering,KCET,2023,79403,70532,11888,14396,176219,161823,No
BNMIT,Civil Engineering,COMEDK,2024,205092,71935,8294,13740,299061,285321,Yes
JSSSTU,Data Science,KCET,2023,63932,74504,13804,19336,171576,152240,No
BITM,Data Science,COMEDK,2024,234341,69637,18012,23914,345904,321990,Yes
GIT,Biotechnology,COMEDK,2023,168365,64208,9085,15492,257150,241658,Yes
PRES,Electrical and Electronics Engineering,COMEDK,2024,191739,61667,9943,10205,273554,263349,Yes
NMIT,Robotics and Automation Engineering,COMEDK,2023,205164,78911,14959,16377,315411,299034,No
YKCE,Aerospace Engineering,KCET,2023,79726,80969,13482,19162,193339,174177,Yes
CMRIT,Information Science and Engineering,KCET,2023,73526,87672,9386,25680,196264,170584,Yes
PESU,Aerospace Engineering,KCET,2023,79101,76721,9217,16766,181805,165039,No
NIE,Information Science and Engineering,COMEDK,2024,206518,75426,16382,12690,311016,298326,Yes
VSM,Aerospace Engineering,KCET,2024,52815,73132,8559,11815,146321,134506,No
SCEM,Electronics and Communication Engineering,KCET,2023,54468,65759,11302,21496,153025,131529,No
YKCE,Electronics and Communication Engineering,KCET,2023,81046,67466,18818,11882,179212,167330,Yes
DSCE,Mechanical Engineering,KCET,2024,82361,60614,14327,23837,181139,157302,No
VemanaIT,Robotics and Automation Engineering,KCET,2023,83643,89347,15209,27798,215997,188199,Yes
SDMCET,Data Science,COMEDK,2024,230111,76887,17569,11773,336340,324567,Yes
SJBCE,Biotechnology,KCET,2024,53206,84912,18236,22927,179281,156354,Yes
GMIT,Chemical Engineering,KCET,2023,73905,65351,12829,20657,172742,152085,Yes
SIT,Aerospace Engineering,COMEDK,2024,169735,92814,15537,19081,297167,278086,Yes
SIT,Aerospace Engineering,COMEDK,2024,201889,92511,12913,28662,335975,307313,Yes
VemanaIT,Electronics and Communication Engineering,COMEDK,2023,166190,76562,14674,10609,268035,257426,No
AITM,Robotics and Automation Engineering,COMEDK,2023,178253,81582,17871,13661,291367,277706,No
DSATM,Data Science,KCET,2023,81630,85921,19939,20858,208348,187490,No
JNNCE,Artificial Intelligence and Data Science,KCET,2023,60337,85858,8533,23709,178437,154728,Yes
JIT,Data Science,COMEDK,2024,202269,72829,9700,23056,307854,284798,Yes
BMSIT,Artificial Intelligence and Data Science,COMEDK,2024,163990,65552,12246,15983,257771,241788,Yes
SDMIT,Electrical and Electronics Engineering,COMEDK,2023,212592,79209,13255,22044,327100,305056,Yes
JIT,Chemical Engineering,KCET,2024,76743,83989,9539,11398,181669,170271,No
BIT,Electronics and Communication Engineering,KCET,2024,69215,61190,8636,18202,157243,139041,No
VemanaIT,Mechanical Engineering,KCET,2024,55185,68322,17763,10187,151457,141270,No
KLEIT,Information Science and Engineering,COMEDK,2024,247675,84449,13403,27117,372644,345527,No
CMRIT,Robotics and Automation Engineering,COMEDK,2024,167661,60087,10917,27136,265801,238665,No
BMIT,Data Science,KCET,2024,53847,71856,8293,13299,147295,133996,Yes
BIT,Biotechnology,COMEDK,2023,201281,89109,14472,16833,321695,304862,Yes
REVA,Electrical and Electronics Engineering,COMEDK,2023,220062,72622,18104,27572,338360,310788,No
AITM,Artificial Intelligence and Data Science,COMEDK,2024,216329,91256,19133,29492,356210,326718,Yes
RNSIT,Information Science and Engineering,COMEDK,2023,200848,89718,18499,29569,338634,309065,Yes
MSRUAS,Information Science and Engineering,COMEDK,2023,219712,76160,19659,19156,334687,315531,Yes
VVCE,Artificial Intelligence and Data Science,KCET,2024,81932,69044,10753,11382,173111,161729,No
HKBK,Chemical Engineering,COMEDK,2024,181606,76177,15476,22790,296049,273259,Yes
CITGubbi,Information Science and Engineering,KCET,2023,81010,65917,10629,23150,180706,157556,Yes
RVCE,Electrical and Electronics Engineering,COMEDK,2024,223105,76469,10493,25922,335989,310067,No
MVJCE,Information Science and Engineering,KCET,2024,74356,91294,14795,12705,193150,180445,Yes
SDMCET,Mechanical Engineering,COMEDK,2024,177218,68981,11460,21960,279619,257659,Yes
AEC,Electrical and Electronics Engineering,COMEDK,2023,169592,89190,11562,28365,298709,270344,Yes
AEC,Chemical Engineering,COMEDK,2023,216130,79814,8637,22390,326971,304581,No
BMSIT,Chemical Engineering,COMEDK,2023,196425,77460,12509,10787,297181,286394,Yes
SDMIT,Computer Science and Engineering,COMEDK,2023,214728,66115,11366,26505,318714,292209,Yes
SDMIT,Chemical Engineering,KCET,2023,66655,77656,9925,12915,167151,154236,No
VSM,Robotics and Automation Engineering,KCET,2024,59921,67311,14694,25905,167831,141926,Yes
DBIT,Data Science,COMEDK,2024,248134,94838,17556,11611,372139,360528,Yes
UVCE,Mechanical Engineering,KCET,2024,74617,69180,13916,19387,177100,157713,Yes
DSATM,Mechanical Engineering,COMEDK,2023,191152,75146,19479,23439,309216,285777,No
AEC,Electrical and Electronics Engineering,KCET,2023,56229,85032,14790,24687,180738,156051,Yes
SJBCE,Information Science and Engineering,COMEDK,2024,168518,84673,11960,13091,278242,265151,No
VemanaIT,Biotechnology,COMEDK,2024,247330,60910,12208,18579,339027,320448,No
SDMIT,Robotics and Automation Engineering,KCET,2024,69975,72945,9482,26225,178627,152402,Yes
SJBCE,Aerospace Engineering,KCET,2024,50803,64240,16014,28178,159235,131057,No
ACU,Robotics and Automation Engineering,COMEDK,2024,219454,94057,9707,14653,337871,323218,No
PRES,Robotics and Automation Engineering,COMEDK,2024,230435,81224,10161,10671,332491,321820,No
JSSSTU,Electronics and Communication Engineering,KCET,2024,69206,62797,11384,25414,168801,143387,No
RIT,Computer Science and Engineering,COMEDK,2024,180982,71610,13251,12007,277850,265843,Yes
RIT,Electronics and Communication Engineering,COMEDK,2024,237790,91182,11242,25878,366092,340214,No
SJBIT,Biotechnology,KCET,2024,65310,62214,16992,20901,165417,144516,Yes
DBIT,Information Science and Engineering,KCET,2024,70511,62520,8579,26474,168084,141610,No
UVCE,Biotechnology,KCET,2023,59234,92837,13776,26195,192042,165847,Yes
PRES,Mechanical Engineering,COMEDK,2023,162088,86407,8509,23120,280124,257004,Yes
GMIT,Data Science,KCET,2024,56890,80869,12121,17552,167432,149880,Yes
GIT,Civil Engineering,KCET,2024,82628,62262,10017,14204,169111,154907,Yes
VemanaIT,Electrical and Electronics Engineering,COMEDK,2023,199057,90898,8855,10437,309247,298810,No
CITGubbi,Information Science and Engineering,KCET,2024,62652,69745,8914,12902,154213,141311,No
DBIT,Civil Engineering,KCET,2023,50542,90964,9936,11492,162934,151442,Yes
SITM,Aerospace Engineering,COMEDK,2023,246054,87568,9995,10996,354613,343617,No
VVCE,Artificial Intelligence and Data Science,COMEDK,2023,219763,62309,14599,17113,313784,296671,No
VSM,Biotechnology,KCET,2024,68332,78504,9404,11161,167401,156240,No
HKBK,Electrical and Electronics Engineering,KCET,2024,82609,92400,11800,18486,205295,186809,Yes
RIT,Electrical and Electronics Engineering,KCET,2024,81926,78165,17710,28849,206650,177801,Yes
UVCE,Biotechnology,KCET,2024,53946,63743,8905,18317,144911,126594,No
JSSSTU,Robotics and Automation Engineering,KCET,2023,74024,79548,18321,23636,195529,171893,No
MVJCE,Mechanical Engineering,COMEDK,2024,226180,87098,15491,11637,340406,328769,Yes
VSM,Aerospace Engineering,KCET,2023,61992,63822,16582,17056,159452,142396,Yes
KLEIT,Computer Science and Engineering,KCET,2024,65161,91074,12645,19950,188830,168880,Yes
JSSSTU,Electrical and Electronics Engineering,COMEDK,2024,245192,94910,19834,18197,378133,359936,Yes
KLSGIT,Computer Science and Engineering,COMEDK,2024,184100,93844,17563,21395,316902,295507,No
NIE,Electrical and Electronics Engineering,COMEDK,2023,247104,72670,14636,18700,353110,334410,Yes
RVCE,Civil Engineering,KCET,2023,55410,76592,9659,16507,158168,141661,No
DSCE,Aerospace Engineering,COMEDK,2023,202664,85346,16901,17991,322902,304911,No
BIT,Electrical and Electronics Engineering,COMEDK,2023,233352,89941,19269,25495,368057,342562,No
BITM,Data Science,KCET,2023,68938,64797,19177,12049,164961,152912,Yes
RAIT,Civil Engineering,KCET,2023,83003,77828,10562,28486,199879,171393,No
NCET,Artificial Intelligence and Data Science,COMEDK,2023,229571,79707,8526,13281,331085,317804,Yes
KLEIT,Mechanical Engineering,COMEDK,2024,165316,67542,9088,18021,259967,241946,No
EastPoint,Robotics and Automation Engineering,COMEDK,2023,234308,71880,11103,21638,338929,317291,No
SITM,Robotics and Automation Engineering,KCET,2023,58914,76741,16704,17115,169474,152359,Yes
JNNCE,Chemical Engineering,KCET,2023,56494,67384,18953,12561,155392,142831,No
SJBCE,Information Science and Engineering,COMEDK,2023,163559,77376,14786,19404,275125,255721,Yes
SDMIT,Electrical and Electronics Engineering,COMEDK,2023,220689,63165,11511,23878,319243,295365,Yes
KLEIT,Biotechnology,KCET,2024,57532,90342,8443,29114,185431,156317,Yes
BNMIT,Computer Science and Engineering,COMEDK,2024,174306,75087,14402,25763,289558,263795,Yes
PESU,Electronics and Communication Engineering,KCET,2023,58192,83098,9617,23370,174277,150907,No
AIT,Data Science,KCET,2024,76313,93397,18362,21605,209677,188072,Yes
MSRIT,Artificial Intelligence and Data Science,KCET,2024,77800,62119,11782,13280,164981,151701,Yes
SJBCE,Aerospace Engineering,COMEDK,2023,227049,79326,11825,14520,332720,318200,Yes
MSRIT,Robotics and Automation Engineering,KCET,2023,73224,80349,15802,24937,194312,169375,No
VemanaIT,Electrical and Electronics Engineering,COMEDK,2023,223338,87584,13714,29090,353726,324636,Yes
ACU,Aerospace Engineering,COMEDK,2023,222300,75985,17290,22312,337887,315575,No
SCEM,Aerospace Engineering,COMEDK,2023,209461,66483,15804,15745,307493,291748,Yes
MSRUAS,Computer Science and Engineering,COMEDK,2023,243519,66153,11734,11076,332482,321406,Yes
KLSGIT,Electrical and Electronics Engineering,KCET,2024,78575,82590,15752,27345,204262,176917,No
DrAIT,Robotics and Automation Engineering,KCET,2023,60689,94102,14047,24843,193681,168838,No
NMIT,Robotics and Automation Engineering,COMEDK,2023,223777,80824,11050,24874,340525,315651,No
BITM,Mechanical Engineering,KCET,2023,59737,80523,12292,29702,182254,152552,No
SIT,Electrical and Electronics Engineering,COMEDK,2024,172329,72311,11795,29961,286396,256435,Yes
KSIT,Mechanical Engineering,COMEDK,2024,185710,81307,16941,10502,294460,283958,Yes
AECMandya,Data Science,COMEDK,2024,186828,90096,13325,18514,308763,290249,No
AECMandya,Data Science,KCET,2024,75812,71316,16310,19780,183218,163438,Yes
BIT,Information Science and Engineering,KCET,2023,68287,71079,18616,13558,171540,157982,Yes
BITM,Civil Engineering,KCET,2024,74646,62102,19099,24236,180083,155847,No
MSRIT,Information Science and Engineering,COMEDK,2024,238199,66709,12682,28827,346417,317590,Yes
KSIT,Computer Science and Engineering,COMEDK,2023,174770,82296,8684,20962,286712,265750,Yes
YKCE,Computer Science and Engineering,COMEDK,2024,186137,64897,10247,25539,286820,261281,Yes
NIE,Electronics and Communication Engineering,KCET,2024,67512,63644,19011,16106,166273,150167,No
PRES,Chemical Engineering,KCET,2024,71401,82776,9818,22329,186324,163995,Yes
AEC,Civil Engineering,COMEDK,2024,185529,84740,19409,27071,316749,289678,Yes
KLEIT,Information Science and Engineering,KCET,2024,76631,80619,16065,12445,185760,173315,No
JSSSTU,Chemical Engineering,KCET,2023,52612,89056,15285,13677,170630,156953,Yes
JNNCE,Information Science and Engineering,COMEDK,2023,228291,64056,12403,16406,321156,304750,No
VIT,Computer Science and Engineering,KCET,2024,80118,62309,12787,12979,168193,155214,No
HKBK,Chemical Engineering,KCET,2024,55723,90009,10759,16380,172871,156491,No
UVCE,Robotics and Automation Engineering,KCET,2024,80169,90186,18405,12185,200945,188760,Yes
RAIT,Biotechnology,COMEDK,2024,187548,84952,19149,13896,305545,291649,No
RNSIT,Computer Science and Engineering,KCET,2024,61830,87161,16537,16708,182236,165528,Yes
NCET,Computer Science and Engineering,KCET,2023,78503,74953,16194,12884,182534,169650,Yes
SIT,Mechanical Engineering,COMEDK,2023,197939,61265,15233,16952,291389,274437,Yes
RAIT,Civil Engineering,COMEDK,2024,220123,80110,11295,15090,326618,311528,No
AIT,Electronics and Communication Engineering,KCET,2024,70167,88932,15843,19017,193959,174942,Yes
BNMIT,Robotics and Automation Engineering,COMEDK,2023,195886,69984,8558,17131,291559,274428,No
VVCE,Electrical and Electronics Engineering,COMEDK,2024,235933,65778,17487,20868,340066,319198,No
BMSCE,Civil Engineering,COMEDK,2023,229989,90286,14138,18977,353390,334413,Yes
PESCE,Civil Engineering,KCET,2023,69783,78103,13308,16774,177968,161194,Yes
NCET,Data Science,KCET,2024,73273,66509,10395,12967,163144,150177,No
CITGubbi,Biotechnology,KCET,2024,82871,65899,9339,22523,180632,158109,No
SIT,Aerospace Engineering,KCET,2024,53953,83694,11671,11048,160366,149318,Yes
BNMIT,Information Science and Engineering,COMEDK,2023,188307,60469,17207,15243,281226,265983,No
HKBK,Biotechnology,COMEDK,2023,202261,76595,17243,22588,318687,296099,Yes
PESCE,Electronics and Communication Engineering,KCET,2023,55664,80971,18259,20698,175592,154894,No
DSCE,Civil Engineering,KCET,2024,82880,89555,18506,23363,214304,190941,No
BNMIT,Artificial Intelligence and Data Science,COMEDK,2023,177510,90704,15379,14571,298164,283593,No
MVJCE,Mechanical Engineering,COMEDK,2023,224986,89391,9745,19533,343655,324122,No
BITM,Data Science,KCET,2023,74781,70434,19115,11399,175729,164330,No
NHCE,Mechanical Engineering,COMEDK,2024,208403,65352,19012,19656,312423,292767,No
VVCE,Mechanical Engineering,COMEDK,2023,161753,90384,11425,30000,293562,263562,No
NMIT,Mechanical Engineering,COMEDK,2024,213434,67299,15373,21535,317641,296106,No
DSCE,Mechanical Engineering,KCET,2024,67264,60214,18054,24004,169536,145532,No
CITGubbi,Chemical Engineering,KCET,2023,54961,65885,8324,12880,142050,129170,Yes
KSIT,Data Science,COMEDK,2024,248473,76954,10598,16755,352780,336025,No
RAIT,Robotics and Automation Engineering,KCET,2023,61367,65559,14739,13943,155608,141665,Yes
KLSGIT,Data Science,COMEDK,2024,194542,63194,8219,11254,277209,265955,Yes
MSRIT,Biotechnology,KCET,2024,79860,65105,16442,29483,190890,161407,No
PESCE,Civil Engineering,KCET,2024,59121,66658,8077,27751,161607,133856,No
KLEIT,Chemical Engineering,KCET,2023,76622,93976,14074,18730,203402,184672,No
AITM,Information Science and Engineering,KCET,2023,78430,86655,8079,26227,199391,173164,No
BMIT,Robotics and Automation Engineering,KCET,2023,54204,63507,19424,21841,158976,137135,No
REVA,Robotics and Automation Engineering,COMEDK,2024,177897,74034,10130,15829,277890,262061,Yes
HKBK,Data Science,KCET,2024,74782,63143,12191,26296,176412,150116,Yes
MSRIT,Robotics and Automation Engineering,COMEDK,2024,209586,83595,14763,27733,335677,307944,Yes
NMIT,Artificial Intelligence and Data Science,COMEDK,2024,208558,65189,16525,28976,319248,290272,No
CMRIT,Mechanical Engineering,COMEDK,2024,182606,80826,13682,28003,305117,277114,Yes
BIT,Robotics and Automation Engineering,KCET,2023,75986,69938,18189,10887,175000,164113,No
AECMandya,Civil Engineering,COMEDK,2024,206812,90751,16002,10351,323916,313565,No
SCEM,Electronics and Communication Engineering,KCET,2024,84256,63985,15080,21849,185170,163321,No
DBIT,Data Science,KCET,2024,82663,81396,18800,25745,208604,182859,No
MVJCE,Mechanical Engineering,COMEDK,2023,246570,87090,8922,24792,367374,342582,Yes
SITM,Electronics and Communication Engineering,COMEDK,2024,246094,64619,10870,13368,334951,321583,Yes
DSCE,Data Science,KCET,2024,52838,91454,9936,14251,168479,154228,No
SDMCET,Biotechnology,KCET,2023,70350,81474,11424,21323,184571,163248,Yes
AITM,Data Science,KCET,2024,55113,85248,15995,19765,176121,156356,No
KLSGIT,Chemical Engineering,COMEDK,2023,208808,82947,16382,26231,334368,308137,No
RNSIT,Information Science and Engineering,COMEDK,2024,228919,82802,15147,20846,347714,326868,Yes
VVIT,Chemical Engineering,COMEDK,2023,240477,66775,12247,15062,334561,319499,No
ACU,Data Science,KCET,2023,78418,83325,14351,15654,191748,176094,Yes
AITM,Computer Science and Engineering,COMEDK,2023,176559,90922,14655,29827,311963,282136,No
BMIT,Electronics and Communication Engineering,COMEDK,2023,230754,87748,16609,27010,362121,335111,No
ACU,Robotics and Automation Engineering,KCET,2023,74900,77183,15383,18779,186245,167466,No
JIT,Data Science,KCET,2024,74820,82260,15182,25046,197308,172262,Yes
DSCE,Civil Engineering,COMEDK,2024,176596,64435,14166,28701,283898,255197,No
AIT,Biotechnology,COMEDK,2023,179380,65917,18560,27484,291341,263857,Yes
RAIT,Information Science and Engineering,KCET,2023,80654,78327,8484,14637,182102,167465,No
AIT,Electrical and Electronics Engineering,COMEDK,2023,245919,63627,19535,18478,347559,329081,No
CITGubbi,Biotechnology,KCET,2024,72735,81060,10340,16714,180849,164135,Yes
RAIT,Aerospace Engineering,KCET,2023,62872,92218,15387,24194,194671,170477,Yes
PESCE,Biotechnology,KCET,2023,69010,93196,14792,12191,189189,176998,Yes
DBIT,Electronics and Communication Engineering,KCET,2023,69042,80615,15939,17670,183266,165596,No
CITGubbi,Mechanical Engineering,COMEDK,2024,219368,61683,12640,21962,315653,293691,No
RVUNIV,Aerospace Engineering,KCET,2024,81051,81409,17124,18698,198282,179584,Yes
RAIT,Civil Engineering,COMEDK,2023,230466,80894,9810,27136,348306,321170,Yes
HKBK,Civil Engineering,COMEDK,2024,190344,61166,12311,20399,284220,263821,No
KSIT,Civil Engineering,KCET,2023,71262,80742,10269,10754,173027,162273,Yes
DSCE,Civil Engineering,KCET,2024,71403,74930,14997,26307,187637,161330,No
BITM,Civil Engineering,KCET,2023,79823,66678,13168,14550,174219,159669,No
RVUNIV,Civil Engineering,KCET,2024,84619,64468,9977,28906,187970,159064,Yes
VVIT,Aerospace Engineering,KCET,2023,57560,60301,18697,13831,150389,136558,Yes
SJBIT,Biotechnology,KCET,2023,73134,74933,8539,18034,174640,156606,Yes
SCEM,Robotics and Automation Engineering,KCET,2024,76704,82401,18459,27534,205098,177564,No
RAIT,Electrical and Electronics Engineering,KCET,2024,58213,67107,10796,15259,151375,136116,No
YKCE,Information Science and Engineering,KCET,2024,80141,86672,12164,29342,208319,178977,No
EastPoint,Biotechnology,KCET,2023,68039,94843,15067,19021,196970,177949,No
AECMandya,Aerospace Engineering,KCET,2023,64655,83366,19099,29434,196554,167120,Yes
MVJCE,Artificial Intelligence and Data Science,COMEDK,2023,185413,89567,8397,28756,312133,283377,No
JNNCE,Robotics and Automation Engineering,KCET,2023,71308,71591,11570,26283,180752,154469,Yes
RVCE,Chemical Engineering,KCET,2023,53485,61224,16438,19549,150696,131147,Yes
GIT,Biotechnology,COMEDK,2023,197241,61839,9290,14687,283057,268370,No
NHCE,Civil Engineering,KCET,2023,53222,80448,14361,13460,161491,148031,No
RVCE,Electronics and Communication Engineering,COMEDK,2024,231736,77669,10135,20702,340242,319540,Yes
HKBK,Information Science and Engineering,KCET,2024,67778,79216,14822,14744,176560,161816,No
VIT,Biotechnology,COMEDK,2024,168275,76050,11424,11570,267319,255749,Yes
BITM,Information Science and Engineering,KCET,2024,64092,66346,13819,19533,163790,144257,No
SIT,Robotics and Automation Engineering,KCET,2024,78497,82974,11944,16561,189976,173415,Yes
DrAIT,Mechanical Engineering,COMEDK,2024,224442,92704,14835,14774,346755,331981,Yes
MSRIT,Computer Science and Engineering,KCET,2024,65602,70752,9852,25899,172105,146206,No
SCEM,Chemical Engineering,KCET,2024,80022,79109,13828,16023,188982,172959,Yes
YKCE,Biotechnology,COMEDK,2023,206851,77713,18195,12074,314833,302759,No
DBIT,Electrical and Electronics Engineering,KCET,2024,81220,90555,11018,20756,203549,182793,No
JIT,Robotics and Automation Engineering,KCET,2024,67977,63860,14974,12694,159505,146811,No
BITM,Civil Engineering,COMEDK,2024,205177,66642,8204,19704,299727,280023,No
SDMIT,Robotics and Automation Engineering,KCET,2023,70081,73955,12449,22711,179196,156485,Yes
NMIT,Computer Science and Engineering,COMEDK,2023,235044,68581,11910,22557,338092,315535,No
VVCE,Robotics and Automation Engineering,KCET,2024,71344,60282,9751,16559,157936,141377,Yes
KLEIT,Computer Science and Engineering,KCET,2023,57141,63020,15264,13462,148887,135425,No
NCET,Robotics and Automation Engineering,KCET,2024,66581,91242,10479,20570,188872,168302,No
SCEM,Electrical and Electronics Engineering,KCET,2023,56038,92320,16854,11266,176478,165212,No
DrAIT,Artificial Intelligence and Data Science,COMEDK,2023,218211,85529,17939,28246,349925,321679,Yes
PESCE,Chemical Engineering,COMEDK,2023,162200,74832,10046,10066,257144,247078,Yes
YKCE,Robotics and Automation Engineering,COMEDK,2024,214107,87578,16114,19401,337200,317799,Yes
BITM,Biotechnology,KCET,2024,58999,71470,9110,10479,150058,139579,Yes
YKCE,Artificial Intelligence and Data Science,COMEDK,2024,225329,92869,12501,12391,343090,330699,Yes
RIT,Electrical and Electronics Engineering,COMEDK,2023,178656,68831,14263,28131,289881,261750,Yes
MVJCE,Civil Engineering,KCET,2023,68913,70934,15895,18043,173785,155742,No
HKBK,Artificial Intelligence and Data Science,COMEDK,2024,169455,85787,12929,20793,288964,268171,No
REVA,Information Science and Engineering,COMEDK,2024,180379,73892,11465,21108,286844,265736,Yes
AEC,Mechanical Engineering,KCET,2024,76183,69955,15669,25828,187635,161807,No
KSIT,Aerospace Engineering,KCET,2023,60713,64141,14810,18684,158348,139664,No
DSCE,Information Science and Engineering,KCET,2023,54786,79080,19282,12759,165907,153148,No
GMIT,Computer Science and Engineering,COMEDK,2024,204997,91886,14630,15446,326959,311513,Yes
VemanaIT,Information Science and Engineering,COMEDK,2023,187498,87589,19251,15484,309822,294338,Yes
UVCE,Artificial Intelligence and Data Science,COMEDK,2024,168428,80903,11606,11930,272867,260937,No
VVCE,Electronics and Communication Engineering,COMEDK,2023,214069,65589,10607,23525,313790,290265,Yes
UVCE,Chemical Engineering,COMEDK,2024,214226,69043,15962,12876,312107,299231,Yes
RVUNIV,Electronics and Communication Engineering,KCET,2023,77678,63049,15782,26729,183238,156509,Yes
NMIT,Electronics and Communication Engineering,COMEDK,2023,236951,60908,16431,26344,340634,314290,No
NCET,Artificial Intelligence and Data Science,COMEDK,2023,237495,89742,17014,16617,360868,344251,No
VVIT,Chemical Engineering,COMEDK,2024,191425,77189,15298,19269,303181,283912,Yes
NMIT,Robotics and Automation Engineering,KCET,2024,74136,93245,14851,16029,198261,182232,Yes
VSM,Civil Engineering,COMEDK,2024,165599,90963,9103,23200,288865,265665,No
CMRIT,Civil Engineering,KCET,2023,63337,65719,16520,26936,172512,145576,No
AITM,Civil Engineering,KCET,2024,55911,77457,9631,18956,161955,142999,Yes
DSCE,Information Science and Engineering,COMEDK,2023,202706,89789,9605,15473,317573,302100,Yes
DrAIT,Biotechnology,KCET,2024,65738,69256,16414,25797,177205,151408,Yes
NMIT,Aerospace Engineering,COMEDK,2023,189238,63808,9553,28706,291305,262599,Yes
MSRUAS,Information Science and Engineering,COMEDK,2024,176001,93433,13474,17997,300905,282908,No
JIT,Mechanical Engineering,KCET,2023,59335,69147,12030,17293,157805,140512,No
YKCE,Computer Science and Engineering,KCET,2023,74367,87909,12356,26782,201414,174632,No
DSATM,Civil Engineering,COMEDK,2023,208768,77556,19414,22803,328541,305738,No
VVIT,Information Science and Engineering,COMEDK,2023,210433,90256,12543,20020,333252,313232,Yes
JIT,Data Science,KCET,2024,73403,79790,17850,24454,195497,171043,Yes
VIT,Aerospace Engineering,KCET,2024,51663,89131,9559,22141,172494,150353,Yes
MSRIT,Computer Science and Engineering,KCET,2023,75220,83782,10216,25429,194647,169218,No
NMIT,Biotechnology,KCET,2023,52656,71809,9699,23115,157279,134164,Yes
PESU,Mechanical Engineering,KCET,2023,61020,65370,10521,22759,159670,136911,Yes
SCEM,Chemical Engineering,KCET,2024,52434,64044,17751,24633,158862,134229,No
BMSCE,Computer Science and Engineering,COMEDK,2023,211000,91603,11103,20010,333716,313706,No
UVCE,Chemical Engineering,KCET,2023,78129,93172,13098,15858,200257,184399,Yes
DSATM,Aerospace Engineering,KCET,2024,53684,87664,9803,17291,168442,151151,Yes
KLEIT,Information Science and Engineering,KCET,2023,56483,60759,19173,11356,147771,136415,Yes
SCEM,Data Science,COMEDK,2023,229608,76864,17838,17145,341455,324310,No
REVA,Electronics and Communication Engineering,KCET,2023,57769,78949,17092,18997,172807,153810,Yes
BNMIT,Chemical Engineering,COMEDK,2023,192008,92434,10610,26246,321298,295052,No
VVCE,Computer Science and Engineering,COMEDK,2023,205287,73011,18891,13826,311015,297189,No
NMIT,Information Science and Engineering,COMEDK,2024,193480,77034,11221,21763,303498,281735,Yes
DSCE,Artificial Intelligence and Data Science,KCET,2023,70613,65244,14195,26308,176360,150052,No
SJBIT,Artificial Intelligence and Data Science,COMEDK,2024,211250,78849,13616,22429,326144,303715,No
VemanaIT,Robotics and Automation Engineering,COMEDK,2023,197416,67782,11447,19147,295792,276645,Yes
KSIT,Computer Science and Engineering,KCET,2024,69727,76073,13492,20021,179313,159292,No
EastPoint,Biotechnology,KCET,2023,79335,70664,13887,15082,178968,163886,Yes
VVIT,Mechanical Engineering,COMEDK,2023,177276,83506,9227,14576,284585,270009,Yes
AEC,Information Science and Engineering,COMEDK,2024,227146,75696,19514,20284,342640,322356,Yes
GMIT,Electrical and Electronics Engineering,COMEDK,2023,193471,85299,19281,26968,325019,298051,No
RIT,Biotechnology,COMEDK,2024,189699,72969,15076,23484,301228,277744,No
BNMIT,Information Science and Engineering,COMEDK,2024,177510,75710,13401,12587,279208,266621,No
NCET,Electrical and Electronics Engineering,KCET,2024,74940,72498,13934,21302,182674,161372,No
RVCE,Electrical and Electronics Engineering,COMEDK,2023,166044,65214,16432,23464,271154,247690,No
BIT,Aerospace Engineering,COMEDK,2024,196311,76422,11810,15506,300049,284543,No
ACU,Electrical and Electronics Engineering,COMEDK,2023,206154,89626,12223,19806,327809,308003,Yes
BITM,Chemical Engineering,COMEDK,2024,233831,60291,17742,16391,328255,311864,Yes
BITM,Robotics and Automation Engineering,KCET,2023,79183,91684,8136,16154,195157,179003,No
SJBIT,Electrical and Electronics Engineering,COMEDK,2024,208380,71152,13829,24368,317729,293361,No
JIT,Chemical Engineering,COMEDK,2024,237420,87856,17059,17696,360031,342335,No
BMIT,Robotics and Automation Engineering,KCET,2024,50431,94382,17157,18339,180309,161970,No
SITM,Robotics and Automation Engineering,COMEDK,2024,196655,87602,14169,13930,312356,298426,No
VIT,Data Science,COMEDK,2024,239281,89183,15091,16471,360026,343555,No
VSM,Electrical and Electronics Engineering,COMEDK,2023,160040,76136,18805,14577,269558,254981,No
CITGubbi,Computer Science and Engineering,KCET,2024,53676,94552,13224,21504,182956,161452,No
VIT,Data Science,KCET,2024,64410,72355,9178,20906,166849,145943,No
VIT,Electrical and Electronics Engineering,COMEDK,2023,162875,66952,19064,14228,263119,248891,No
JSSSTU,Information Science and Engineering,KCET,2024,60549,90181,16863,15189,182782,167593,No
DBIT,Aerospace Engineering,COMEDK,2023,222189,83965,14313,26282,346749,320467,No
RNSIT,Civil Engineering,KCET,2024,54369,77544,15327,13713,160953,147240,No
DSATM,Civil Engineering,KCET,2023,77647,77101,9082,12829,176659,163830,Yes
MVJCE,Information Science and Engineering,KCET,2024,66619,91103,15815,22728,196265,173537,No
VVIT,Mechanical Engineering,COMEDK,2024,190570,63249,19390,18056,291265,273209,Yes
JNNCE,Data Science,COMEDK,2024,202178,73016,16267,26786,318247,291461,Yes
MSRIT,Electronics and Communication Engineering,COMEDK,2024,201189,91505,19362,27100,339156,312056,Yes
RIT,Mechanical Engineering,KCET,2023,76182,76805,11567,24482,189036,164554,Yes
AIT,Electronics and Communication Engineering,KCET,2024,58278,82810,16898,15316,173302,157986,No
YKCE,Information Science and Engineering,COMEDK,2024,175670,82852,13464,13221,285207,271986,Yes
REVA,Artificial Intelligence and Data Science,KCET,2024,55889,70397,19132,17368,162786,145418,No
DBIT,Biotechnology,KCET,2024,57129,80130,8666,20686,166611,145925,Yes
VSM,Chemical Engineering,KCET,2024,82473,71892,16407,21071,191843,170772,No
AITM,Mechanical Engineering,COMEDK,2023,181709,63066,9870,21407,276052,254645,Yes
RVCE,Civil Engineering,KCET,2023,58053,70978,19607,17541,166179,148638,No
JIT,Data Science,COMEDK,2024,216939,67076,15697,29120,328832,299712,No
KLSGIT,Computer Science and Engineering,COMEDK,2023,235048,88367,15823,21278,360516,339238,Yes
VIT,Data Science,COMEDK,2024,233151,78603,11740,25344,348838,323494,No
BNMIT,Artificial Intelligence and Data Science,COMEDK,2023,227761,80346,14049,29934,352090,322156,No
SJBIT,Mechanical Engineering,COMEDK,2024,195838,76406,17003,17682,306929,289247,No
CMRIT,Electrical and Electronics Engineering,COMEDK,2024,183431,69447,16936,27624,297438,269814,Yes
MVJCE,Electrical and Electronics Engineering,COMEDK,2023,161755,88444,14488,28325,293012,264687,Yes
DrAIT,Electrical and Electronics Engineering,KCET,2023,82421,76060,17607,14171,190259,176088,No
PESU,Information Science and Engineering,COMEDK,2023,212330,68883,8191,13812,303216,289404,Yes
JNNCE,Information Science and Engineering,KCET,2023,56445,73580,16861,12610,159496,146886,Yes
SDMIT,Artificial Intelligence and Data Science,KCET,2024,79938,81675,12739,25743,200095,174352,Yes
AITM,Civil Engineering,KCET,2024,68642,60852,19229,18158,166881,148723,No
PESCE,Civil Engineering,COMEDK,2023,212676,70295,10262,12710,305943,293233,Yes
AECMandya,Computer Science and Engineering,KCET,2023,80025,87128,10009,14116,191278,177162,No
BNMIT,Data Science,COMEDK,2024,189258,60797,10840,16258,277153,260895,Yes
VSM,Biotechnology,COMEDK,2024,179901,86179,13232,29951,309263,279312,Yes
SJBCE,Biotechnology,COMEDK,2024,213104,88294,8054,23037,332489,309452,Yes
AECMandya,Chemical Engineering,KCET,2024,56536,73829,10873,15761,156999,141238,No
DSCE,Robotics and Automation Engineering,KCET,2023,78175,70667,12173,27799,188814,161015,Yes
VVCE,Information Science and Engineering,KCET,2024,65438,85700,11476,19438,182052,162614,Yes
PESU,Civil Engineering,KCET,2024,63129,63003,17338,15973,159443,143470,Yes
PRES,Robotics and Automation Engineering,COMEDK,2023,217441,68715,17301,24665,328122,303457,No
KSIT,Biotechnology,COMEDK,2023,197802,90489,12838,25926,327055,301129,No
NCET,Electrical and Electronics Engineering,KCET,2023,74243,88698,13206,24928,201075,176147,Yes
VVCE,Biotechnology,KCET,2024,56014,85418,12239,29304,182975,153671,No
CITGubbi,Electrical and Electronics Engineering,COMEDK,2023,222618,83851,9700,29458,345627,316169,No
SDMCET,Chemical Engineering,COMEDK,2024,214810,65697,14747,21834,317088,295254,Yes
NIE,Biotechnology,COMEDK,2023,178867,82042,13635,26465,301009,274544,No
AIT,Chemical Engineering,COMEDK,2024,166879,65399,18771,26616,277665,251049,Yes
RVCE,Biotechnology,COMEDK,2024,217154,76578,11385,15889,321006,305117,No
JIT,Electrical and Electronics Engineering,KCET,2024,64125,61809,13690,11862,151486,139624,Yes
VVIT,Electrical and Electronics Engineering,COMEDK,2024,247111,67959,12152,16009,343231,327222,No
SDMCET,Biotechnology,KCET,2024,70014,66144,8439,18045,162642,144597,Yes
BMSIT,Aerospace Engineering,COMEDK,2024,232510,74073,10360,17958,334901,316943,Yes
SDMCET,Chemical Engineering,COMEDK,2024,183786,61567,17716,19934,283003,263069,Yes
VemanaIT,Artificial Intelligence and Data Science,KCET,2023,80494,76010,12194,14579,183277,168698,No
BIT,Robotics and Automation Engineering,KCET,2024,58092,62149,11105,17193,148539,131346,No
MSRUAS,Mechanical Engineering,KCET,2023,57703,62085,8443,11395,139626,128231,Yes
REVA,Chemical Engineering,COMEDK,2024,162189,71547,11725,16309,261770,245461,Yes
GIT,Aerospace Engineering,COMEDK,2024,192381,66558,8194,22607,289740,267133,No
DSATM,Mechanical Engineering,KCET,2024,71026,70882,14792,17733,174433,156700,Yes
CITGubbi,Electronics and Communication Engineering,COMEDK,2023,164473,66378,15877,25089,271817,246728,Yes
VSM,Electrical and Electronics Engineering,KCET,2024,51886,81464,10544,11948,155842,143894,No
RVUNIV,Biotechnology,COMEDK,2023,188260,84537,13603,20862,307262,286400,No
VVIT,Computer Science and Engineering,COMEDK,2024,165915,90016,17460,13437,286828,273391,No
JNNCE,Artificial Intelligence and Data Science,KCET,2024,67581,84728,12628,18643,183580,164937,Yes
PESU,Mechanical Engineering,COMEDK,2024,217213,81666,12835,15838,327552,311714,Yes
NIE,Computer Science and Engineering,KCET,2023,70115,73979,16867,24831,185792,160961,Yes
NIE,Biotechnology,COMEDK,2024,163148,73596,19331,26712,282787,256075,Yes
BITM,Biotechnology,COMEDK,2023,201382,90766,13127,19639,324914,305275,No
KSIT,Data Science,COMEDK,2024,169302,85258,10596,26850,292006,265156,No
BITM,Mechanical Engineering,KCET,2023,80465,79819,19203,14317,193804,179487,No
DrAIT,Artificial Intelligence and Data Science,KCET,2023,57309,73804,11106,26093,168312,142219,No
SJBIT,Data Science,COMEDK,2024,225581,81352,9640,21520,338093,316573,Yes
AIT,Electronics and Communication Engineering,COMEDK,2023,211651,88000,18012,29840,347503,317663,No
DBIT,Electronics and Communication Engineering,COMEDK,2023,222441,72596,8031,22473,325541,303068,Yes
DSCE,Biotechnology,COMEDK,2024,225258,67872,19979,21072,334181,313109,Yes
AECMandya,Computer Science and Engineering,KCET,2024,72420,77431,19722,22345,191918,169573,No
AEC,Mechanical Engineering,KCET,2023,69632,86274,14517,15808,186231,170423,Yes
BMIT,Artificial Intelligence and Data Science,COMEDK,2023,178097,90288,13271,17827,299483,281656,Yes
REVA,Artificial Intelligence and Data Science,COMEDK,2024,182370,81369,17250,14121,295110,280989,Yes
KLSGIT,Civil Engineering,COMEDK,2023,211853,65562,17071,22113,316599,294486,No
BIT,Artificial Intelligence and Data Science,COMEDK,2023,229924,64417,18824,20359,333524,313165,Yes
AECMandya,Electronics and Communication Engineering,COMEDK,2023,195899,70439,14161,17780,298279,280499,No
SCEM,Civil Engineering,KCET,2023,66980,83094,11326,23605,185005,161400,Yes
SJBIT,Electrical and Electronics Engineering,COMEDK,2023,214664,76517,17004,16139,324324,308185,No
SJBCE,Electrical and Electronics Engineering,KCET,2023,66855,94046,10661,18803,190365,171562,No
VVIT,Biotechnology,KCET,2023,65676,72859,18226,16998,173759,156761,Yes
HKBK,Mechanical Engineering,COMEDK,2023,186790,93850,11650,13885,306175,292290,Yes
BMSIT,Computer Science and Engineering,COMEDK,2023,166445,88508,15281,10213,280447,270234,No
EastPoint,Computer Science and Engineering,COMEDK,2024,239436,91120,8980,29571,369107,339536,No
AECMandya,Robotics and Automation Engineering,KCET,2023,60004,85230,14535,28324,188093,159769,Yes
DSATM,Electronics and Communication Engineering,COMEDK,2024,196472,71395,16222,19238,303327,284089,Yes
DBIT,Civil Engineering,COMEDK,2023,235854,77062,17266,24329,354511,330182,Yes
RIT,Artificial Intelligence and Data Science,KCET,2023,60146,74203,10418,22740,167507,144767,No
ACU,Aerospace Engineering,COMEDK,2024,198271,81670,8573,15633,304147,288514,No
HKBK,Electronics and Communication Engineering,COMEDK,2024,165572,65770,10782,17238,259362,242124,Yes
BITM,Artificial Intelligence and Data Science,KCET,2024,69860,91339,9263,27168,197630,170462,Yes
BMSIT,Artificial Intelligence and Data Science,KCET,2024,70560,88372,18578,16361,193871,177510,Yes
SDMIT,Robotics and Automation Engineering,KCET,2023,79583,80248,14109,27468,201408,173940,Yes
AEC,Aerospace Engineering,COMEDK,2024,245104,64570,14021,22582,346277,323695,Yes
NMIT,Biotechnology,KCET,2023,51484,73625,10024,22770,157903,135133,Yes
GMIT,Artificial Intelligence and Data Science,KCET,2023,76389,75097,12990,16024,180500,164476,No
VSM,Electronics and Communication Engineering,KCET,2024,83900,81940,10881,29293,206014,176721,No
KSIT,Artificial Intelligence and Data Science,COMEDK,2023,191833,75487,13450,19213,299983,280770,Yes
JIT,Artificial Intelligence and Data Science,KCET,2023,67715,79433,11474,16477,175099,158622,Yes
GIT,Electrical and Electronics Engineering,COMEDK,2023,225491,70594,11503,11919,319507,307588,No
EastPoint,Robotics and Automation Engineering,COMEDK,2024,222063,86662,9462,22928,341115,318187,Yes
JSSSTU,Robotics and Automation Engineering,KCET,2024,73133,89530,9080,13743,185486,171743,Yes
NIE,Civil Engineering,COMEDK,2024,241362,79475,14034,20000,354871,334871,Yes
CITGubbi,Information Science and Engineering,KCET,2023,65833,64486,19055,20772,170146,149374,No
UVCE,Aerospace Engineering,COMEDK,2023,189136,90561,13635,27102,320434,293332,No
KSIT,Robotics and Automation Engineering,COMEDK,2024,164350,79684,9075,15246,268355,253109,Yes
MSRUAS,Artificial Intelligence and Data Science,KCET,2023,57028,72778,16428,27336,173570,146234,Yes
RIT,Artificial Intelligence and Data Science,COMEDK,2024,202596,81101,14787,29015,327499,298484,No
NIE,Civil Engineering,KCET,2023,64940,61131,10909,14886,151866,136980,Yes
UVCE,Electronics and Communication Engineering,KCET,2023,81222,87034,17928,18367,204551,186184,Yes
BIT,Electrical and Electronics Engineering,COMEDK,2023,227156,78748,13262,15492,334658,319166,Yes
NMIT,Civil Engineering,COMEDK,2024,204581,84640,15834,19739,324794,305055,Yes
RIT,Computer Science and Engineering,COMEDK,2024,179134,94259,13895,24206,311494,287288,Yes
NMIT,Information Science and Engineering,COMEDK,2024,173397,89322,11986,21405,296110,274705,Yes
VSM,Civil Engineering,KCET,2023,74951,65710,15736,18991,175388,156397,No
BITM,Electrical and Electronics Engineering,COMEDK,2024,179719,81121,13987,19965,294792,274827,No
SCEM,Robotics and Automation Engineering,COMEDK,2024,232944,64983,15722,25061,338710,313649,Yes
UVCE,Chemical Engineering,KCET,2024,81681,88996,18240,22490,211407,188917,Yes
SIT,Mechanical Engineering,KCET,2023,83008,92444,8024,12955,196431,183476,Yes
BIT,Civil Engineering,KCET,2023,80900,71403,12578,15937,180818,164881,No
BMSIT,Data Science,KCET,2023,70133,60955,10064,15760,156912,141152,No
HKBK,Civil Engineering,COMEDK,2023,225997,70326,12954,13250,322527,309277,Yes
SDMCET,Chemical Engineering,COMEDK,2023,233853,89341,9774,15868,348836,332968,Yes
NIE,Chemical Engineering,COMEDK,2024,163147,66073,18069,10500,257789,247289,No
SCEM,Electronics and Communication Engineering,COMEDK,2024,230605,71653,17966,13148,333372,320224,No
RVCE,Civil Engineering,COMEDK,2023,204690,94142,17017,20360,336209,315849,No
JNNCE,Information Science and Engineering,COMEDK,2024,230268,85794,10384,12538,338984,326446,No
CMRIT,Electrical and Electronics Engineering,KCET,2023,52129,87231,11324,20946,171630,150684,Yes
RIT,Artificial Intelligence and Data Science,COMEDK,2023,212904,79998,11934,16236,321072,304836,Yes
YKCE,Data Science,COMEDK,2023,247694,72299,11020,29416,360429,331013,No
DSCE,Aerospace Engineering,KCET,2024,58903,70145,18632,27952,175632,147680,No
BIT,Information Science and Engineering,KCET,2023,53266,80718,17155,24507,175646,151139,Yes
BMSCE,Data Science,KCET,2024,68017,84741,10689,27677,191124,163447,No
VVCE,Civil Engineering,COMEDK,2024,237401,92620,18501,12723,361245,348522,No
DSCE,Computer Science and Engineering,COMEDK,2023,239691,84590,12786,21297,358364,337067,Yes
NIE,Biotechnology,KCET,2024,50226,67966,9841,15617,143650,128033,No
SJBCE,Biotechnology,KCET,2023,74856,91124,8760,14268,189008,174740,No
AIT,Biotechnology,COMEDK,2023,236549,64823,13738,26789,341899,315110,No
MSRIT,Artificial Intelligence and Data Science,KCET,2024,78419,70053,9865,22076,180413,158337,No
DSCE,Computer Science and Engineering,COMEDK,2023,221263,64369,14108,12126,311866,299740,No
VSM,Aerospace Engineering,KCET,2024,58153,94542,8019,26190,186904,160714,Yes
RAIT,Robotics and Automation Engineering,KCET,2023,61952,80201,16220,16542,174915,158373,Yes
VemanaIT,Artificial Intelligence and Data Science,COMEDK,2023,198530,72525,19420,26762,317237,290475,Yes
RNSIT,Chemical Engineering,COMEDK,2024,232301,75771,16771,12948,337791,324843,Yes
CITGubbi,Data Science,KCET,2023,50815,80360,12971,29631,173777,144146,No
RNSIT,Information Science and Engineering,COMEDK,2023,220144,82514,15201,22659,340518,317859,No
DrAIT,Chemical Engineering,KCET,2023,75302,90222,13739,15427,194690,179263,No
ACU,Biotechnology,COMEDK,2023,172300,83427,15336,11390,282453,271063,No
BMSCE,Information Science and Engineering,COMEDK,2023,195751,75055,12467,11923,295196,283273,No
VemanaIT,Aerospace Engineering,KCET,2023,59858,89399,11657,14883,175797,160914,Yes
DrAIT,Electronics and Communication Engineering,COMEDK,2023,194868,85910,10660,10412,301850,291438,Yes
ACU,Robotics and Automation Engineering,KCET,2024,51348,79401,13448,15309,159506,144197,No
BNMIT,Biotechnology,KCET,2023,56819,67092,10138,18997,153046,134049,No
DSATM,Electrical and Electronics Engineering,COMEDK,2023,184847,85330,19085,16259,305521,289262,No
RVUNIV,Electrical and Electronics Engineering,KCET,2024,56394,65922,10928,20808,154052,133244,No
PESCE,Aerospace Engineering,COMEDK,2024,242825,81089,19745,13459,357118,343659,Yes
JSSSTU,Aerospace Engineering,KCET,2024,69415,77022,12602,16545,175584,159039,No
BIT,Chemical Engineering,KCET,2023,76718,64141,9140,26133,176132,149999,Yes
AITM,Robotics and Automation Engineering,COMEDK,2023,222376,78503,8632,26960,336471,309511,No
NMIT,Robotics and Automation Engineering,KCET,2023,66073,67902,15884,24876,174735,149859,No
JIT,Electrical and Electronics Engineering,KCET,2023,61910,88398,15393,16595,182296,165701,Yes
BMIT,Electrical and Electronics Engineering,KCET,2024,62766,74619,13322,10774,161481,150707,No
BMSCE,Electronics and Communication Engineering,KCET,2023,77683,78213,19610,15757,191263,175506,No
JIT,Electrical and Electronics Engineering,KCET,2024,72480,78877,13932,10768,176057,165289,Yes
VemanaIT,Chemical Engineering,COMEDK,2023,161886,82883,16423,10892,272084,261192,No
SCEM,Biotechnology,COMEDK,2024,240142,64717,15658,15559,336076,320517,Yes
JSSSTU,Mechanical Engineering,KCET,2024,62425,73616,14566,13593,164200,150607,Yes
REVA,Computer Science and Engineering,KCET,2023,57028,91367,12726,18519,179640,161121,No
SDMCET,Data Science,COMEDK,2024,246408,74487,9420,13528,343843,330315,No
YKCE,Biotechnology,COMEDK,2023,181683,65046,14934,27574,289237,261663,No
NHCE,Mechanical Engineering,COMEDK,2023,195747,60219,13259,28407,297632,269225,Yes
RAIT,Electronics and Communication Engineering,KCET,2023,79030,69940,15434,10471,174875,164404,No
ACU,Computer Science and Engineering,KCET,2024,83976,91119,13141,15933,204169,188236,No
NIE,Aerospace Engineering,KCET,2023,78961,78521,14921,13120,185523,172403,No
BMSCE,Computer Science and Engineering,COMEDK,2024,200186,92773,17080,15095,325134,310039,No
KLSGIT,Data Science,COMEDK,2024,249864,66208,19023,29296,364391,335095,No
VVIT,Civil Engineering,COMEDK,2023,213340,67381,8334,18263,307318,289055,Yes
BMSCE,Electronics and Communication Engineering,KCET,2023,50976,84857,18319,23586,177738,154152,No
DSATM,Artificial Intelligence and Data Science,COMEDK,2023,208429,68281,15836,18378,310924,292546,No
HKBK,Mechanical Engineering,KCET,2023,82520,81946,13693,19432,197591,178159,Yes
SJBIT,Information Science and Engineering,COMEDK,2024,168874,65644,11420,17724,263662,245938,No
VSM,Mechanical Engineering,KCET,2023,62823,72383,10743,17602,163551,145949,No
BMSIT,Artificial Intelligence and Data Science,COMEDK,2023,166147,81277,16468,20547,284439,263892,Yes
JIT,Artificial Intelligence and Data Science,COMEDK,2023,177028,64811,10460,12029,264328,252299,Yes
AECMandya,Data Science,KCET,2024,82340,68598,13943,21757,186638,164881,Yes
BMIT,Artificial Intelligence and Data Science,KCET,2024,64608,60488,17945,23347,166388,143041,Yes
RNSIT,Data Science,COMEDK,2024,178093,93377,12137,18873,302480,283607,No
VSM,Artificial Intelligence and Data Science,COMEDK,2023,212459,66266,10140,20044,308909,288865,Yes
VVCE,Robotics and Automation Engineering,COMEDK,2024,222501,68554,19995,12903,323953,311050,Yes
DBIT,Biotechnology,COMEDK,2023,242599,89312,9685,14494,356090,341596,No
JNNCE,Chemical Engineering,COMEDK,2024,161286,93733,15586,13396,284001,270605,No
DBIT,Biotechnology,COMEDK,2024,162801,78677,18306,21531,281315,259784,Yes
RIT,Civil Engineering,COMEDK,2023,199623,76172,17095,24082,316972,292890,No
UVCE,Robotics and Automation Engineering,COMEDK,2023,170717,71140,13222,13946,269025,255079,Yes
AIT,Electrical and Electronics Engineering,COMEDK,2024,249352,80668,15573,27504,373097,345593,No
PRES,Mechanical Engineering,COMEDK,2023,171477,86729,18436,14657,291299,276642,Yes
VSM,Robotics and Automation Engineering,COMEDK,2024,224396,73879,10763,21866,330904,309038,No
RVCE,Electronics and Communication Engineering,KCET,2023,51769,60831,10698,26810,150108,123298,No
RIT,Computer Science and Engineering,KCET,2024,83233,66763,15240,13050,178286,165236,No
RVUNIV,Data Science,COMEDK,2024,190474,69018,10764,27472,297728,270256,Yes
UVCE,Computer Science and Engineering,KCET,2024,69583,71525,17772,13417,172297,158880,Yes
HKBK,Information Science and Engineering,KCET,2023,73980,91289,8661,19821,193751,173930,No
RIT,Aerospace Engineering,KCET,2023,68190,92146,14569,14716,189621,174905,Yes
UVCE,Aerospace Engineering,COMEDK,2024,205327,60780,9541,29760,305408,275648,Yes
UVCE,Civil Engineering,COMEDK,2023,168388,89431,16403,14824,289046,274222,No
ACU,Civil Engineering,COMEDK,2024,205669,61033,13721,16365,296788,280423,No
BMSIT,Electrical and Electronics Engineering,KCET,2024,59556,71395,8745,16862,156558,139696,Yes
UVCE,Biotechnology,COMEDK,2023,225709,73227,15237,22589,336762,314173,Yes
AITM,Information Science and Engineering,KCET,2024,61525,76494,8513,18192,164724,146532,Yes
BIT,Artificial Intelligence and Data Science,KCET,2024,81346,79983,9049,15049,185427,170378,No
MSRUAS,Biotechnology,COMEDK,2023,190280,78234,8152,15478,292144,276666,Yes
PRES,Information Science and Engineering,KCET,2024,81560,66748,15551,29682,193541,163859,Yes
HKBK,Biotechnology,KCET,2023,51225,67540,10491,24132,153388,129256,Yes
RAIT,Electrical and Electronics Engineering,KCET,2023,53272,81815,9897,12677,157661,144984,Yes
SJBCE,Mechanical Engineering,KCET,2023,79701,83324,15484,11727,190236,178509,Yes
JNNCE,Data Science,KCET,2023,56571,64486,10459,13828,145344,131516,Yes
SCEM,Data Science,KCET,2023,77398,74286,8686,27114,187484,160370,No
RVCE,Biotechnology,COMEDK,2023,186409,88062,10856,23668,308995,285327,No
GMIT,Robotics and Automation Engineering,COMEDK,2023,201237,89063,11718,18490,320508,302018,Yes
PRES,Electrical and Electronics Engineering,COMEDK,2023,247998,76389,18747,22265,365399,343134,Yes
CMRIT,Chemical Engineering,KCET,2024,72148,82329,14141,15283,183901,168618,Yes
RAIT,Chemical Engineering,KCET,2023,66652,65580,11126,15045,158403,143358,No
BITM,Computer Science and Engineering,KCET,2024,65551,61555,13821,16427,157354,140927,Yes
SDMCET,Aerospace Engineering,COMEDK,2024,193306,62923,8866,13240,278335,265095,No
PESU,Electrical and Electronics Engineering,COMEDK,2023,232570,76377,17115,20090,346152,326062,Yes
JNNCE,Computer Science and Engineering,COMEDK,2023,219806,74513,13092,13251,320662,307411,No
NMIT,Biotechnology,COMEDK,2024,231205,81453,13676,23056,349390,326334,No
BMSCE,Artificial Intelligence and Data Science,COMEDK,2023,171711,90614,19566,16761,298652,281891,Yes
MSRIT,Chemical Engineering,KCET,2023,59813,87902,15185,20794,183694,162900,No
PESCE,Computer Science and Engineering,KCET,2024,83948,82766,14340,26691,207745,181054,No
HKBK,Mechanical Engineering,KCET,2023,53658,86125,10919,25683,176385,150702,Yes
BITM,Information Science and Engineering,COMEDK,2024,211155,87465,10230,17765,326615,308850,Yes
MVJCE,Civil Engineering,KCET,2023,84195,70012,14545,10268,179020,168752,Yes
JSSSTU,Robotics and Automation Engineering,COMEDK,2024,237485,93001,9082,29129,368697,339568,Yes
AIT,Data Science,KCET,2023,83819,69949,17441,17194,188403,171209,Yes
REVA,Artificial Intelligence and Data Science,COMEDK,2023,203509,77050,8195,24971,313725,288754,No
CITGubbi,Data Science,COMEDK,2023,239819,72290,9881,13238,335228,321990,No
CMRIT,Electronics and Communication Engineering,COMEDK,2023,245121,82171,19847,29026,376165,347139,No
RVUNIV,Information Science and Engineering,COMEDK,2023,223502,81079,17459,18028,340068,322040,Yes
AECMandya,Chemical Engineering,COMEDK,2023,162667,62403,15424,26765,267259,240494,Yes
KLEIT,Civil Engineering,KCET,2024,84769,68778,15587,15730,184864,169134,Yes
PRES,Information Science and Engineering,COMEDK,2023,168882,88792,11827,29709,299210,269501,Yes
JIT,Aerospace Engineering,COMEDK,2024,200986,75185,17719,10471,304361,293890,Yes
MSRUAS,Biotechnology,COMEDK,2024,200025,90077,9229,12359,311690,299331,No
SDMIT,Aerospace Engineering,KCET,2024,53432,65211,12840,12825,144308,131483,Yes
BITM,Information Science and Engineering,COMEDK,2024,220907,64113,15617,14015,314652,300637,No
VemanaIT,Data Science,COMEDK,2024,160901,85446,19847,22221,288415,266194,Yes
MSRIT,Data Science,KCET,2023,51742,74914,14383,12740,153779,141039,No
AEC,Electronics and Communication Engineering,KCET,2024,55461,76008,16851,25537,173857,148320,Yes
EastPoint,Electronics and Communication Engineering,COMEDK,2024,208912,79246,10054,18950,317162,298212,Yes
RVUNIV,Chemical Engineering,KCET,2023,79671,93506,11275,18835,203287,184452,No
BMIT,Chemical Engineering,KCET,2024,59870,89609,9423,29947,188849,158902,No
MSRUAS,Information Science and Engineering,KCET,2023,69453,72171,13518,15371,170513,155142,Yes
VIT,Aerospace Engineering,KCET,2023,82914,63065,17531,22983,186493,163510,No
SJBCE,Aerospace Engineering,COMEDK,2023,200251,69386,8593,14770,293000,278230,Yes
VSM,Electrical and Electronics Engineering,COMEDK,2024,240643,76233,13962,15660,346498,330838,Yes
ACU,Data Science,KCET,2024,54757,94355,8794,18514,176420,157906,Yes
JSSSTU,Aerospace Engineering,KCET,2023,50820,85663,10467,19358,166308,146950,No
AITM,Electronics and Communication Engineering,COMEDK,2023,235402,60608,14529,14684,325223,310539,No
PESCE,Chemical Engineering,COMEDK,2023,230749,78087,9567,27802,346205,318403,No
NIE,Computer Science and Engineering,COMEDK,2024,237206,91475,18767,10873,358321,347448,Yes
VemanaIT,Artificial Intelligence and Data Science,KCET,2024,76629,66529,12173,11374,166705,155331,Yes
AIT,Information Science and Engineering,COMEDK,2023,246647,79660,13264,10156,349727,339571,No
ACU,Data Science,COMEDK,2023,199607,93976,11524,22753,327860,305107,No
JIT,Civil Engineering,KCET,2023,71981,91391,9031,14260,186663,172403,Yes
NIE,Information Science and Engineering,COMEDK,2024,168164,94867,18335,26516,307882,281366,Yes
VVIT,Mechanical Engineering,KCET,2023,51757,69231,10194,18217,149399,131182,Yes
PESU,Civil Engineering,KCET,2024,51331,89594,14776,29837,185538,155701,No
VSM,Civil Engineering,COMEDK,2024,246783,88166,10446,21741,367136,345395,No
BMIT,Aerospace Engineering,COMEDK,2024,236438,80485,11381,19650,347954,328304,No
VSM,Biotechnology,KCET,2024,66524,75983,10035,16407,168949,152542,No
ACU,Biotechnology,KCET,2024,76860,80972,19060,24781,201673,176892,Yes
AIT,Electronics and Communication Engineering,COMEDK,2023,196846,80999,18254,26345,322444,296099,Yes
BIT,Artificial Intelligence and Data Science,COMEDK,2024,213241,61206,13312,24584,312343,287759,Yes
AITM,Biotechnology,KCET,2023,67986,90932,19451,22637,201006,178369,Yes
VIT,Chemical Engineering,KCET,2024,71210,92433,17366,15196,196205,181009,Yes
PESCE,Chemical Engineering,KCET,2024,51597,88425,18638,15962,174622,158660,No
KLEIT,Civil Engineering,KCET,2023,65998,91590,11746,18831,188165,169334,No
BNMIT,Mechanical Engineering,COMEDK,2024,225575,60275,19089,12890,317829,304939,No
DSCE,Biotechnology,KCET,2023,78273,67111,11951,12536,169871,157335,Yes
NCET,Biotechnology,KCET,2023,70043,86056,17897,15553,189549,173996,No
VSM,Artificial Intelligence and Data Science,COMEDK,2024,192920,80332,9296,29220,311768,282548,Yes
BNMIT,Mechanical Engineering,COMEDK,2023,198981,92665,15197,27549,334392,306843,No
MSRIT,Electrical and Electronics Engineering,KCET,2024,73489,88631,17912,14132,194164,180032,No
AECMandya,Electronics and Communication Engineering,COMEDK,2024,237136,84616,11459,17313,350524,333211,Yes
VVCE,Electrical and Electronics Engineering,COMEDK,2024,169440,90548,14922,16710,291620,274910,No
MSRIT,Chemical Engineering,KCET,2024,60811,86081,17484,15327,179703,164376,No
SJBCE,Artificial Intelligence and Data Science,COMEDK,2024,214006,88293,16361,29824,348484,318660,No
RVCE,Biotechnology,COMEDK,2024,173800,77017,9172,29247,289236,259989,Yes
RNSIT,Robotics and Automation Engineering,KCET,2024,81898,84529,17761,23251,207439,184188,No
DSATM,Chemical Engineering,COMEDK,2023,169329,76488,14938,26270,287025,260755,Yes
BIT,Data Science,COMEDK,2023,185863,74778,9803,25277,295721,270444,No
BMIT,Data Science,COMEDK,2024,222478,87277,11823,27872,349450,321578,No
BMSIT,Computer Science and Engineering,COMEDK,2024,237409,88709,18814,11410,356342,344932,Yes
HKBK,Data Science,COMEDK,2023,169177,65038,9297,28737,272249,243512,Yes
NCET,Civil Engineering,COMEDK,2024,190492,70933,18609,29402,309436,280034,No
HKBK,Robotics and Automation Engineering,KCET,2023,83971,85041,15423,20124,204559,184435,No
GIT,Data Science,KCET,2023,68761,93616,18492,25784,206653,180869,Yes
RAIT,Aerospace Engineering,COMEDK,2024,208792,83344,8952,17052,318140,301088,No
ACU,Aerospace Engineering,KCET,2023,66517,63236,10857,29818,170428,140610,No
ACU,Civil Engineering,KCET,2024,50753,73850,10430,20351,155384,135033,Yes
SIT,Biotechnology,COMEDK,2024,182510,68373,12175,15375,278433,263058,Yes
BNMIT,Mechanical Engineering,KCET,2024,73292,62082,16849,18384,170607,152223,No
KSIT,Artificial Intelligence and Data Science,COMEDK,2024,175364,94892,9839,16792,296887,280095,Yes
VIT,Electrical and Electronics Engineering,KCET,2023,71953,85636,19040,13546,190175,176629,No
SIT,Information Science and Engineering,KCET,2024,52394,65600,11346,19050,148390,129340,Yes
MVJCE,Mechanical Engineering,COMEDK,2024,165155,93032,19095,23934,301216,277282,Yes
DSCE,Robotics and Automation Engineering,COMEDK,2023,207017,65680,13623,26405,312725,286320,No
RVUNIV,Computer Science and Engineering,KCET,2024,82472,82421,19317,16508,200718,184210,Yes
UVCE,Mechanical Engineering,COMEDK,2023,221292,72957,18832,21836,334917,313081,No
BMSIT,Chemical Engineering,KCET,2024,64210,81425,16138,29006,190779,161773,No
DSATM,Chemical Engineering,COMEDK,2023,166989,77101,14024,22372,280486,258114,No
RIT,Data Science,COMEDK,2024,245814,64699,11368,15933,337814,321881,Yes
CMRIT,Information Science and Engineering,KCET,2024,53773,77799,8080,25271,164923,139652,No
JSSSTU,Aerospace Engineering,COMEDK,2024,163379,81168,17564,10482,272593,262111,No
NMIT,Mechanical Engineering,KCET,2023,74250,75056,17618,19161,186085,166924,No
RAIT,Robotics and Automation Engineering,COMEDK,2024,183200,68089,18220,25355,294864,269509,Yes
SDMCET,Electrical and Electronics Engineering,COMEDK,2024,199452,73681,13856,12240,299229,286989,Yes
NMIT,Electronics and Communication Engineering,KCET,2024,82439,60418,11478,26458,180793,154335,No
VIT,Chemical Engineering,COMEDK,2023,229603,84891,13070,27468,355032,327564,No
YKCE,Aerospace Engineering,COMEDK,2023,231883,88457,17076,12434,349850,337416,No
SJBIT,Robotics and Automation Engineering,COMEDK,2024,243306,89833,11743,17070,361952,344882,Yes
VVCE,Artificial Intelligence and Data Science,COMEDK,2023,177547,70979,12598,22656,283780,261124,No
HKBK,Mechanical Engineering,KCET,2023,62080,66176,13442,28018,169716,141698,Yes
BMSCE,Biotechnology,KCET,2023,71803,85847,16186,28562,202398,173836,Yes
PESU,Mechanical Engineering,KCET,2024,80736,90918,13502,16041,201197,185156,Yes
GMIT,Robotics and Automation Engineering,KCET,2023,59949,85704,9485,27581,182719,155138,No
KLEIT,Aerospace Engineering,COMEDK,2024,222631,90547,17824,17767,348769,331002,No
PRES,Artificial Intelligence and Data Science,COMEDK,2023,212220,88633,15178,15997,332028,316031,Yes
SDMIT,Mechanical Engineering,COMEDK,2023,197406,90561,11000,25432,324399,298967,No
RVUNIV,Biotechnology,COMEDK,2024,229497,86762,19840,13747,349846,336099,Yes
SJBIT,Biotechnology,COMEDK,2023,242439,79351,19507,19902,361199,341297,Yes
KSIT,Information Science and Engineering,COMEDK,2023,213994,93951,18761,17680,344386,326706,Yes
ACU,Chemical Engineering,COMEDK,2024,246250,83842,17709,17374,365175,347801,Yes
VSM,Mechanical Engineering,COMEDK,2023,232740,63931,14019,27718,338408,310690,No
PESU,Mechanical Engineering,COMEDK,2023,185002,78825,11729,18169,293725,275556,Yes
DrAIT,Artificial Intelligence and Data Science,KCET,2024,74973,94507,8627,11364,189471,178107,Yes
SJBIT,Computer Science and Engineering,KCET,2023,63161,72326,16685,18852,171024,152172,Yes
DSCE,Mechanical Engineering,COMEDK,2024,186217,78267,8652,10547,283683,273136,No
JNNCE,Chemical Engineering,COMEDK,2024,180359,77265,8731,16527,282882,266355,No
DSATM,Mechanical Engineering,COMEDK,2023,192200,91676,13254,29553,326683,297130,No
SJBCE,Data Science,KCET,2024,75179,66299,18826,24398,184702,160304,No
SDMCET,Aerospace Engineering,COMEDK,2023,168386,87883,14680,22543,293492,270949,No
MVJCE,Electrical and Electronics Engineering,COMEDK,2024,222955,65074,11326,23123,322478,299355,Yes
SDMIT,Biotechnology,COMEDK,2023,247910,92519,8321,18066,366816,348750,Yes
MSRUAS,Civil Engineering,KCET,2024,58259,62639,15058,26464,162420,135956,Yes
CMRIT,Robotics and Automation Engineering,KCET,2024,82703,84540,13104,23537,203884,180347,No
VemanaIT,Aerospace Engineering,KCET,2024,63853,89677,9907,18293,181730,163437,Yes
NMIT,Civil Engineering,COMEDK,2023,213244,91095,18185,25637,348161,322524,Yes
RVUNIV,Computer Science and Engineering,COMEDK,2024,227934,71935,16024,19596,335489,315893,Yes
RAIT,Computer Science and Engineering,COMEDK,2024,212174,83439,15667,29074,340354,311280,Yes
ACU,Information Science and Engineering,KCET,2024,74149,71173,19688,18075,183085,165010,No
JNNCE,Robotics and Automation Engineering,KCET,2023,65812,60494,13712,22765,162783,140018,No
NMIT,Civil Engineering,COMEDK,2024,242697,79878,10334,19029,351938,332909,Yes
SIT,Data Science,KCET,2024,67924,80713,19945,21330,189912,168582,Yes
SJBCE,Data Science,KCET,2023,71991,85383,8792,16831,182997,166166,No
HKBK,Chemical Engineering,KCET,2024,58042,67145,8314,25954,159455,133501,No
BIT,Civil Engineering,KCET,2024,84837,82894,9052,15067,191850,176783,No
VIT,Data Science,COMEDK,2023,208552,81271,9385,15182,314390,299208,No
BNMIT,Electrical and Electronics Engineering,KCET,2023,74613,88650,19459,12488,195210,182722,No
PESCE,Information Science and Engineering,KCET,2024,65718,87048,17958,24494,195218,170724,Yes
RNSIT,Robotics and Automation Engineering,KCET,2024,50925,69975,15724,22204,158828,136624,Yes
NIE,Electrical and Electronics Engineering,COMEDK,2024,198136,79419,19995,15479,313029,297550,Yes
SJBIT,Civil Engineering,COMEDK,2024,236874,79264,10503,22075,348716,326641,Yes
SIT,Mechanical Engineering,COMEDK,2023,226327,79323,11082,26148,342880,316732,No
SJBIT,Biotechnology,KCET,2024,60646,64294,17959,24132,167031,142899,No
REVA,Computer Science and Engineering,COMEDK,2024,234492,83919,17905,28625,364941,336316,Yes
ACU,Data Science,KCET,2024,54404,86356,19534,23940,184234,160294,Yes
PESU,Artificial Intelligence and Data Science,COMEDK,2024,181147,62890,8272,15104,267413,252309,Yes
VVIT,Electronics and Communication Engineering,KCET,2023,58393,70967,16630,10084,156074,145990,Yes
KLSGIT,Civil Engineering,COMEDK,2024,175333,66289,9762,27525,278909,251384,No
MSRUAS,Chemical Engineering,COMEDK,2023,204847,69392,10852,18352,303443,285091,No
SITM,Artificial Intelligence and Data Science,KCET,2023,77288,69054,14324,16877,177543,160666,No
SCEM,Artificial Intelligence and Data Science,KCET,2023,80680,80584,8645,26403,196312,169909,No
DSCE,Chemical Engineering,COMEDK,2024,230172,85068,9544,10470,335254,324784,Yes
BMSIT,Data Science,KCET,2024,80993,60741,10503,13275,165512,152237,Yes
NHCE,Electronics and Communication Engineering,KCET,2024,63300,68530,8808,29234,169872,140638,Yes
REVA,Civil Engineering,KCET,2024,53272,73933,18045,19712,164962,145250,No
YKCE,Computer Science and Engineering,KCET,2024,79837,68776,16921,28068,193602,165534,No
CMRIT,Biotechnology,COMEDK,2023,225018,70163,12860,25868,333909,308041,No
GMIT,Artificial Intelligence and Data Science,KCET,2024,63223,88549,13150,23679,188601,164922,Yes
YKCE,Chemical Engineering,COMEDK,2023,229382,66002,8497,17067,320948,303881,No
KLSGIT,Mechanical Engineering,COMEDK,2024,160356,72182,8129,20653,261320,240667,Yes
SDMCET,Computer Science and Engineering,KCET,2023,82345,64299,15014,29906,191564,161658,No
SITM,Robotics and Automation Engineering,KCET,2024,57239,68908,9143,10396,145686,135290,Yes
CMRIT,Electronics and Communication Engineering,COMEDK,2023,234268,70985,17530,25426,348209,322783,No
GMIT,Chemical Engineering,COMEDK,2023,229983,64966,12293,11386,318628,307242,Yes
AITM,Robotics and Automation Engineering,COMEDK,2023,171492,75066,15995,20940,283493,262553,No
MVJCE,Data Science,KCET,2024,79685,80722,18319,14037,192763,178726,No
JSSSTU,Information Science and Engineering,KCET,2023,50076,71672,11448,27730,160926,133196,No
BMSCE,Chemical Engineering,COMEDK,2023,199324,93987,11187,26325,330823,304498,Yes
UVCE,Computer Science and Engineering,KCET,2023,50989,72062,13166,19201,155418,136217,No
NIE,Aerospace Engineering,COMEDK,2023,177241,74234,10975,27295,289745,262450,Yes
DBIT,Information Science and Engineering,KCET,2024,78553,62269,9878,19352,170052,150700,No
VSM,Chemical Engineering,COMEDK,2024,184291,86910,17114,15981,304296,288315,No
HKBK,Electronics and Communication Engineering,KCET,2023,78734,80649,14320,21540,195243,173703,No
AECMandya,Electrical and Electronics Engineering,COMEDK,2023,234432,62023,13963,25531,335949,310418,Yes
JIT,Artificial Intelligence and Data Science,KCET,2024,72164,78626,8084,29077,187951,158874,No
VVCE,Data Science,KCET,2024,61241,71124,14260,13241,159866,146625,Yes
NIE,Electronics and Communication Engineering,COMEDK,2023,220393,68725,9361,25664,324143,298479,No
SDMIT,Data Science,COMEDK,2023,249584,75396,19293,19015,363288,344273,No
BMSIT,Electronics and Communication Engineering,COMEDK,2024,200465,63125,8573,15614,287777,272163,Yes
AECMandya,Computer Science and Engineering,KCET,2024,72784,78815,10869,13855,176323,162468,No
GIT,Electronics and Communication Engineering,KCET,2024,70280,78068,17223,23115,188686,165571,Yes
NHCE,Electrical and Electronics Engineering,COMEDK,2024,183996,89815,12484,10692,296987,286295,Yes
JNNCE,Civil Engineering,COMEDK,2023,235339,82928,12998,10904,342169,331265,No
DrAIT,Mechanical Engineering,COMEDK,2023,237992,71791,19312,10877,339972,329095,Yes
SIT,Robotics and Automation Engineering,COMEDK,2024,176314,68129,12301,10276,267020,256744,No
DSATM,Computer Science and Engineering,KCET,2023,69934,66882,11550,16423,164789,148366,Yes
MSRUAS,Mechanical Engineering,KCET,2023,77485,67395,11410,22248,178538,156290,No
PESU,Biotechnology,COMEDK,2023,170235,63026,12574,14134,259969,245835,Yes
NIE,Electrical and Electronics Engineering,COMEDK,2023,175049,74419,19947,14731,284146,269415,No
GIT,Mechanical Engineering,KCET,2023,79278,78214,15013,20947,193452,172505,Yes
SITM,Electrical and Electronics Engineering,COMEDK,2024,173792,67829,8831,10485,260937,250452,Yes
VVCE,Data Science,COMEDK,2023,216698,85045,19749,19064,340556,321492,Yes
PRES,Chemical Engineering,KCET,2024,71327,90150,12125,18962,192564,173602,Yes
MSRIT,Electrical and Electronics Engineering,COMEDK,2023,203445,63850,9355,24031,300681,276650,Yes
DSATM,Chemical Engineering,COMEDK,2024,176906,72321,17610,12596,279433,266837,No
KLEIT,Aerospace Engineering,COMEDK,2023,183405,60216,16934,25230,285785,260555,Yes
PESCE,Data Science,COMEDK,2024,186334,62616,16561,16058,281569,265511,No
HKBK,Computer Science and Engineering,KCET,2024,70580,69461,12928,10857,163826,152969,Yes
CMRIT,Biotechnology,COMEDK,2023,234839,65028,15420,21220,336507,315287,No
BITM,Civil Engineering,COMEDK,2024,210599,62134,13678,16730,303141,286411,No
NHCE,Electronics and Communication Engineering,KCET,2024,78379,72799,19344,19362,189884,170522,Yes
AITM,Biotechnology,COMEDK,2023,236592,68332,9005,20720,334649,313929,Yes
BMSIT,Artificial Intelligence and Data Science,COMEDK,2023,168198,78884,11005,22878,280965,258087,Yes
PRES,Biotechnology,KCET,2023,69078,66239,19862,10648,165827,155179,No
SDMIT,Artificial Intelligence and Data Science,KCET,2023,84951,64002,15064,13659,177676,164017,Yes
RVCE,Electronics and Communication Engineering,COMEDK,2024,174882,93308,12151,29422,309763,280341,No
YKCE,Civil Engineering,KCET,2023,84005,77908,13849,18787,194549,175762,No
EastPoint,Biotechnology,COMEDK,2024,166642,60867,9245,15419,252173,236754,No
KLSGIT,Artificial Intelligence and Data Science,KCET,2024,77856,71706,19768,24558,193888,169330,Yes
AIT,Civil Engineering,KCET,2024,54598,73112,17738,22253,167701,145448,Yes
PESU,Mechanical Engineering,COMEDK,2023,164226,74156,10558,13330,262270,248940,No
JIT,Data Science,COMEDK,2023,185801,71902,9470,22117,289290,267173,No
SDMIT,Artificial Intelligence and Data Science,KCET,2023,75839,77790,10032,21265,184926,163661,No
DSCE,Civil Engineering,COMEDK,2024,180048,73141,10629,17953,281771,263818,No
NHCE,Electronics and Communication Engineering,KCET,2023,80229,76086,16299,19749,192363,172614,No
RNSIT,Aerospace Engineering,KCET,2024,84990,67212,11704,23607,187513,163906,Yes
DSCE,Electronics and Communication Engineering,COMEDK,2024,243661,87669,18933,17800,368063,350263,No
YKCE,Information Science and Engineering,KCET,2024,56640,89834,13055,25699,185228,159529,Yes
RVCE,Artificial Intelligence and Data Science,KCET,2024,83829,72283,10176,18593,184881,166288,No
DBIT,Aerospace Engineering,COMEDK,2024,220411,87360,19001,23617,350389,326772,No
AITM,Chemical Engineering,COMEDK,2024,214945,61367,14868,24341,315521,291180,Yes
SJBCE,Data Science,KCET,2024,77006,74139,8224,27906,187275,159369,Yes
BMSIT,Chemical Engineering,COMEDK,2023,166077,63367,13562,28752,271758,243006,Yes
DBIT,Civil Engineering,KCET,2024,80298,88481,12375,17699,198853,181154,Yes
DrAIT,Chemical Engineering,COMEDK,2024,206960,60759,18577,10739,297035,286296,Yes
SIT,Aerospace Engineering,COMEDK,2023,161132,86846,16958,10808,275744,264936,No
SITM,Biotechnology,COMEDK,2024,244864,75789,13531,11324,345508,334184,Yes
KLSGIT,Chemical Engineering,COMEDK,2023,220719,94032,9325,20115,344191,324076,Yes
DBIT,Artificial Intelligence and Data Science,KCET,2023,52627,72363,9669,13009,147668,134659,No
BMSIT,Civil Engineering,KCET,2023,72339,88574,12386,25495,198794,173299,Yes
ACU,Data Science,COMEDK,2023,179170,85879,8938,23650,297637,273987,No
YKCE,Information Science and Engineering,KCET,2024,72370,90099,14484,10074,187027,176953,Yes
SDMCET,Chemical Engineering,COMEDK,2024,244791,92997,10522,13989,362299,348310,Yes
AECMandya,Electrical and Electronics Engineering,COMEDK,2023,195791,64686,12278,17353,290108,272755,No
AITM,Computer Science and Engineering,COMEDK,2024,209983,60224,16325,23334,309866,286532,Yes
AEC,Civil Engineering,COMEDK,2023,231727,65132,18658,22350,337867,315517,No
GMIT,Electrical and Electronics Engineering,COMEDK,2024,246316,74419,17723,12245,350703,338458,Yes
SIT,Civil Engineering,COMEDK,2024,188459,65170,13152,19995,286776,266781,No
PRES,Data Science,KCET,2024,50546,83155,16929,23345,173975,150630,No
MSRUAS,Electrical and Electronics Engineering,KCET,2023,79091,82369,19476,14689,195625,180936,No
DrAIT,Artificial Intelligence and Data Science,KCET,2024,64576,79527,13989,17359,175451,158092,Yes
MVJCE,Electrical and Electronics Engineering,COMEDK,2023,212871,92578,14625,21448,341522,320074,No
SCEM,Data Science,COMEDK,2023,200989,84259,17281,23605,326134,302529,Yes
BNMIT,Civil Engineering,KCET,2023,68414,63196,14941,14747,161298,146551,No
RNSIT,Information Science and Engineering,KCET,2023,68863,83480,8930,10150,171423,161273,No
JIT,Robotics and Automation Engineering,KCET,2024,75473,93034,14555,17991,201053,183062,No
KLEIT,Electrical and Electronics Engineering,COMEDK,2024,210804,71121,19313,26162,327400,301238,Yes
NMIT,Computer Science and Engineering,COMEDK,2024,168651,66420,9685,22667,267423,244756,No
BITM,Biotechnology,KCET,2023,68789,79090,12966,14887,175732,160845,Yes
BIT,Mechanical Engineering,KCET,2024,59345,84098,13833,20771,178047,157276,No
JIT,Chemical Engineering,KCET,2023,67452,64363,17060,24690,173565,148875,No
AITM,Aerospace Engineering,KCET,2024,75512,92187,16045,22246,205990,183744,No
DBIT,Data Science,COMEDK,2023,195284,89324,15403,23258,323269,300011,Yes
PRES,Robotics and Automation Engineering,COMEDK,2023,206648,88574,13285,27664,336171,308507,Yes
NCET,Artificial Intelligence and Data Science,COMEDK,2024,163950,84045,10732,14838,273565,258727,No
BMSIT,Biotechnology,KCET,2023,50525,75586,12587,29047,167745,138698,No
DSCE,Robotics and Automation Engineering,KCET,2024,69239,77104,19982,25348,191673,166325,No
VSM,Data Science,KCET,2024,62633,93243,15248,21282,192406,171124,Yes
VVCE,Electrical and Electronics Engineering,COMEDK,2023,216072,65980,9770,22230,314052,291822,No
SITM,Information Science and Engineering,COMEDK,2024,227371,79171,14266,29432,350240,320808,No
SJBCE,Information Science and Engineering,KCET,2023,59038,84373,13240,24000,180651,156651,Yes
RVCE,Artificial Intelligence and Data Science,KCET,2023,74906,62884,12241,21343,171374,150031,No
RVCE,Data Science,COMEDK,2024,191103,61078,11788,15583,279552,263969,Yes
SDMCET,Artificial Intelligence and Data Science,COMEDK,2024,246433,62011,16446,22991,347881,324890,No
NMIT,Data Science,KCET,2023,84502,94305,17674,15129,211610,196481,No
KLSGIT,Electrical and Electronics Engineering,COMEDK,2023,191323,78985,10013,21686,302007,280321,No
MSRUAS,Information Science and Engineering,KCET,2024,64467,71575,12001,20854,168897,148043,Yes
BITM,Electrical and Electronics Engineering,KCET,2024,54122,82792,13189,27743,177846,150103,No
AIT,Artificial Intelligence and Data Science,COMEDK,2024,165840,82524,15304,17885,281553,263668,No
KLSGIT,Aerospace Engineering,COMEDK,2023,240116,69483,8488,12817,330904,318087,No
PESU,Electrical and Electronics Engineering,COMEDK,2023,244082,83078,11749,14156,353065,338909,Yes
SJBCE,Robotics and Automation Engineering,COMEDK,2023,199552,85226,16341,29747,330866,301119,No
JSSSTU,Artificial Intelligence and Data Science,COMEDK,2023,229749,66434,14794,11327,322304,310977,Yes
GIT,Biotechnology,KCET,2024,67377,75574,13160,29985,186096,156111,No
JSSSTU,Information Science and Engineering,COMEDK,2024,190416,88500,17506,19161,315583,296422,Yes
RAIT,Computer Science and Engineering,KCET,2024,69985,72269,14905,27950,185109,157159,Yes
BNMIT,Robotics and Automation Engineering,COMEDK,2024,193616,89962,16773,11681,312032,300351,No
RVUNIV,Electronics and Communication Engineering,COMEDK,2024,180937,67844,16441,10845,276067,265222,Yes
RVUNIV,Artificial Intelligence and Data Science,KCET,2023,68496,75930,8378,19602,172406,152804,No
SIT,Civil Engineering,KCET,2024,58707,72617,18379,11831,161534,149703,No
BNMIT,Aerospace Engineering,COMEDK,2023,201423,84196,16151,23534,325304,301770,No
BMSIT,Computer Science and Engineering,COMEDK,2023,244969,70285,12375,16221,343850,327629,Yes
SCEM,Aerospace Engineering,COMEDK,2024,200888,92266,14288,20212,327654,307442,No
BMSCE,Electrical and Electronics Engineering,COMEDK,2024,186417,76045,14236,14565,291263,276698,Yes
SJBIT,Chemical Engineering,KCET,2024,62893,65401,10178,18741,157213,138472,No
REVA,Chemical Engineering,COMEDK,2023,229062,82320,15429,14206,341017,326811,Yes
MSRIT,Chemical Engineering,KCET,2024,73768,81801,9474,18385,183428,165043,Yes
BMSCE,Electrical and Electronics Engineering,COMEDK,2023,246464,82101,14926,18810,362301,343491,No
SDMCET,Data Science,COMEDK,2024,244329,71370,11209,28158,355066,326908,No
MVJCE,Aerospace Engineering,KCET,2024,50072,83136,14200,24810,172218,147408,Yes
NMIT,Electronics and Communication Engineering,KCET,2024,68775,62015,12365,25034,168189,143155,No
YKCE,Biotechnology,KCET,2023,59884,79381,12481,15469,167215,151746,Yes
PESCE,Chemical Engineering,COMEDK,2024,248277,89228,12233,20938,370676,349738,Yes
RIT,Robotics and Automation Engineering,COMEDK,2024,191208,91218,19426,28651,330503,301852,Yes
KSIT,Biotechnology,COMEDK,2024,184322,72883,11340,14867,283412,268545,No
VemanaIT,Computer Science and Engineering,COMEDK,2023,231658,91035,19151,26125,367969,341844,No
VVCE,Robotics and Automation Engineering,COMEDK,2024,233322,71714,9394,10756,325186,314430,Yes
RIT,Chemical Engineering,COMEDK,2023,214157,92165,13114,10882,330318,319436,Yes
KSIT,Aerospace Engineering,KCET,2024,52961,69820,11797,19773,154351,134578,Yes
VIT,Data Science,KCET,2023,76653,76806,14202,21958,189619,167661,No
VSM,Aerospace Engineering,COMEDK,2024,248974,64931,17785,24120,355810,331690,Yes
DSATM,Biotechnology,KCET,2023,69823,60241,12567,16013,158644,142631,No
MSRIT,Information Science and Engineering,COMEDK,2024,194627,69673,13846,28445,306591,278146,Yes
MVJCE,Chemical Engineering,COMEDK,2024,214104,63159,13395,29433,320091,290658,Yes
RVCE,Electronics and Communication Engineering,KCET,2024,78218,77066,19630,20357,195271,174914,No
AITM,Aerospace Engineering,COMEDK,2024,239213,81329,18215,13188,351945,338757,Yes
NIE,Biotechnology,KCET,2023,84124,83887,16828,22080,206919,184839,Yes
VVIT,Mechanical Engineering,KCET,2024,77560,71299,18620,11002,178481,167479,No
GMIT,Mechanical Engineering,KCET,2024,71387,78141,15461,11328,176317,164989,No
DrAIT,Aerospace Engineering,COMEDK,2023,223016,69466,14402,28750,335634,306884,Yes
RIT,Artificial Intelligence and Data Science,KCET,2024,54921,85075,16806,23252,180054,156802,Yes
RIT,Mechanical Engineering,COMEDK,2024,210426,94734,9059,23382,337601,314219,Yes
RAIT,Data Science,KCET,2024,55673,69466,13326,11487,149952,138465,Yes
DSATM,Mechanical Engineering,KCET,2023,70136,93935,11776,18442,194289,175847,No
VemanaIT,Artificial Intelligence and Data Science,COMEDK,2023,224538,73822,10982,16127,325469,309342,Yes
SJBCE,Electronics and Communication Engineering,COMEDK,2024,213950,73172,16079,17788,320989,303201,Yes
BIT,Electrical and Electronics Engineering,KCET,2023,68378,87553,16487,19863,192281,172418,Yes
DSCE,Civil Engineering,COMEDK,2023,232550,92115,9255,28648,362568,333920,Yes
SDMIT,Information Science and Engineering,COMEDK,2023,207392,61145,18473,27461,314471,287010,No
JNNCE,Biotechnology,KCET,2024,68575,74811,8067,14740,166193,151453,Yes
AITM,Computer Science and Engineering,COMEDK,2023,171113,94232,14567,18406,298318,279912,No
AEC,Electronics and Communication Engineering,COMEDK,2024,205639,70910,15220,21525,313294,291769,Yes
JSSSTU,Electronics and Communication Engineering,COMEDK,2023,170097,60484,8297,28882,267760,238878,Yes
AECMandya,Chemical Engineering,KCET,2023,61148,85470,9938,25746,182302,156556,No
JSSSTU,Chemical Engineering,COMEDK,2024,183431,82954,19160,10725,296270,285545,Yes
REVA,Electronics and Communication Engineering,COMEDK,2023,160050,67377,16705,21494,265626,244132,No
SIT,Information Science and Engineering,COMEDK,2023,217560,77676,13975,29117,338328,309211,Yes
NHCE,Artificial Intelligence and Data Science,KCET,2023,66221,64504,9565,14715,155005,140290,No
RNSIT,Biotechnology,COMEDK,2024,204600,90600,10731,11401,317332,305931,Yes
GIT,Electrical and Electronics Engineering,COMEDK,2024,168161,82390,11538,17474,279563,262089,Yes
JIT,Robotics and Automation Engineering,KCET,2024,65036,67531,8597,23611,164775,141164,Yes
NMIT,Electronics and Communication Engineering,KCET,2023,54044,73761,15371,20123,163299,143176,Yes
CITGubbi,Biotechnology,COMEDK,2024,180813,92379,17003,10688,300883,290195,Yes
RIT,Biotechnology,COMEDK,2023,188673,80190,19263,15439,303565,288126,No
GMIT,Aerospace Engineering,KCET,2024,82717,73456,18367,19435,193975,174540,Yes
NIE,Chemical Engineering,COMEDK,2024,236139,80237,18106,21267,355749,334482,No
BIT,Artificial Intelligence and Data Science,KCET,2023,63532,82387,17493,26192,189604,163412,Yes
SDMIT,Information Science and Engineering,KCET,2023,82729,69186,15766,24609,192290,167681,Yes
EastPoint,Mechanical Engineering,COMEDK,2024,161111,65030,12311,24033,262485,238452,No
PESCE,Electronics and Communication Engineering,COMEDK,2024,225933,88851,8948,12871,336603,323732,Yes
DrAIT,Aerospace Engineering,KCET,2023,81048,70066,13972,14840,179926,165086,Yes
MSRUAS,Chemical Engineering,COMEDK,2024,174788,91842,12009,20118,298757,278639,Yes
SDMCET,Civil Engineering,KCET,2023,60678,82418,14358,21747,179201,157454,Yes
UVCE,Electronics and Communication Engineering,KCET,2024,81998,76780,8314,10805,177897,167092,Yes
SCEM,Artificial Intelligence and Data Science,COMEDK,2023,174748,73428,10526,29178,287880,258702,No
MSRIT,Electrical and Electronics Engineering,COMEDK,2023,217938,69627,19188,18143,324896,306753,No
AECMandya,Aerospace Engineering,COMEDK,2024,164571,89174,12420,20097,286262,266165,Yes
VVIT,Civil Engineering,COMEDK,2023,212800,75340,12368,22594,323102,300508,Yes
DSCE,Information Science and Engineering,KCET,2024,69290,66475,17603,10969,164337,153368,No
NIE,Civil Engineering,COMEDK,2023,218533,65374,18617,27547,330071,302524,Yes
GIT,Aerospace Engineering,COMEDK,2023,231588,65788,8995,15544,321915,306371,Yes
RVUNIV,Biotechnology,COMEDK,2024,241574,76292,15863,29950,363679,333729,Yes
YKCE,Data Science,COMEDK,2023,223051,79629,8308,26751,337739,310988,Yes
JSSSTU,Computer Science and Engineering,COMEDK,2023,164372,67578,15835,24698,272483,247785,Yes
DSATM,Aerospace Engineering,COMEDK,2024,239739,70417,11096,11924,333176,321252,No
AIT,Aerospace Engineering,COMEDK,2024,243741,82774,14463,25337,366315,340978,Yes
VVIT,Biotechnology,KCET,2024,69221,66110,13184,29767,178282,148515,No
RAIT,Electronics and Communication Engineering,COMEDK,2023,173360,85422,12225,26039,297046,271007,No
SITM,Civil Engineering,COMEDK,2024,170057,64132,11824,17149,263162,246013,Yes
AEC,Information Science and Engineering,KCET,2024,75811,75104,18797,12930,182642,169712,Yes
RVCE,Computer Science and Engineering,COMEDK,2023,234231,94379,8957,12701,350268,337567,Yes
KSIT,Data Science,COMEDK,2023,228938,62883,17437,12140,321398,309258,Yes
GMIT,Biotechnology,KCET,2024,60171,90656,8659,23740,183226,159486,No
AITM,Data Science,KCET,2024,69819,82595,8758,29483,190655,161172,No
RVUNIV,Information Science and Engineering,COMEDK,2024,214683,84345,16040,19199,334267,315068,Yes
BMSCE,Aerospace Engineering,COMEDK,2024,178839,85508,18089,21064,303500,282436,No
VIT,Mechanical Engineering,KCET,2023,71968,71658,8586,12720,164932,152212,Yes
RNSIT,Mechanical Engineering,KCET,2024,63194,93835,19218,13269,189516,176247,No
VIT,Biotechnology,KCET,2023,81098,76362,13191,19563,190214,170651,No
SDMCET,Civil Engineering,KCET,2023,51041,69223,11966,15105,147335,132230,No
DrAIT,Information Science and Engineering,KCET,2024,67177,86409,10831,26694,191111,164417,Yes
AITM,Artificial Intelligence and Data Science,COMEDK,2024,203441,80019,14772,22391,320623,298232,No
NCET,Chemical Engineering,COMEDK,2024,207281,86896,10576,11255,316008,304753,No
NIE,Robotics and Automation Engineering,COMEDK,2023,211997,66018,8505,13415,299935,286520,No
KSIT,Artificial Intelligence and Data Science,COMEDK,2024,204061,75630,18223,25743,323657,297914,No
DSATM,Robotics and Automation Engineering,COMEDK,2024,203388,63337,16472,28682,311879,283197,Yes
RVUNIV,Chemical Engineering,KCET,2023,75780,84776,18772,18933,198261,179328,No
JNNCE,Computer Science and Engineering,KCET,2023,71228,92763,14833,10606,189430,178824,No
SCEM,Biotechnology,KCET,2023,56337,80180,11308,12170,159995,147825,No
MVJCE,Aerospace Engineering,KCET,2024,82808,84769,9569,19377,196523,177146,Yes
MVJCE,Chemical Engineering,KCET,2024,69664,74237,13952,28994,186847,157853,Yes
VemanaIT,Mechanical Engineering,KCET,2023,64260,73979,8774,11493,158506,147013,Yes
AEC,Information Science and Engineering,KCET,2024,76542,69676,8899,10712,165829,155117,No
SIT,Computer Science and Engineering,COMEDK,2024,181698,78320,15169,18280,293467,275187,No
JNNCE,Computer Science and Engineering,COMEDK,2024,192222,85306,17996,26954,322478,295524,Yes
EastPoint,Electrical and Electronics Engineering,COMEDK,2023,173850,64832,13261,24354,276297,251943,No
VSM,Electronics and Communication Engineering,COMEDK,2023,161417,83704,16672,19989,281782,261793,No
AECMandya,Robotics and Automation Engineering,COMEDK,2024,238347,66379,14155,16615,335496,318881,Yes
KLEIT,Electrical and Electronics Engineering,KCET,2023,59756,69646,14404,25416,169222,143806,Yes
EastPoint,Electrical and Electronics Engineering,KCET,2023,77020,81640,13593,19414,191667,172253,Yes
JNNCE,Robotics and Automation Engineering,KCET,2023,65628,91420,13922,14455,185425,170970,Yes
RAIT,Civil Engineering,KCET,2023,71632,76998,15138,13405,177173,163768,No
MSRUAS,Mechanical Engineering,COMEDK,2023,235299,74088,14560,12408,336355,323947,No
ACU,Robotics and Automation Engineering,COMEDK,2023,185896,86016,11801,10738,294451,283713,Yes
MSRUAS,Artificial Intelligence and Data Science,KCET,2024,83428,69081,13606,15122,181237,166115,Yes
MSRIT,Electrical and Electronics Engineering,COMEDK,2023,237808,90582,11388,13923,353701,339778,Yes
BMSIT,Mechanical Engineering,COMEDK,2023,230101,78451,16402,17302,342256,324954,Yes
VSM,Mechanical Engineering,KCET,2023,53438,84041,8736,12919,159134,146215,No
NMIT,Electrical and Electronics Engineering,KCET,2023,58605,65448,14188,22753,160994,138241,Yes
VVCE,Artificial Intelligence and Data Science,KCET,2024,65623,74229,16127,10877,166856,155979,Yes
AITM,Civil Engineering,COMEDK,2024,184366,89109,18348,24726,316549,291823,Yes
JIT,Robotics and Automation Engineering,COMEDK,2024,231499,87438,13635,15388,347960,332572,Yes
YKCE,Computer Science and Engineering,KCET,2023,66242,74852,13107,26992,181193,154201,Yes
GMIT,Computer Science and Engineering,KCET,2024,70406,79920,13584,19375,183285,163910,Yes
EastPoint,Chemical Engineering,COMEDK,2024,209946,74316,13860,29590,327712,298122,Yes
SJBIT,Electronics and Communication Engineering,KCET,2023,77769,76389,9751,10793,174702,163909,Yes
NMIT,Artificial Intelligence and Data Science,KCET,2023,74848,86720,14205,17629,193402,175773,Yes
JNNCE,Aerospace Engineering,KCET,2024,76442,67266,11711,15725,171144,155419,Yes
DrAIT,Computer Science and Engineering,KCET,2023,77040,64251,15134,17381,173806,156425,No
AECMandya,Electrical and Electronics Engineering,KCET,2023,84882,93554,12138,12045,202619,190574,No
VVCE,Biotechnology,COMEDK,2024,175732,80798,10543,28241,295314,267073,No
SITM,Electrical and Electronics Engineering,COMEDK,2023,164050,84431,13640,21221,283342,262121,No
AECMandya,Civil Engineering,COMEDK,2024,224060,76520,14891,18629,334100,315471,No
KSIT,Chemical Engineering,COMEDK,2024,234584,79808,17074,17390,348856,331466,No
NHCE,Aerospace Engineering,KCET,2023,50353,85935,19901,20414,176603,156189,Yes
VVIT,Data Science,COMEDK,2023,231062,88292,10518,27660,357532,329872,No
BIT,Electronics and Communication Engineering,KCET,2023,59012,85639,13062,29424,187137,157713,No
AITM,Biotechnology,KCET,2024,68875,61449,13005,20851,164180,143329,Yes
RVUNIV,Chemical Engineering,COMEDK,2023,177889,88679,17749,27014,311331,284317,Yes
NHCE,Biotechnology,KCET,2024,81956,94913,13208,10129,200206,190077,Yes
BIT,Electronics and Communication Engineering,KCET,2023,56838,67215,10653,16826,151532,134706,No
RVCE,Data Science,KCET,2023,55235,79875,9347,12172,156629,144457,No
SJBCE,Electrical and Electronics Engineering,KCET,2023,74286,74768,10147,15583,174784,159201,Yes
SCEM,Electronics and Communication Engineering,COMEDK,2024,185408,61341,16274,14877,277900,263023,Yes
VIT,Electrical and Electronics Engineering,COMEDK,2024,183528,80039,9418,25072,298057,272985,Yes
VSM,Data Science,COMEDK,2024,182821,71143,16667,14352,284983,270631,Yes
PESCE,Data Science,KCET,2023,53734,76267,9345,18603,157949,139346,No
SCEM,Mechanical Engineering,KCET,2023,63078,69257,11908,11205,155448,144243,No
MSRUAS,Electronics and Communication Engineering,COMEDK,2024,173159,74206,19710,28172,295247,267075,No
SIT,Electrical and Electronics Engineering,COMEDK,2024,180384,74388,14634,11574,280980,269406,No
BMSIT,Electronics and Communication Engineering,COMEDK,2023,200513,94626,13436,16575,325150,308575,No
MSRUAS,Information Science and Engineering,COMEDK,2024,214122,90146,13780,23726,341774,318048,No
PRES,Electrical and Electronics Engineering,KCET,2023,84531,91643,15700,22511,214385,191874,Yes
YKCE,Civil Engineering,COMEDK,2024,216309,81029,10555,20909,328802,307893,No
BITM,Data Science,COMEDK,2024,168209,70553,13915,29461,282138,252677,No
RVCE,Robotics and Automation Engineering,COMEDK,2023,228289,90266,14811,28180,361546,333366,No
EastPoint,Information Science and Engineering,KCET,2024,70298,65181,14259,16830,166568,149738,Yes
VSM,Data Science,KCET,2024,71576,76835,18321,23246,189978,166732,Yes
VVCE,Chemical Engineering,KCET,2024,78865,75357,12469,23279,189970,166691,No
SITM,Aerospace Engineering,KCET,2023,74146,60733,9434,15547,159860,144313,Yes
KLSGIT,Biotechnology,KCET,2024,62040,72966,18343,11406,164755,153349,Yes
SJBCE,Data Science,KCET,2024,74719,70077,9740,26561,181097,154536,Yes
SITM,Mechanical Engineering,KCET,2024,60915,81783,9796,25505,177999,152494,No
NCET,Computer Science and Engineering,KCET,2023,60772,86505,17221,26744,191242,164498,No
MSRUAS,Data Science,KCET,2024,72453,81358,15691,17433,186935,169502,Yes
VSM,Data Science,KCET,2023,75648,86354,15268,24582,201852,177270,Yes
ACU,Data Science,KCET,2024,84761,92445,10635,13616,201457,187841,Yes
SCEM,Civil Engineering,KCET,2023,70254,89902,10583,20605,191344,170739,Yes
NHCE,Mechanical Engineering,KCET,2023,73281,71687,12276,17787,175031,157244,Yes
KLSGIT,Chemical Engineering,COMEDK,2023,198904,82753,18181,17649,317487,299838,Yes
NIE,Data Science,KCET,2023,63911,85067,13590,27341,189909,162568,No
RNSIT,Chemical Engineering,KCET,2023,61428,60442,16343,25343,163556,138213,No
PRES,Artificial Intelligence and Data Science,KCET,2023,67910,60278,15996,25408,169592,144184,No
KSIT,Robotics and Automation Engineering,COMEDK,2023,178612,72137,19721,18337,288807,270470,Yes
AIT,Aerospace Engineering,COMEDK,2024,243406,68072,16519,24463,352460,327997,No
DSATM,Computer Science and Engineering,COMEDK,2024,222721,65728,16208,19801,324458,304657,No
BMSIT,Biotechnology,COMEDK,2024,223038,61455,17474,20953,322920,301967,Yes
DrAIT,Chemical Engineering,KCET,2023,70238,64603,8459,25494,168794,143300,No
RVCE,Artificial Intelligence and Data Science,COMEDK,2023,246505,90896,10572,14601,362574,347973,Yes
ACU,Electronics and Communication Engineering,KCET,2023,51245,80109,18108,20685,170147,149462,Yes
KLEIT,Chemical Engineering,COMEDK,2023,231735,92447,17443,27019,368644,341625,Yes
AITM,Chemical Engineering,COMEDK,2023,197286,81661,11517,20138,310602,290464,No
CMRIT,Chemical Engineering,COMEDK,2023,181243,63547,17470,20573,282833,262260,Yes
GMIT,Civil Engineering,KCET,2023,55035,67959,11693,28335,163022,134687,No
VSM,Artificial Intelligence and Data Science,COMEDK,2023,229607,79340,14152,24922,348021,323099,No
SITM,Information Science and Engineering,KCET,2024,75409,71706,12720,28953,188788,159835,Yes
VSM,Electronics and Communication Engineering,KCET,2024,55175,68312,10061,23877,157425,133548,No
VemanaIT,Artificial Intelligence and Data Science,KCET,2024,51140,81068,17028,17412,166648,149236,Yes
NCET,Electronics and Communication Engineering,COMEDK,2023,220386,79966,11151,24097,335600,311503,Yes
CMRIT,Biotechnology,KCET,2024,70657,66907,19117,11439,168120,156681,Yes
REVA,Civil Engineering,KCET,2024,65632,81567,16358,18360,181917,163557,No
NCET,Chemical Engineering,KCET,2023,57576,69464,13479,26564,167083,140519,No
BMSIT,Electronics and Communication Engineering,KCET,2023,64940,75185,16169,20922,177216,156294,Yes
SCEM,Electronics and Communication Engineering,COMEDK,2023,241988,90283,8994,18769,360034,341265,No
RAIT,Artificial Intelligence and Data Science,KCET,2024,62032,84010,9652,19945,175639,155694,Yes
BITM,Electronics and Communication Engineering,COMEDK,2023,249906,72630,12005,16120,350661,334541,Yes
BMSIT,Robotics and Automation Engineering,KCET,2024,50048,90458,18913,15631,175050,159419,No
MSRIT,Computer Science and Engineering,KCET,2023,77060,88013,18842,24710,208625,183915,Yes
RAIT,Information Science and Engineering,KCET,2024,73793,91413,15559,28621,209386,180765,No
VIT,Chemical Engineering,COMEDK,2024,217327,81552,9853,27386,336118,308732,No
MSRUAS,Chemical Engineering,KCET,2023,72134,69284,18438,19032,178888,159856,Yes
RAIT,Mechanical Engineering,COMEDK,2023,183659,91441,11248,16472,302820,286348,No
UVCE,Data Science,COMEDK,2024,216452,79045,16779,19590,331866,312276,No
VVCE,Biotechnology,COMEDK,2024,199009,67178,10296,18903,295386,276483,Yes
SIT,Mechanical Engineering,KCET,2023,65316,81127,16643,22598,185684,163086,No
UVCE,Aerospace Engineering,KCET,2023,70923,69333,9163,14430,163849,149419,Yes
YKCE,Information Science and Engineering,KCET,2023,51862,63893,19850,21607,157212,135605,Yes
SIT,Biotechnology,KCET,2024,60749,77273,15199,12307,165528,153221,Yes
CMRIT,Electronics and Communication Engineering,KCET,2023,78841,82352,8000,18996,188189,169193,Yes
RNSIT,Electrical and Electronics Engineering,COMEDK,2024,232169,78732,10402,24314,345617,321303,No
RVUNIV,Biotechnology,COMEDK,2024,208914,81677,19846,29221,339658,310437,Yes
SITM,Computer Science and Engineering,COMEDK,2023,199358,60915,9484,11918,281675,269757,No
RVCE,Electrical and Electronics Engineering,COMEDK,2023,194800,66822,13679,16493,291794,275301,No
KSIT,Civil Engineering,KCET,2023,75352,87249,15347,15569,193517,177948,No
YKCE,Data Science,KCET,2024,77126,77964,8882,28327,192299,163972,No
DBIT,Chemical Engineering,KCET,2024,56665,84051,10710,18203,169629,151426,No
DBIT,Robotics and Automation Engineering,KCET,2024,63180,61520,13464,17323,155487,138164,No
HKBK,Electronics and Communication Engineering,COMEDK,2023,242420,77642,11650,13545,345257,331712,No
SIT,Computer Science and Engineering,COMEDK,2023,189559,65458,15409,16371,286797,270426,No
SCEM,Robotics and Automation Engineering,KCET,2023,65402,78165,15283,13195,172045,158850,No
DSCE,Artificial Intelligence and Data Science,KCET,2024,50336,91298,13107,25139,179880,154741,Yes
RVCE,Civil Engineering,KCET,2023,70089,91723,17634,20211,199657,179446,Yes
CMRIT,Electronics and Communication Engineering,KCET,2023,71405,93237,8421,29169,202232,173063,No
VSM,Computer Science and Engineering,KCET,2023,68294,62758,11182,15032,157266,142234,No
CMRIT,Mechanical Engineering,KCET,2023,58371,90695,9525,26424,185015,158591,Yes
RIT,Civil Engineering,COMEDK,2024,161106,90862,19206,23319,294493,271174,Yes
SIT,Aerospace Engineering,COMEDK,2023,223402,72556,8327,21639,325924,304285,Yes
PESU,Electronics and Communication Engineering,KCET,2023,53784,90487,9117,28961,182349,153388,Yes
RVUNIV,Electrical and Electronics Engineering,KCET,2024,57139,70639,13902,28608,170288,141680,Yes
CITGubbi,Aerospace Engineering,COMEDK,2024,208450,68352,9630,25365,311797,286432,No
NCET,Mechanical Engineering,COMEDK,2023,221358,69444,17177,19587,327566,307979,Yes
BITM,Information Science and Engineering,COMEDK,2023,180722,66330,12383,12465,271900,259435,Yes
RVUNIV,Aerospace Engineering,KCET,2023,84098,92352,12055,17950,206455,188505,No
NMIT,Biotechnology,COMEDK,2024,186270,87608,10441,14162,298481,284319,Yes
BMIT,Information Science and Engineering,KCET,2024,79733,66570,18447,25489,190239,164750,Yes
HKBK,Biotechnology,KCET,2024,61681,85241,8188,16216,171326,155110,No
AEC,Mechanical Engineering,KCET,2023,58910,60266,19631,26252,165059,138807,No
NHCE,Artificial Intelligence and Data Science,COMEDK,2023,248591,84762,13086,24726,371165,346439,No
DrAIT,Information Science and Engineering,COMEDK,2024,208581,60348,17557,14098,300584,286486,No
KSIT,Biotechnology,COMEDK,2024,200569,89572,10561,17403,318105,300702,Yes
MVJCE,Information Science and Engineering,COMEDK,2023,176465,63633,8076,15906,264080,248174,Yes
KLEIT,Biotechnology,COMEDK,2024,192233,64653,9137,12836,278859,266023,Yes
RVCE,Data Science,COMEDK,2024,234416,85331,19547,21528,360822,339294,Yes
MSRUAS,Artificial Intelligence and Data Science,COMEDK,2024,167704,75055,12020,22426,277205,254779,No
MSRIT,Robotics and Automation Engineering,COMEDK,2023,242750,76870,18692,26201,364513,338312,No
SIT,Electrical and Electronics Engineering,KCET,2023,84595,76716,18798,23421,203530,180109,No
RVCE,Aerospace Engineering,KCET,2024,54127,79506,12358,29083,175074,145991,No
KLEIT,Electronics and Communication Engineering,KCET,2023,77578,90748,18582,20543,207451,186908,Yes
SCEM,Mechanical Engineering,COMEDK,2024,186408,85795,9654,21794,303651,281857,Yes
HKBK,Information Science and Engineering,COMEDK,2023,175286,83882,11383,13415,283966,270551,Yes
MSRIT,Electronics and Communication Engineering,KCET,2023,77399,77832,14599,14124,183954,169830,No
SJBCE,Biotechnology,KCET,2023,79972,60781,17717,13492,171962,158470,Yes
MSRUAS,Data Science,COMEDK,2024,228039,86069,16464,10296,340868,330572,Yes
UVCE,Data Science,KCET,2024,84571,75964,14511,19851,194897,175046,No
AIT,Electronics and Communication Engineering,KCET,2023,76901,81532,19239,19279,196951,177672,Yes
RNSIT,Aerospace Engineering,KCET,2023,50643,82479,11403,20408,164933,144525,Yes
JSSSTU,Data Science,COMEDK,2023,175945,76306,15143,23941,291335,267394,Yes
SJBCE,Electrical and Electronics Engineering,COMEDK,2023,212508,73879,13803,17847,318037,300190,Yes
SJBIT,Mechanical Engineering,KCET,2023,55589,80882,17629,26239,180339,154100,Yes
NIE,Mechanical Engineering,COMEDK,2023,223483,66709,11816,29844,331852,302008,No
GIT,Robotics and Automation Engineering,COMEDK,2024,200888,70422,16813,16261,304384,288123,Yes
BMIT,Aerospace Engineering,COMEDK,2024,200626,88474,8786,29752,327638,297886,No
MSRUAS,Electrical and Electronics Engineering,COMEDK,2023,206632,67946,9491,17966,302035,284069,No
DrAIT,Data Science,KCET,2023,55336,63697,12078,18185,149296,131111,No
RNSIT,Aerospace Engineering,COMEDK,2023,215055,64185,8594,15730,303564,287834,No
CMRIT,Computer Science and Engineering,COMEDK,2024,220115,60736,8168,17438,306457,289019,Yes
SCEM,Chemical Engineering,COMEDK,2023,174525,81725,13858,27910,298018,270108,Yes
YKCE,Electrical and Electronics Engineering,COMEDK,2024,248803,81672,11418,20557,362450,341893,Yes
GIT,Electronics and Communication Engineering,KCET,2024,53785,89006,11227,18978,172996,154018,Yes
RVCE,Electronics and Communication Engineering,COMEDK,2023,205530,72169,14646,28071,320416,292345,Yes
JIT,Electrical and Electronics Engineering,KCET,2023,52838,73275,18882,22498,167493,144995,No
KLSGIT,Data Science,COMEDK,2023,244976,62161,15106,13387,335630,322243,Yes
SDMIT,Information Science and Engineering,COMEDK,2024,167288,76818,13390,25144,282640,257496,No
VemanaIT,Artificial Intelligence and Data Science,COMEDK,2023,173084,60048,11071,22976,267179,244203,Yes
SITM,Civil Engineering,KCET,2024,52058,75482,18064,28231,173835,145604,Yes
YKCE,Computer Science and Engineering,COMEDK,2024,221424,78257,15042,25624,340347,314723,Yes
MSRIT,Mechanical Engineering,COMEDK,2024,197805,85915,8372,15628,307720,292092,No
KLEIT,Information Science and Engineering,KCET,2024,83815,65001,11113,25824,185753,159929,Yes
SJBCE,Computer Science and Engineering,KCET,2024,70384,66066,12879,13944,163273,149329,Yes
PESCE,Civil Engineering,COMEDK,2024,241590,89587,18910,11250,361337,350087,Yes
ACU,Artificial Intelligence and Data Science,COMEDK,2024,234331,91284,17258,26666,369539,342873,Yes
NHCE,Biotechnology,KCET,2024,78190,85748,13922,13602,191462,177860,Yes
VemanaIT,Electrical and Electronics Engineering,COMEDK,2024,210206,72598,14049,15983,312836,296853,Yes
DBIT,Biotechnology,COMEDK,2023,169364,78169,16134,10094,273761,263667,No
NIE,Electrical and Electronics Engineering,COMEDK,2023,209627,61546,19966,20990,312129,291139,Yes
BIT,Artificial Intelligence and Data Science,KCET,2024,59544,77862,19632,15707,172745,157038,No
REVA,Civil Engineering,KCET,2023,69170,86678,17500,27193,200541,173348,Yes
YKCE,Civil Engineering,KCET,2023,63062,94174,12470,28195,197901,169706,No
GMIT,Mechanical Engineering,KCET,2024,79847,63925,11125,13156,168053,154897,Yes
JSSSTU,Information Science and Engineering,KCET,2023,71932,84916,18800,25179,200827,175648,Yes
RIT,Electrical and Electronics Engineering,COMEDK,2024,174530,76590,9921,22396,283437,261041,Yes
NMIT,Chemical Engineering,COMEDK,2024,178006,62286,8363,16069,264724,248655,No
PRES,Computer Science and Engineering,KCET,2023,61320,70441,11581,24402,167744,143342,Yes
VIT,Civil Engineering,KCET,2024,64232,83906,18185,21095,187418,166323,No
GIT,Aerospace Engineering,KCET,2023,51779,81039,19104,28437,180359,151922,No
GIT,Computer Science and Engineering,COMEDK,2023,182971,62559,18891,20426,284847,264421,No
DBIT,Biotechnology,COMEDK,2023,175173,67010,19213,26270,287666,261396,No
RAIT,Chemical Engineering,COMEDK,2024,240066,79129,13565,11157,343917,332760,Yes
VVCE,Aerospace Engineering,KCET,2023,78837,64257,18265,29337,190696,161359,No
BMSCE,Data Science,KCET,2024,50738,67965,10317,22276,151296,129020,No
NCET,Information Science and Engineering,KCET,2024,52668,65281,19179,24555,161683,137128,No
MSRIT,Mechanical Engineering,COMEDK,2023,230937,89182,18443,26392,364954,338562,Yes
MSRIT,Information Science and Engineering,COMEDK,2023,168585,86375,13683,21603,290246,268643,No
BMIT,Computer Science and Engineering,COMEDK,2024,170312,68881,18273,21033,278499,257466,Yes
DSCE,Artificial Intelligence and Data Science,COMEDK,2023,161882,69472,8760,16025,256139,240114,Yes
DSCE,Computer Science and Engineering,KCET,2024,83348,94416,19123,23736,220623,196887,Yes
BIT,Chemical Engineering,KCET,2024,69816,88209,17656,26366,202047,175681,Yes
SCEM,Electrical and Electronics Engineering,COMEDK,2024,249691,82788,19455,18649,370583,351934,Yes
KSIT,Biotechnology,COMEDK,2023,230913,72455,15625,24139,343132,318993,Yes
AIT,Civil Engineering,COMEDK,2023,171980,71103,10850,14247,268180,253933,Yes
PESCE,Mechanical Engineering,COMEDK,2024,186753,68252,19370,20974,295349,274375,No
BMSIT,Electronics and Communication Engineering,COMEDK,2023,187963,66198,15236,16267,285664,269397,No
ACU,Chemical Engineering,COMEDK,2024,184221,91296,12445,12433,300395,287962,Yes
DBIT,Electrical and Electronics Engineering,KCET,2024,74027,64793,19913,16732,175465,158733,Yes
PESU,Data Science,KCET,2024,81120,66045,16362,10325,173852,163527,No
JNNCE,Computer Science and Engineering,KCET,2024,81706,94859,14179,25856,216600,190744,Yes
UVCE,Electrical and Electronics Engineering,COMEDK,2023,176076,80019,10521,12591,279207,266616,Yes
VemanaIT,Robotics and Automation Engineering,KCET,2024,56290,91894,15276,24840,188300,163460,No
UVCE,Biotechnology,KCET,2024,82968,71081,19379,16102,189530,173428,No
UVCE,Mechanical Engineering,COMEDK,2024,234534,78740,11517,15943,340734,324791,Yes
DBIT,Chemical Engineering,KCET,2024,79763,86549,9465,11494,187271,175777,No
SDMIT,Mechanical Engineering,COMEDK,2024,231678,63055,13835,14415,322983,308568,No
PESU,Biotechnology,KCET,2024,83661,62955,12685,26305,185606,159301,Yes
NMIT,Artificial Intelligence and Data Science,KCET,2024,67198,92249,18482,26396,204325,177929,No
RIT,Aerospace Engineering,COMEDK,2023,164253,90032,18152,20878,293315,272437,Yes
MSRUAS,Artificial Intelligence and Data Science,KCET,2024,65973,78096,17377,17890,179336,161446,No
RNSIT,Biotechnology,KCET,2023,77977,83124,15789,26581,203471,176890,Yes
KSIT,Electrical and Electronics Engineering,COMEDK,2023,233970,86083,15081,27402,362536,335134,Yes
VSM,Civil Engineering,KCET,2024,58315,74759,8987,20845,162906,142061,No
MSRUAS,Civil Engineering,COMEDK,2024,214675,69411,12724,28382,325192,296810,Yes
MVJCE,Information Science and Engineering,COMEDK,2023,249194,93212,13028,28085,383519,355434,No
EastPoint,Electronics and Communication Engineering,KCET,2023,75838,83714,12831,23724,196107,172383,Yes
PRES,Computer Science and Engineering,KCET,2024,67919,74184,12535,11917,166555,154638,No
HKBK,Robotics and Automation Engineering,COMEDK,2024,188647,90321,15643,18510,313121,294611,No
RIT,Information Science and Engineering,KCET,2023,72947,82705,12598,14145,182395,168250,No
PRES,Robotics and Automation Engineering,COMEDK,2023,242851,78777,19836,15795,357259,341464,No
MSRUAS,Robotics and Automation Engineering,COMEDK,2024,195510,82676,14330,22912,315428,292516,Yes
MSRUAS,Chemical Engineering,COMEDK,2023,162915,88731,9894,28539,290079,261540,Yes
DSCE,Chemical Engineering,COMEDK,2023,193002,78394,12059,26366,309821,283455,No
RNSIT,Chemical Engineering,COMEDK,2023,242314,86119,15708,24502,368643,344141,Yes
RIT,Electronics and Communication Engineering,KCET,2023,53833,83766,19554,15283,172436,157153,No
SCEM,Data Science,KCET,2024,84468,79088,14608,18951,197115,178164,Yes
BMIT,Data Science,COMEDK,2023,227741,60407,14362,19763,322273,302510,No
KSIT,Electrical and Electronics Engineering,COMEDK,2024,209046,63773,12184,13752,298755,285003,No
NMIT,Chemical Engineering,KCET,2024,74667,67115,11400,10464,163646,153182,Yes
KSIT,Information Science and Engineering,KCET,2024,50893,61511,13604,13779,139787,126008,No
JNNCE,Electrical and Electronics Engineering,KCET,2024,82803,78208,8655,28479,198145,169666,Yes
MVJCE,Civil Engineering,KCET,2023,78157,71214,14503,19463,183337,163874,Yes
BNMIT,Mechanical Engineering,COMEDK,2023,175822,89001,15804,29031,309658,280627,Yes
MSRIT,Chemical Engineering,COMEDK,2024,186078,60590,13550,14617,274835,260218,No
JSSSTU,Electrical and Electronics Engineering,COMEDK,2023,184820,60925,17808,13362,276915,263553,No
RNSIT,Information Science and Engineering,KCET,2024,56878,90815,17940,13796,179429,165633,No
DBIT,Artificial Intelligence and Data Science,KCET,2023,59857,83378,14905,22745,180885,158140,No
BITM,Electrical and Electronics Engineering,COMEDK,2024,169799,84949,8746,24647,288141,263494,Yes
VIT,Computer Science and Engineering,KCET,2024,81509,61291,10726,19548,173074,153526,No
AITM,Biotechnology,KCET,2023,58074,86636,10416,10894,166020,155126,No
PESU,Data Science,KCET,2023,59690,91894,16358,16372,184314,167942,Yes
HKBK,Biotechnology,COMEDK,2023,248417,66720,12627,21812,349576,327764,Yes
BIT,Electronics and Communication Engineering,COMEDK,2024,237526,77742,12964,12170,340402,328232,Yes
SCEM,Data Science,KCET,2024,84837,79335,9850,19765,193787,174022,No
KLEIT,Electrical and Electronics Engineering,KCET,2024,65356,72078,18003,12252,167689,155437,No
BIT,Electrical and Electronics Engineering,COMEDK,2023,235280,78542,14426,24492,352740,328248,No
BMSCE,Electrical and Electronics Engineering,KCET,2024,72236,86515,15623,24155,198529,174374,Yes
MSRUAS,Information Science and Engineering,KCET,2024,73866,71021,19703,10508,175098,164590,Yes
YKCE,Aerospace Engineering,KCET,2023,57558,83702,9425,23982,174667,150685,No
PESCE,Mechanical Engineering,KCET,2024,55296,64139,11711,15216,146362,131146,No
AEC,Computer Science and Engineering,COMEDK,2024,205143,75159,17371,19302,316975,297673,Yes
DBIT,Mechanical Engineering,COMEDK,2024,242156,62244,18007,27385,349792,322407,No
CMRIT,Artificial Intelligence and Data Science,COMEDK,2024,211310,77184,11778,12432,312704,300272,No
KLEIT,Electrical and Electronics Engineering,KCET,2024,78449,61559,18834,28798,187640,158842,No
GIT,Information Science and Engineering,KCET,2024,81248,74778,13689,14613,184328,169715,No
BIT,Data Science,KCET,2023,79663,79343,8535,16466,184007,167541,No
RVCE,Electrical and Electronics Engineering,COMEDK,2023,196551,90787,10167,13546,311051,297505,Yes
SJBIT,Civil Engineering,COMEDK,2024,170646,64347,9259,22069,266321,244252,Yes
SJBIT,Mechanical Engineering,KCET,2023,64877,86200,16481,21343,188901,167558,Yes
MSRIT,Aerospace Engineering,KCET,2023,69851,64898,13889,20181,168819,148638,No
BITM,Mechanical Engineering,COMEDK,2023,182051,91833,13736,27754,315374,287620,Yes
BMSIT,Electrical and Electronics Engineering,KCET,2023,61667,88442,11742,23519,185370,161851,No
ACU,Biotechnology,KCET,2023,76633,73970,10003,24111,184717,160606,Yes
AEC,Civil Engineering,COMEDK,2024,229560,75915,18433,16693,340601,323908,No
RVUNIV,Electrical and Electronics Engineering,KCET,2023,52935,69439,14448,23212,160034,136822,No
BNMIT,Electrical and Electronics Engineering,KCET,2023,68854,71957,11414,10966,163191,152225,Yes
JIT,Artificial Intelligence and Data Science,COMEDK,2023,169155,60790,12121,19122,261188,242066,Yes
HKBK,Aerospace Engineering,COMEDK,2023,161624,62845,19038,15150,258657,243507,No
RIT,Artificial Intelligence and Data Science,COMEDK,2024,224444,70416,10675,25291,330826,305535,Yes
BIT,Electrical and Electronics Engineering,KCET,2024,74286,72448,17002,27981,191717,163736,No
PESU,Mechanical Engineering,COMEDK,2024,178055,64091,18156,20311,280613,260302,Yes
DrAIT,Mechanical Engineering,KCET,2023,66164,60072,15271,10540,152047,141507,No
NCET,Mechanical Engineering,COMEDK,2024,173667,72475,9485,18881,274508,255627,No
JSSSTU,Mechanical Engineering,COMEDK,2023,191096,71029,19899,29246,311270,282024,Yes
VVIT,Biotechnology,KCET,2023,67520,75017,16262,20393,179192,158799,Yes
SDMCET,Electrical and Electronics Engineering,KCET,2024,61927,92132,12596,16263,182918,166655,Yes
BITM,Mechanical Engineering,COMEDK,2024,197086,74258,13156,22789,307289,284500,Yes
SIT,Electronics and Communication Engineering,COMEDK,2023,217146,67073,16599,12284,313102,300818,No
AECMandya,Electronics and Communication Engineering,KCET,2023,83715,92202,13600,17320,206837,189517,No
DBIT,Chemical Engineering,COMEDK,2024,206163,78465,17345,23461,325434,301973,No
MVJCE,Computer Science and Engineering,KCET,2024,75022,69540,13228,29968,187758,157790,Yes
SITM,Data Science,KCET,2023,52157,63738,14482,14656,145033,130377,Yes
VemanaIT,Chemical Engineering,KCET,2024,59070,76227,19908,25081,180286,155205,No
BNMIT,Artificial Intelligence and Data Science,COMEDK,2024,235870,93684,8861,23802,362217,338415,No
VemanaIT,Aerospace Engineering,COMEDK,2023,205536,61196,18697,27953,313382,285429,No
NMIT,Mechanical Engineering,KCET,2024,68651,66936,10777,16675,163039,146364,Yes
KLSGIT,Electrical and Electronics Engineering,KCET,2023,62253,82511,10295,14427,169486,155059,Yes
AITM,Computer Science and Engineering,COMEDK,2024,243471,61563,15629,29125,349788,320663,No
VSM,Robotics and Automation Engineering,KCET,2023,61945,91092,12328,20149,185514,165365,Yes
KSIT,Robotics and Automation Engineering,COMEDK,2023,204389,76313,8196,16522,305420,288898,Yes
NHCE,Mechanical Engineering,COMEDK,2023,168057,62855,8413,28849,268174,239325,Yes
KLEIT,Biotechnology,COMEDK,2024,200606,83755,9240,18331,311932,293601,Yes
SIT,Computer Science and Engineering,KCET,2023,78967,61001,9566,11087,160621,149534,Yes
RVUNIV,Mechanical Engineering,COMEDK,2024,185975,93941,19000,23266,322182,298916,Yes
UVCE,Electrical and Electronics Engineering,COMEDK,2023,202646,94234,9686,21223,327789,306566,No
JNNCE,Electrical and Electronics Engineering,KCET,2023,62107,67412,10100,19129,158748,139619,No
SITM,Chemical Engineering,KCET,2023,63063,66276,17453,10723,157515,146792,Yes
RVUNIV,Aerospace Engineering,KCET,2024,67973,81484,9010,11729,170196,158467,No
YKCE,Biotechnology,KCET,2024,73808,71347,18242,15492,178889,163397,No
PRES,Chemical Engineering,COMEDK,2024,249676,73183,17537,14934,355330,340396,No
PRES,Artificial Intelligence and Data Science,KCET,2024,73011,75777,15618,11664,176070,164406,Yes
AEC,Information Science and Engineering,COMEDK,2024,176710,72491,11271,25850,286322,260472,No
EastPoint,Electrical and Electronics Engineering,COMEDK,2024,202276,63327,14283,29313,309199,279886,Yes
KSIT,Aerospace Engineering,COMEDK,2023,232015,69323,17666,28167,347171,319004,No
CMRIT,Aerospace Engineering,COMEDK,2023,218510,78461,14955,20475,332401,311926,Yes
VVIT,Electronics and Communication Engineering,COMEDK,2024,171062,91154,8406,10874,281496,270622,Yes
ACU,Information Science and Engineering,COMEDK,2023,178582,73233,19167,11726,282708,270982,Yes
BIT,Aerospace Engineering,KCET,2023,52614,88650,9843,16310,167417,151107,Yes
CITGubbi,Information Science and Engineering,KCET,2024,63409,78136,17819,19831,179195,159364,No
AIT,Aerospace Engineering,KCET,2024,84898,75632,10971,29669,201170,171501,No
BMSCE,Robotics and Automation Engineering,KCET,2024,65033,92157,8332,26885,192407,165522,No
KSIT,Data Science,KCET,2024,54895,92000,17363,21809,186067,164258,No
RVUNIV,Mechanical Engineering,KCET,2023,55344,67737,16260,21655,160996,139341,Yes
ACU,Aerospace Engineering,COMEDK,2024,234667,75053,19313,15189,344222,329033,Yes
RAIT,Computer Science and Engineering,COMEDK,2023,179995,87609,13450,14620,295674,281054,No
DBIT,Electronics and Communication Engineering,COMEDK,2023,222114,90419,19952,27568,360053,332485,No
SITM,Mechanical Engineering,COMEDK,2023,231822,76760,12287,23608,344477,320869,Yes
CITGubbi,Mechanical Engineering,COMEDK,2024,240025,73687,8599,27785,350096,322311,Yes
BMSIT,Civil Engineering,KCET,2023,65262,63179,14838,16146,159425,143279,No
SIT,Biotechnology,KCET,2024,75887,76879,10760,17935,181461,163526,No
SDMCET,Artificial Intelligence and Data Science,KCET,2024,76666,71610,10578,12501,171355,158854,No
DSATM,Artificial Intelligence and Data Science,COMEDK,2024,194472,77323,15128,11538,298461,286923,Yes
DrAIT,Data Science,KCET,2024,80073,60411,16164,10947,167595,156648,Yes
SDMCET,Data Science,COMEDK,2024,225703,77083,17913,15878,336577,320699,No
REVA,Aerospace Engineering,COMEDK,2024,170907,65756,16945,20474,274082,253608,No
AIT,Artificial Intelligence and Data Science,KCET,2023,81520,75318,16242,24367,197447,173080,Yes
HKBK,Robotics and Automation Engineering,KCET,2024,74441,89901,16462,15600,196404,180804,Yes
SDMIT,Mechanical Engineering,KCET,2023,82440,79445,8223,17146,187254,170108,Yes
SDMCET,Computer Science and Engineering,COMEDK,2023,236058,71702,18656,25650,352066,326416,Yes
CITGubbi,Robotics and Automation Engineering,KCET,2024,73449,85559,17308,29313,205629,176316,No
MVJCE,Civil Engineering,COMEDK,2023,227413,69663,19685,29718,346479,316761,No
NMIT,Computer Science and Engineering,KCET,2024,59825,88864,9069,10738,168496,157758,Yes
SDMCET,Mechanical Engineering,KCET,2023,80860,94318,18451,13094,206723,193629,Yes
NCET,Computer Science and Engineering,COMEDK,2024,187084,68656,10156,28534,294430,265896,Yes
GIT,Electronics and Communication Engineering,COMEDK,2023,200070,87140,15425,20385,323020,302635,Yes
JNNCE,Robotics and Automation Engineering,KCET,2024,82137,65653,15855,20228,183873,163645,No
CITGubbi,Artificial Intelligence and Data Science,KCET,2024,80485,72628,9064,29535,191712,162177,No
DrAIT,Civil Engineering,COMEDK,2024,226810,78304,12982,11188,329284,318096,No
SDMCET,Computer Science and Engineering,KCET,2023,69879,77885,13215,29582,190561,160979,No
REVA,Data Science,KCET,2024,80110,69161,10500,29060,188831,159771,No
RVCE,Computer Science and Engineering,COMEDK,2023,220951,85357,8246,27402,341956,314554,Yes
NHCE,Mechanical Engineering,KCET,2023,51508,79749,17365,26842,175464,148622,No
NMIT,Data Science,COMEDK,2024,222281,91923,11965,21749,347918,326169,No
RVCE,Electronics and Communication Engineering,KCET,2024,65950,76681,16847,21351,180829,159478,Yes
KLSGIT,Artificial Intelligence and Data Science,COMEDK,2024,175516,89791,12782,23292,301381,278089,No
DSCE,Computer Science and Engineering,COMEDK,2024,190295,94275,15960,18804,319334,300530,Yes
RVUNIV,Data Science,KCET,2024,71829,87240,8868,18041,185978,167937,No
SJBIT,Information Science and Engineering,KCET,2023,76248,84095,9608,17125,187076,169951,Yes
CMRIT,Electrical and Electronics Engineering,KCET,2024,61345,61589,16088,17909,156931,139022,No
DSATM,Chemical Engineering,COMEDK,2024,197176,72638,10304,12301,292419,280118,No
VSM,Electrical and Electronics Engineering,COMEDK,2023,160440,60698,15471,15482,252091,236609,No
NCET,Electronics and Communication Engineering,KCET,2023,64468,89300,15533,14967,184268,169301,Yes
NIE,Computer Science and Engineering,KCET,2023,57044,90208,15857,26454,189563,163109,No
JSSSTU,Electronics and Communication Engineering,KCET,2024,68279,80608,16771,28979,194637,165658,No
PESU,Chemical Engineering,KCET,2023,75673,62850,8593,10807,157923,147116,Yes
RVCE,Civil Engineering,COMEDK,2024,189237,85343,17712,22161,314453,292292,Yes
BMIT,Information Science and Engineering,KCET,2023,82317,61080,9896,13914,167207,153293,Yes
KSIT,Data Science,COMEDK,2023,213076,79745,12320,21519,326660,305141,Yes
NIE,Information Science and Engineering,KCET,2024,68436,68019,8246,26849,171550,144701,No
MSRUAS,Robotics and Automation Engineering,COMEDK,2024,225368,68684,13467,12584,320103,307519,No
RVCE,Mechanical Engineering,KCET,2023,77081,75614,10248,12346,175289,162943,Yes
RNSIT,Mechanical Engineering,KCET,2023,65436,85464,8166,14160,173226,159066,Yes
VIT,Data Science,COMEDK,2023,217144,89301,13712,13605,333762,320157,No
BMSIT,Robotics and Automation Engineering,COMEDK,2024,217763,75173,13506,24362,330804,306442,Yes
BMSIT,Chemical Engineering,COMEDK,2024,233989,83481,10419,16890,344779,327889,No
REVA,Electrical and Electronics Engineering,COMEDK,2023,241969,67019,10429,18106,337523,319417,No
SCEM,Computer Science and Engineering,COMEDK,2023,178981,73111,16789,22032,290913,268881,No
GIT,Biotechnology,COMEDK,2024,177763,72406,9087,24615,283871,259256,No
ACU,Data Science,COMEDK,2024,239484,67888,9783,20025,337180,317155,Yes
NIE,Mechanical Engineering,KCET,2024,66122,79210,9659,13130,168121,154991,No
YKCE,Mechanical Engineering,COMEDK,2023,219277,60744,10099,26168,316288,290120,No
BNMIT,Information Science and Engineering,KCET,2023,53852,69617,8524,18167,150160,131993,Yes
BMSIT,Electrical and Electronics Engineering,KCET,2023,58837,86412,12558,29278,187085,157807,Yes
JNNCE,Artificial Intelligence and Data Science,COMEDK,2023,220248,91174,11406,29927,352755,322828,No
VIT,Electronics and Communication Engineering,COMEDK,2023,231354,66969,15886,23927,338136,314209,Yes
CITGubbi,Robotics and Automation Engineering,KCET,2024,83907,60583,13407,17070,174967,157897,Yes
YKCE,Computer Science and Engineering,COMEDK,2024,240863,78750,10725,21911,352249,330338,Yes
BMSCE,Artificial Intelligence and Data Science,COMEDK,2024,242375,67890,15471,29784,355520,325736,No
SJBIT,Electronics and Communication Engineering,COMEDK,2023,241070,79542,12041,15737,348390,332653,Yes
NHCE,Chemical Engineering,COMEDK,2024,167814,79210,8118,21530,276672,255142,Yes
SJBIT,Electronics and Communication Engineering,KCET,2023,71319,72315,15641,24186,183461,159275,Yes
DrAIT,Electrical and Electronics Engineering,COMEDK,2023,217837,82018,14234,10003,324092,314089,Yes
MSRUAS,Electrical and Electronics Engineering,COMEDK,2023,234080,70912,12616,21384,338992,317608,Yes
NHCE,Data Science,COMEDK,2024,168110,86416,10683,23929,289138,265209,No
SIT,Biotechnology,COMEDK,2024,222794,86976,12726,16992,339488,322496,Yes
NCET,Data Science,COMEDK,2023,245768,83934,10322,22688,362712,340024,Yes
ACU,Information Science and Engineering,COMEDK,2024,185176,61909,17171,16172,280428,264256,Yes
BIT,Civil Engineering,COMEDK,2024,243233,85259,15128,13165,356785,343620,No
DSCE,Civil Engineering,COMEDK,2024,188895,76975,15031,14392,295293,280901,Yes
BMSCE,Mechanical Engineering,KCET,2024,57170,89640,16980,26776,190566,163790,Yes
SDMCET,Electrical and Electronics Engineering,COMEDK,2023,174096,88268,13473,13236,289073,275837,No
UVCE,Information Science and Engineering,KCET,2023,58908,93983,18421,12466,183778,171312,No
KLEIT,Robotics and Automation Engineering,KCET,2023,79375,83223,12886,10784,186268,175484,No
VSM,Information Science and Engineering,COMEDK,2023,164248,90987,13244,22831,291310,268479,Yes
RAIT,Mechanical Engineering,KCET,2024,50111,70459,15769,26916,163255,136339,No
RNSIT,Electronics and Communication Engineering,KCET,2023,56535,75551,12760,19228,164074,144846,No
DSCE,Civil Engineering,KCET,2023,79510,67631,12071,19731,178943,159212,Yes
CMRIT,Civil Engineering,KCET,2023,76552,78189,17970,27687,200398,172711,Yes
MSRUAS,Mechanical Engineering,KCET,2024,55298,62407,19807,12493,150005,137512,No
NMIT,Biotechnology,COMEDK,2023,220975,71599,16387,17182,326143,308961,No
JSSSTU,Electrical and Electronics Engineering,KCET,2023,54783,65162,18338,18061,156344,138283,Yes
VVCE,Aerospace Engineering,COMEDK,2024,161988,93263,19132,19573,293956,274383,No
VVIT,Electronics and Communication Engineering,KCET,2024,70709,87542,15008,11642,184901,173259,Yes
REVA,Artificial Intelligence and Data Science,KCET,2024,69697,91668,16077,23284,200726,177442,No
PESU,Civil Engineering,KCET,2024,59633,66095,11072,10758,147558,136800,Yes
EastPoint,Biotechnology,COMEDK,2024,171894,88817,10883,19109,290703,271594,No
RIT,Civil Engineering,KCET,2024,65535,90359,12342,19783,188019,168236,No
BNMIT,Civil Engineering,KCET,2024,78907,87432,9183,29535,205057,175522,Yes
MVJCE,Robotics and Automation Engineering,COMEDK,2024,193098,86336,9826,25183,314443,289260,No
RAIT,Electrical and Electronics Engineering,KCET,2023,83235,83593,11077,29043,206948,177905,Yes
BIT,Biotechnology,COMEDK,2024,216717,81445,8500,15708,322370,306662,No
VemanaIT,Civil Engineering,KCET,2023,75559,74247,12120,26488,188414,161926,Yes
VSM,Electrical and Electronics Engineering,COMEDK,2023,241818,82081,19703,22256,365858,343602,Yes
AEC,Data Science,KCET,2023,51865,68674,12015,28029,160583,132554,No
DSATM,Chemical Engineering,KCET,2024,66120,80354,15299,17890,179663,161773,No
AIT,Civil Engineering,COMEDK,2024,221822,69396,9557,27838,328613,300775,Yes
DSCE,Chemical Engineering,COMEDK,2024,232760,63648,9994,26899,333301,306402,Yes
UVCE,Civil Engineering,COMEDK,2024,202355,65418,10597,17771,296141,278370,Yes
NIE,Computer Science and Engineering,COMEDK,2024,234790,76673,13401,12542,337406,324864,Yes
CITGubbi,Biotechnology,KCET,2024,71848,89213,12972,25000,199033,174033,No
CMRIT,Data Science,COMEDK,2023,194351,71770,15518,19527,301166,281639,Yes
BNMIT,Civil Engineering,KCET,2023,78365,62466,12473,27307,180611,153304,No
BNMIT,Aerospace Engineering,COMEDK,2024,249103,67581,12061,20908,349653,328745,No
KLEIT,Data Science,COMEDK,2023,168620,62172,11204,29490,271486,241996,Yes
ACU,Civil Engineering,KCET,2023,76289,91327,14159,11128,192903,181775,No
RVCE,Biotechnology,COMEDK,2023,206470,64942,14087,16515,302014,285499,No
BIT,Biotechnology,COMEDK,2024,180949,71643,8851,12360,273803,261443,Yes
AECMandya,Electrical and Electronics Engineering,COMEDK,2024,171003,77875,19808,15926,284612,268686,Yes
NCET,Mechanical Engineering,KCET,2023,54572,94335,16283,17818,183008,165190,Yes
ACU,Computer Science and Engineering,KCET,2023,80315,64929,11993,11695,168932,157237,Yes
NIE,Aerospace Engineering,KCET,2023,69811,90371,10529,14992,185703,170711,No
UVCE,Mechanical Engineering,COMEDK,2023,161978,60940,11191,25956,260065,234109,Yes
KLEIT,Chemical Engineering,KCET,2023,58948,92088,17641,18414,187091,168677,Yes
CITGubbi,Computer Science and Engineering,COMEDK,2024,186261,65367,12423,15178,279229,264051,Yes
PESU,Data Science,COMEDK,2024,195720,73547,8008,20355,297630,277275,No
BMSIT,Information Science and Engineering,KCET,2024,72430,89227,17904,13640,193201,179561,No
PESCE,Electrical and Electronics Engineering,KCET,2023,63150,68594,8139,21166,161049,139883,No
ACU,Data Science,COMEDK,2023,183717,78112,9148,22098,293075,270977,Yes
VVIT,Civil Engineering,COMEDK,2024,193258,63933,16911,17219,291321,274102,No
MSRIT,Mechanical Engineering,KCET,2023,57095,87796,18885,20727,184503,163776,Yes
JIT,Electronics and Communication Engineering,KCET,2023,63766,70745,15624,12034,162169,150135,Yes
NHCE,Data Science,KCET,2023,72709,70026,10541,23664,176940,153276,Yes
UVCE,Robotics and Automation Engineering,KCET,2024,76042,62777,17599,21663,178081,156418,Yes
BMSCE,Robotics and Automation Engineering,KCET,2023,73364,66297,11646,13518,164825,151307,Yes
RVCE,Artificial Intelligence and Data Science,COMEDK,2023,206827,66336,10503,16203,299869,283666,No
VemanaIT,Civil Engineering,COMEDK,2023,177032,77668,13076,19209,286985,267776,Yes
SJBCE,Chemical Engineering,COMEDK,2023,205739,64066,14530,13991,298326,284335,No
VemanaIT,Robotics and Automation Engineering,KCET,2023,77081,69605,17539,13918,178143,164225,Yes
SJBIT,Artificial Intelligence and Data Science,KCET,2024,77055,60600,18175,26138,181968,155830,No
BIT,Biotechnology,COMEDK,2023,177891,91244,14423,10794,294352,283558,Yes
SJBIT,Electronics and Communication Engineering,COMEDK,2024,209179,74027,18627,28610,330443,301833,Yes
SDMIT,Information Science and Engineering,KCET,2024,73988,84757,17331,22894,198970,176076,Yes
SDMIT,Data Science,KCET,2023,78303,86076,8962,29419,202760,173341,No
SJBIT,Artificial Intelligence and Data Science,KCET,2024,72749,84502,10567,18443,186261,167818,No
YKCE,Electrical and Electronics Engineering,KCET,2023,59557,89706,8652,22322,180237,157915,No
DSCE,Aerospace Engineering,KCET,2023,54044,77305,18351,18046,167746,149700,No
DBIT,Data Science,COMEDK,2024,165915,91970,9829,25600,293314,267714,Yes
GMIT,Artificial Intelligence and Data Science,KCET,2023,52222,88177,11907,16409,168715,152306,Yes
PESCE,Civil Engineering,COMEDK,2023,199231,73937,13995,12224,299387,287163,No
VVIT,Electronics and Communication Engineering,KCET,2023,52883,93709,16772,13301,176665,163364,No
RIT,Artificial Intelligence and Data Science,KCET,2023,64405,82731,13469,25218,185823,160605,Yes
RIT,Data Science,KCET,2023,59625,84432,18047,25705,187809,162104,No
PRES,Chemical Engineering,COMEDK,2023,183334,63597,11084,27403,285418,258015,No
RVCE,Artificial Intelligence and Data Science,KCET,2023,66321,94027,19702,23225,203275,180050,Yes
JIT,Civil Engineering,KCET,2023,58810,63756,14711,15524,152801,137277,Yes
PRES,Data Science,COMEDK,2024,208282,81882,13396,25515,329075,303560,No
RAIT,Mechanical Engineering,COMEDK,2023,179973,82982,11173,29341,303469,274128,No
YKCE,Electrical and Electronics Engineering,KCET,2023,75240,94446,10144,29348,209178,179830,No
KLSGIT,Artificial Intelligence and Data Science,KCET,2024,81249,94169,14149,29350,218917,189567,Yes
NHCE,Electrical and Electronics Engineering,COMEDK,2024,194622,86260,15533,24021,320436,296415,Yes
NHCE,Chemical Engineering,COMEDK,2023,168834,63793,12965,22650,268242,245592,Yes
ACU,Electronics and Communication Engineering,COMEDK,2024,225449,79237,14703,26852,346241,319389,No
AITM,Chemical Engineering,KCET,2023,51365,84898,14118,15817,166198,150381,No
BMSIT,Robotics and Automation Engineering,COMEDK,2023,177613,68790,14642,18771,279816,261045,No
ACU,Biotechnology,KCET,2023,63594,84765,19867,17959,186185,168226,Yes
GMIT,Robotics and Automation Engineering,COMEDK,2023,229001,91129,9546,13304,342980,329676,No
AEC,Mechanical Engineering,COMEDK,2024,193847,92929,11093,10161,308030,297869,No
BIT,Aerospace Engineering,COMEDK,2024,208728,93720,9140,15577,327165,311588,No
KLSGIT,Robotics and Automation Engineering,COMEDK,2023,178345,83052,11130,27139,299666,272527,Yes
AEC,Artificial Intelligence and Data Science,KCET,2024,79217,70662,10167,28319,188365,160046,No
MSRUAS,Aerospace Engineering,KCET,2024,55951,77546,8605,26445,168547,142102,No
YKCE,Electrical and Electronics Engineering,COMEDK,2024,233753,91852,13006,12450,351061,338611,Yes
NMIT,Electronics and Communication Engineering,COMEDK,2024,160218,73707,10625,24667,269217,244550,No
VIT,Aerospace Engineering,COMEDK,2023,207933,64039,8968,24411,305351,280940,No
NIE,Chemical Engineering,COMEDK,2023,179511,84819,16785,28365,309480,281115,Yes
BMSIT,Chemical Engineering,COMEDK,2024,225974,62434,14713,11774,314895,303121,No
SJBIT,Artificial Intelligence and Data Science,KCET,2023,52600,90699,17061,28855,189215,160360,Yes
RVCE,Data Science,KCET,2024,56156,67206,9993,29074,162429,133355,Yes
AECMandya,Mechanical Engineering,COMEDK,2024,177234,87560,9076,16043,289913,273870,Yes
VVCE,Electronics and Communication Engineering,KCET,2023,84433,76918,9603,17100,188054,170954,Yes
SIT,Artificial Intelligence and Data Science,KCET,2024,72683,73141,18822,23894,188540,164646,No
AEC,Artificial Intelligence and Data Science,KCET,2024,67371,71836,8156,13270,160633,147363,No
BIT,Civil Engineering,KCET,2024,72173,68854,10148,11676,162851,151175,Yes
DrAIT,Chemical Engineering,COMEDK,2024,245014,63039,18204,22299,348556,326257,Yes
BMIT,Mechanical Engineering,KCET,2023,63195,61829,14240,23617,162881,139264,Yes
NIE,Electrical and Electronics Engineering,KCET,2023,62217,68233,16550,21606,168606,147000,Yes
RIT,Information Science and Engineering,COMEDK,2023,167555,91324,9031,23573,291483,267910,No
VemanaIT,Mechanical Engineering,COMEDK,2023,205887,75209,19818,10088,311002,300914,Yes
JSSSTU,Robotics and Automation Engineering,KCET,2024,50188,73719,13354,21802,159063,137261,No
BMIT,Mechanical Engineering,COMEDK,2024,179920,87066,19623,12142,298751,286609,Yes
DSATM,Biotechnology,COMEDK,2023,176890,70236,8717,29113,284956,255843,No
DBIT,Aerospace Engineering,KCET,2023,63994,63799,19227,16781,163801,147020,Yes
DSATM,Electronics and Communication Engineering,COMEDK,2023,190259,71450,18238,22976,302923,279947,No
AEC,Robotics and Automation Engineering,COMEDK,2024,182373,90737,19128,19722,311960,292238,Yes
PRES,Artificial Intelligence and Data Science,COMEDK,2023,163578,69798,8347,21386,263109,241723,Yes
BNMIT,Chemical Engineering,COMEDK,2024,184907,93101,18540,23100,319648,296548,Yes
JSSSTU,Chemical Engineering,KCET,2023,69648,64128,10535,12443,156754,144311,Yes
SDMCET,Data Science,COMEDK,2023,180644,90891,15230,11829,298594,286765,Yes
YKCE,Aerospace Engineering,COMEDK,2024,230528,63957,19161,15618,329264,313646,No
RAIT,Mechanical Engineering,KCET,2024,70095,78154,8468,18485,175202,156717,Yes
VIT,Robotics and Automation Engineering,COMEDK,2023,236334,67143,9635,13599,326711,313112,Yes
VemanaIT,Aerospace Engineering,KCET,2024,51416,60702,10833,11098,134049,122951,Yes
NCET,Aerospace Engineering,COMEDK,2024,206140,77492,11278,26754,321664,294910,Yes
NMIT,Electrical and Electronics Engineering,KCET,2023,71853,93278,9463,23098,197692,174594,Yes
VIT,Chemical Engineering,KCET,2023,52562,94123,9855,15349,171889,156540,No
REVA,Biotechnology,KCET,2023,78766,89683,10407,17425,196281,178856,No
GIT,Robotics and Automation Engineering,KCET,2024,68522,61638,17049,12109,159318,147209,No
BNMIT,Aerospace Engineering,KCET,2023,68667,69750,12020,13036,163473,150437,No
SDMIT,Data Science,COMEDK,2023,160558,73255,15565,16809,266187,249378,Yes
VIT,Artificial Intelligence and Data Science,COMEDK,2024,206321,76704,18810,27957,329792,301835,No
VSM,Aerospace Engineering,KCET,2023,73862,75817,17158,15502,182339,166837,Yes
BITM,Electronics and Communication Engineering,COMEDK,2024,166224,60046,19219,13787,259276,245489,Yes
RVCE,Chemical Engineering,COMEDK,2023,218120,68117,19705,11875,317817,305942,Yes
VVCE,Artificial Intelligence and Data Science,COMEDK,2024,197141,62089,12448,10579,282257,271678,No
SJBIT,Data Science,COMEDK,2024,214266,88918,17112,23854,344150,320296,Yes
NIE,Electrical and Electronics Engineering,KCET,2023,66307,92445,12394,23285,194431,171146,No
HKBK,Electrical and Electronics Engineering,KCET,2024,77188,66860,11936,25893,181877,155984,Yes
YKCE,Computer Science and Engineering,KCET,2023,60682,89419,10402,13178,173681,160503,Yes
EastPoint,Robotics and Automation Engineering,KCET,2024,60190,64668,8659,13212,146729,133517,Yes
BMSCE,Computer Science and Engineering,KCET,2024,84441,79966,19356,22746,206509,183763,No
JSSSTU,Data Science,COMEDK,2024,170755,75993,15298,20216,282262,262046,Yes
JIT,Computer Science and Engineering,COMEDK,2024,196422,66214,15243,16917,294796,277879,No
BITM,Biotechnology,KCET,2023,75471,84676,18077,17786,196010,178224,No
JNNCE,Information Science and Engineering,COMEDK,2023,195504,89472,10558,11551,307085,295534,No
CITGubbi,Electrical and Electronics Engineering,COMEDK,2023,224651,84655,14557,27135,350998,323863,No
JNNCE,Civil Engineering,KCET,2023,55598,85308,11630,12279,164815,152536,Yes
RVCE,Chemical Engineering,COMEDK,2023,195963,93395,17186,29215,335759,306544,No
BMSIT,Aerospace Engineering,COMEDK,2023,196177,89997,9020,18967,314161,295194,Yes
AITM,Civil Engineering,COMEDK,2023,187697,94297,18825,23147,323966,300819,No
HKBK,Electrical and Electronics Engineering,KCET,2023,50049,73283,16849,10476,150657,140181,No
SCEM,Biotechnology,COMEDK,2023,205144,60585,12194,21172,299095,277923,No
CITGubbi,Electrical and Electronics Engineering,COMEDK,2024,245769,91497,14833,28191,380290,352099,No
VVCE,Electrical and Electronics Engineering,KCET,2023,58189,67744,17558,27876,171367,143491,No
BNMIT,Chemical Engineering,KCET,2023,63498,79359,8836,29940,181633,151693,No
NIE,Computer Science and Engineering,KCET,2023,59652,82289,17476,27271,186688,159417,Yes
BITM,Mechanical Engineering,KCET,2024,59943,69265,10805,20625,160638,140013,No
PESU,Chemical Engineering,COMEDK,2023,174326,75637,18320,13329,281612,268283,Yes
RNSIT,Data Science,COMEDK,2024,214606,88618,10973,26991,341188,314197,Yes
SJBCE,Civil Engineering,KCET,2024,74996,86354,16687,14058,192095,178037,No
RIT,Electrical and Electronics Engineering,COMEDK,2023,175665,62196,16147,23335,277343,254008,No
JIT,Electronics and Communication Engineering,COMEDK,2024,168200,61526,14095,18246,262067,243821,No
BMSIT,Robotics and Automation Engineering,KCET,2024,80663,78432,15442,11450,185987,174537,Yes
GIT,Information Science and Engineering,KCET,2023,74392,62165,15807,29696,182060,152364,No
RVUNIV,Aerospace Engineering,KCET,2024,73106,62576,10103,18414,164199,145785,Yes
RAIT,Electrical and Electronics Engineering,KCET,2024,52664,84008,15706,26158,178536,152378,Yes
SITM,Chemical Engineering,KCET,2024,83246,63772,10135,20572,177725,157153,Yes
SDMIT,Mechanical Engineering,COMEDK,2024,205997,87219,16743,17336,327295,309959,Yes
DSCE,Chemical Engineering,KCET,2023,69646,84934,11835,26143,192558,166415,No
KSIT,Chemical Engineering,COMEDK,2023,182947,60171,10241,26837,280196,253359,No
KSIT,Artificial Intelligence and Data Science,KCET,2024,80021,65990,12045,26657,184713,158056,No
YKCE,Biotechnology,COMEDK,2024,204186,71893,12092,22728,310899,288171,No
RVUNIV,Data Science,COMEDK,2023,201141,76658,19896,24008,321703,297695,No
VVIT,Civil Engineering,COMEDK,2023,228785,80952,18516,17997,346250,328253,No
EastPoint,Biotechnology,COMEDK,2023,183354,76094,14286,12284,286018,273734,No
SJBIT,Robotics and Automation Engineering,COMEDK,2024,173380,83571,8543,12990,278484,265494,No
SITM,Data Science,KCET,2024,52009,83688,14378,27671,177746,150075,Yes
BMIT,Electrical and Electronics Engineering,KCET,2023,84814,66757,15532,22505,189608,167103,No
SITM,Electronics and Communication Engineering,COMEDK,2024,178725,89176,18576,20374,306851,286477,No
DBIT,Aerospace Engineering,KCET,2023,57228,89861,15530,22836,185455,162619,Yes
PRES,Electronics and Communication Engineering,KCET,2023,83702,63436,8813,25182,181133,155951,No
AECMandya,Data Science,KCET,2023,65669,72099,9805,16429,164002,147573,Yes
VIT,Aerospace Engineering,KCET,2023,71766,69987,8795,17480,168028,150548,No
ACU,Aerospace Engineering,KCET,2023,64318,63446,19301,19578,166643,147065,Yes
AECMandya,Information Science and Engineering,KCET,2023,72361,73281,9470,13635,168747,155112,No
NMIT,Information Science and Engineering,COMEDK,2023,229498,72545,14170,26891,343104,316213,Yes
ACU,Artificial Intelligence and Data Science,COMEDK,2023,237103,93646,10634,19382,360765,341383,Yes
RNSIT,Chemical Engineering,KCET,2024,60303,90496,17604,27729,196132,168403,No
KLEIT,Artificial Intelligence and Data Science,KCET,2024,84874,81599,19485,20553,206511,185958,Yes
JSSSTU,Civil Engineering,KCET,2023,70367,93531,9174,10658,183730,173072,No
DSCE,Aerospace Engineering,KCET,2024,66315,87199,14410,21173,189097,167924,No
VSM,Biotechnology,KCET,2023,79952,93945,11605,29450,214952,185502,No
MSRIT,Mechanical Engineering,KCET,2023,57290,75222,19248,22848,174608,151760,No
BITM,Robotics and Automation Engineering,KCET,2023,71783,82487,11115,26111,191496,165385,No
MSRUAS,Electronics and Communication Engineering,KCET,2023,62789,93232,9920,10806,176747,165941,Yes
RNSIT,Aerospace Engineering,COMEDK,2024,210616,91754,19724,23958,346052,322094,Yes
BMSIT,Electronics and Communication Engineering,KCET,2024,58208,92339,9412,17222,177181,159959,No
SIT,Biotechnology,KCET,2024,68434,75665,16969,27713,188781,161068,Yes
NMIT,Biotechnology,KCET,2024,84863,68366,19872,25089,198190,173101,No
VVIT,Data Science,KCET,2024,58220,79628,17409,28259,183516,155257,No
KLSGIT,Information Science and Engineering,KCET,2024,51030,91157,8294,23797,174278,150481,Yes
GIT,Computer Science and Engineering,COMEDK,2023,217114,72330,18332,11203,318979,307776,Yes
SITM,Mechanical Engineering,KCET,2023,57100,73483,8450,15203,154236,139033,No
MSRIT,Electronics and Communication Engineering,KCET,2023,50125,63512,15997,17320,146954,129634,No
MVJCE,Artificial Intelligence and Data Science,COMEDK,2024,234559,86624,15327,10479,346989,336510,No
JNNCE,Aerospace Engineering,COMEDK,2024,233186,87863,9963,10606,341618,331012,Yes
NMIT,Electrical and Electronics Engineering,KCET,2023,62598,73711,11775,14472,162556,148084,Yes
DrAIT,Civil Engineering,COMEDK,2023,210177,85000,15127,26948,337252,310304,Yes
YKCE,Biotechnology,KCET,2023,81759,85235,11414,10452,188860,178408,No
KLSGIT,Aerospace Engineering,KCET,2024,61151,94755,8487,15517,179910,164393,No
NHCE,Chemical Engineering,COMEDK,2024,186934,66407,12037,16994,282372,265378,Yes
KLEIT,Artificial Intelligence and Data Science,KCET,2023,52572,77859,16726,22606,169763,147157,No
VVCE,Electronics and Communication Engineering,KCET,2024,53189,74493,10768,26027,164477,138450,Yes
NCET,Robotics and Automation Engineering,COMEDK,2023,210283,81181,13210,14849,319523,304674,No
NIE,Artificial Intelligence and Data Science,COMEDK,2023,249109,71270,17551,18417,356347,337930,Yes
KLSGIT,Chemical Engineering,KCET,2023,71149,82597,8719,28822,191287,162465,No
CITGubbi,Artificial Intelligence and Data Science,KCET,2024,63263,91790,9229,27834,192116,164282,No
SJBIT,Robotics and Automation Engineering,KCET,2023,71104,73541,12984,12809,170438,157629,Yes
SIT,Data Science,COMEDK,2024,179075,71910,9133,17276,277394,260118,No
PESU,Information Science and Engineering,KCET,2023,50016,62140,13879,27545,153580,126035,Yes
UVCE,Robotics and Automation Engineering,KCET,2023,77069,76352,9025,29327,191773,162446,No
NMIT,Data Science,COMEDK,2024,207237,81127,9489,28125,325978,297853,No
AIT,Civil Engineering,COMEDK,2023,195533,92096,8345,24882,320856,295974,No
BMSIT,Civil Engineering,KCET,2023,57196,79929,13228,21160,171513,150353,No
AITM,Aerospace Engineering,KCET,2024,50767,86053,10957,11554,159331,147777,No
RAIT,Data Science,KCET,2024,74926,89958,15139,17064,197087,180023,Yes
JIT,Artificial Intelligence and Data Science,KCET,2023,70328,80349,19443,10724,180844,170120,No
PRES,Aerospace Engineering,COMEDK,2023,170812,85745,15434,10182,282173,271991,Yes
BITM,Biotechnology,COMEDK,2024,206842,69986,16982,11832,305642,293810,Yes
YKCE,Information Science and Engineering,COMEDK,2024,195480,65308,10917,24464,296169,271705,Yes
KLSGIT,Biotechnology,COMEDK,2023,192043,62112,13316,27854,295325,267471,No
MVJCE,Electronics and Communication Engineering,KCET,2024,65138,75626,19108,14835,174707,159872,No
MSRUAS,Electronics and Communication Engineering,COMEDK,2024,170226,64173,18266,27075,279740,252665,No
KLEIT,Data Science,KCET,2024,60120,89062,15498,26135,190815,164680,Yes
RNSIT,Electrical and Electronics Engineering,KCET,2023,78551,76560,12252,10631,177994,167363,Yes
KSIT,Information Science and Engineering,COMEDK,2023,218099,65771,8284,18123,310277,292154,Yes
NIE,Artificial Intelligence and Data Science,COMEDK,2023,192592,90760,8492,12629,304473,291844,Yes
EastPoint,Information Science and Engineering,COMEDK,2023,240785,90839,8913,25782,366319,340537,No
NHCE,Civil Engineering,COMEDK,2024,188418,82420,12435,17019,300292,283273,No
SDMIT,Aerospace Engineering,KCET,2024,58601,77533,15665,19324,171123,151799,No
KLSGIT,Information Science and Engineering,COMEDK,2023,214625,75035,11800,28908,330368,301460,No
NHCE,Artificial Intelligence and Data Science,COMEDK,2024,197839,93265,18228,18769,328101,309332,No
RVUNIV,Biotechnology,KCET,2024,59372,70960,16110,16362,162804,146442,No
MVJCE,Artificial Intelligence and Data Science,KCET,2023,78352,64594,19696,11971,174613,162642,Yes
HKBK,Artificial Intelligence and Data Science,COMEDK,2023,249910,60695,11626,27489,349720,322231,No
RNSIT,Data Science,KCET,2024,59697,68246,16320,20663,164926,144263,No
AITM,Civil Engineering,COMEDK,2023,211944,60881,8657,28694,310176,281482,Yes
DSATM,Data Science,KCET,2024,79750,82321,8406,10455,180932,170477,Yes
RIT,Electronics and Communication Engineering,KCET,2024,67698,89232,11702,29674,198306,168632,No
NHCE,Data Science,COMEDK,2024,197046,70293,10908,25490,303737,278247,No
MSRUAS,Aerospace Engineering,COMEDK,2023,194466,62957,8033,21406,286862,265456,Yes
AIT,Mechanical Engineering,COMEDK,2023,192963,70686,18175,19400,301224,281824,Yes
CMRIT,Electronics and Communication Engineering,KCET,2023,78275,91161,18829,29566,217831,188265,Yes
BMIT,Civil Engineering,COMEDK,2024,197776,84794,8641,14799,306010,291211,No
NIE,Aerospace Engineering,COMEDK,2024,193970,85126,11624,26243,316963,290720,Yes
YKCE,Electronics and Communication Engineering,KCET,2024,50065,80396,11096,18827,160384,141557,No
RNSIT,Civil Engineering,COMEDK,2024,248034,87152,18753,14037,367976,353939,Yes
MVJCE,Mechanical Engineering,KCET,2024,84224,72551,11955,18718,187448,168730,No
NIE,Information Science and Engineering,KCET,2023,68340,71932,17710,17580,175562,157982,Yes
VIT,Computer Science and Engineering,COMEDK,2024,190135,93539,10675,20956,315305,294349,No
PESCE,Biotechnology,COMEDK,2023,181107,70647,13947,14263,279964,265701,No
ACU,Biotechnology,KCET,2023,73922,77807,12918,23824,188471,164647,No
SDMCET,Aerospace Engineering,KCET,2024,74643,72528,17713,18156,183040,164884,No
JSSSTU,Computer Science and Engineering,COMEDK,2024,232487,77912,10312,25531,346242,320711,No
HKBK,Information Science and Engineering,COMEDK,2024,245062,77553,18678,13101,354394,341293,Yes
RAIT,Robotics and Automation Engineering,KCET,2024,55413,60193,14538,10930,141074,130144,Yes
JNNCE,Mechanical Engineering,KCET,2024,52812,82520,12394,16301,164027,147726,No
NHCE,Biotechnology,COMEDK,2023,204228,84681,8287,12174,309370,297196,No
ACU,Civil Engineering,KCET,2023,65409,87941,17096,23865,194311,170446,Yes
ACU,Information Science and Engineering,COMEDK,2024,176780,86010,9121,19948,291859,271911,No
AITM,Computer Science and Engineering,KCET,2024,71172,60286,8615,19377,159450,140073,No
AECMandya,Aerospace Engineering,COMEDK,2024,241857,65327,12601,13021,332806,319785,No
BMIT,Mechanical Engineering,KCET,2024,67853,78336,17991,25534,189714,164180,No
VIT,Mechanical Engineering,KCET,2024,66209,74165,14705,14032,169111,155079,Yes
SJBCE,Civil Engineering,KCET,2024,50980,87830,13242,18187,170239,152052,No
SDMIT,Mechanical Engineering,KCET,2023,56284,78331,17598,18627,170840,152213,No
DrAIT,Mechanical Engineering,COMEDK,2023,200145,64008,17005,10187,291345,281158,Yes
AEC,Data Science,KCET,2023,75941,72144,11256,15666,175007,159341,No
KLSGIT,Biotechnology,COMEDK,2023,237009,63271,14815,22994,338089,315095,Yes
PESCE,Chemical Engineering,COMEDK,2024,170979,71218,13632,17090,272919,255829,Yes
CMRIT,Aerospace Engineering,KCET,2023,76998,72941,14374,20876,185189,164313,Yes
YKCE,Information Science and Engineering,KCET,2024,57299,67957,8635,15952,149843,133891,Yes
GIT,Electrical and Electronics Engineering,COMEDK,2023,224309,85900,12957,26769,349935,323166,Yes
SIT,Artificial Intelligence and Data Science,COMEDK,2024,242524,68249,18198,15328,344299,328971,No
KLSGIT,Data Science,KCET,2024,55593,60994,9141,25815,151543,125728,No
BMIT,Computer Science and Engineering,COMEDK,2023,210629,78106,13194,28347,330276,301929,Yes
GMIT,Computer Science and Engineering,KCET,2024,55603,80912,19321,12969,168805,155836,No
MSRUAS,Electronics and Communication Engineering,COMEDK,2023,196383,70552,11571,26223,304729,278506,Yes
VemanaIT,Computer Science and Engineering,COMEDK,2024,214614,74898,8256,18750,316518,297768,Yes
KSIT,Data Science,KCET,2023,69931,85842,19647,29293,204713,175420,Yes
SDMCET,Civil Engineering,COMEDK,2023,213775,92177,17939,11472,335363,323891,No
GIT,Mechanical Engineering,KCET,2023,55987,78611,16951,23666,175215,151549,No
VemanaIT,Data Science,KCET,2024,67122,84695,10211,22059,184087,162028,No
NCET,Biotechnology,COMEDK,2024,174275,68603,17954,21179,282011,260832,No
SCEM,Chemical Engineering,COMEDK,2023,179577,91218,11868,24977,307640,282663,Yes
BMSCE,Data Science,KCET,2023,63828,85450,18499,21525,189302,167777,No
JNNCE,Biotechnology,COMEDK,2024,215853,64004,9836,27767,317460,289693,Yes
JIT,Data Science,COMEDK,2024,211580,85380,18290,25829,341079,315250,No
DSCE,Aerospace Engineering,KCET,2023,78842,71614,13084,14285,177825,163540,Yes
PRES,Artificial Intelligence and Data Science,KCET,2024,64540,64310,9081,21431,159362,137931,Yes
HKBK,Mechanical Engineering,COMEDK,2024,207938,66996,16509,28698,320141,291443,No
KLSGIT,Mechanical Engineering,KCET,2023,63738,71567,13782,23862,172949,149087,Yes
VSM,Electronics and Communication Engineering,COMEDK,2023,242224,68446,9914,11718,332302,320584,Yes
ACU,Mechanical Engineering,KCET,2024,77151,92150,15199,20832,205332,184500,No
DrAIT,Aerospace Engineering,KCET,2024,75968,63508,11655,24637,175768,151131,Yes
VIT,Mechanical Engineering,KCET,2023,58968,92061,10290,14934,176253,161319,No
SDMCET,Aerospace Engineering,KCET,2024,71488,69032,19872,14500,174892,160392,Yes
DrAIT,Chemical Engineering,COMEDK,2024,231700,72413,14410,29241,347764,318523,Yes
AIT,Electronics and Communication Engineering,KCET,2024,73832,61143,9500,11913,156388,144475,Yes
YKCE,Information Science and Engineering,KCET,2023,53062,62318,10390,14562,140332,125770,No
JIT,Robotics and Automation Engineering,KCET,2024,56930,87488,8451,20021,172890,152869,Yes
PESCE,Electronics and Communication Engineering,KCET,2024,67153,69002,13928,20150,170233,150083,No
RAIT,Chemical Engineering,COMEDK,2024,233751,71756,13010,22776,341293,318517,No
SIT,Biotechnology,COMEDK,2024,171495,85171,9484,16388,282538,266150,Yes
ACU,Information Science and Engineering,KCET,2023,83721,90427,10080,22427,206655,184228,Yes
YKCE,Computer Science and Engineering,KCET,2024,55660,86319,16124,26237,184340,158103,Yes
JIT,Data Science,COMEDK,2023,236020,71127,15985,20319,343451,323132,Yes
UVCE,Aerospace Engineering,KCET,2023,83090,94802,12186,29235,219313,190078,Yes
PRES,Data Science,KCET,2024,63906,87375,17704,26213,195198,168985,No
KLEIT,Chemical Engineering,COMEDK,2024,192516,93469,11909,14905,312799,297894,Yes
DSATM,Biotechnology,COMEDK,2024,240457,81313,11320,22855,355945,333090,No
AIT,Chemical Engineering,COMEDK,2024,183421,94736,18420,18958,315535,296577,Yes
BMIT,Artificial Intelligence and Data Science,KCET,2023,75586,81285,18329,20715,195915,175200,Yes
GMIT,Biotechnology,KCET,2023,83309,60243,10294,21225,175071,153846,No
RIT,Electrical and Electronics Engineering,KCET,2024,82275,73156,15635,11960,183026,171066,Yes
NIE,Artificial Intelligence and Data Science,KCET,2024,64996,83022,15950,20343,184311,163968,Yes
REVA,Biotechnology,KCET,2024,84851,63498,8503,21666,178518,156852,Yes
RNSIT,Chemical Engineering,COMEDK,2023,232144,92335,8638,14079,347196,333117,Yes
ACU,Biotechnology,COMEDK,2024,223584,69860,13957,12597,319998,307401,No
CITGubbi,Chemical Engineering,KCET,2023,81810,68438,9091,15771,175110,159339,No
GMIT,Civil Engineering,COMEDK,2024,197984,82321,10197,19870,310372,290502,No
AIT,Mechanical Engineering,KCET,2024,68491,93991,19187,14956,196625,181669,No
RVCE,Data Science,COMEDK,2024,177446,74877,13610,10687,276620,265933,Yes
SCEM,Civil Engineering,KCET,2024,83974,85571,14884,15166,199595,184429,No
VVCE,Electrical and Electronics Engineering,COMEDK,2024,207628,80374,19563,29698,337263,307565,Yes
HKBK,Electronics and Communication Engineering,COMEDK,2023,204802,71673,10663,14885,302023,287138,Yes
NCET,Information Science and Engineering,COMEDK,2023,177805,87956,17050,13956,296767,282811,Yes
RAIT,Mechanical Engineering,KCET,2023,77132,79821,19233,21866,198052,176186,No
NHCE,Information Science and Engineering,COMEDK,2024,227118,78543,9355,27745,342761,315016,Yes
CMRIT,Electrical and Electronics Engineering,COMEDK,2023,207639,63631,9652,28770,309692,280922,Yes
MSRUAS,Data Science,COMEDK,2023,242682,62989,13412,20196,339279,319083,Yes
JNNCE,Mechanical Engineering,COMEDK,2024,225443,75339,15127,28400,344309,315909,Yes
SDMCET,Aerospace Engineering,COMEDK,2024,210450,90452,12080,21619,334601,312982,Yes
NMIT,Computer Science and Engineering,KCET,2023,65158,64807,12706,15404,158075,142671,Yes
JIT,Mechanical Engineering,COMEDK,2023,196695,63225,9449,15691,285060,269369,No
SDMCET,Electrical and Electronics Engineering,COMEDK,2023,172470,94232,13149,17267,297118,279851,Yes
EastPoint,Aerospace Engineering,COMEDK,2023,207359,71229,9771,28108,316467,288359,No
RVCE,Information Science and Engineering,KCET,2024,57205,65542,9892,22091,154730,132639,No
EastPoint,Aerospace Engineering,COMEDK,2024,182681,67957,14284,27160,292082,264922,No
KSIT,Robotics and Automation Engineering,KCET,2024,60961,65322,19103,22799,168185,145386,No
SCEM,Robotics and Automation Engineering,COMEDK,2023,232318,76905,10006,28574,347803,319229,Yes
AIT,Biotechnology,COMEDK,2024,182188,93731,15269,17429,308617,291188,Yes
VIT,Chemical Engineering,COMEDK,2023,178951,64745,11806,25345,280847,255502,No
CITGubbi,Aerospace Engineering,KCET,2023,52838,73706,18855,19993,165392,145399,No
RAIT,Data Science,COMEDK,2024,206831,86641,9810,26603,329885,303282,No
VIT,Mechanical Engineering,KCET,2023,53274,73500,11260,25864,163898,138034,Yes
VVCE,Electronics and Communication Engineering,COMEDK,2024,197562,84758,10386,26313,319019,292706,Yes
JNNCE,Electrical and Electronics Engineering,COMEDK,2023,210965,80858,10791,21803,324417,302614,Yes
SJBCE,Aerospace Engineering,COMEDK,2024,239586,62454,17357,14029,333426,319397,No
YKCE,Biotechnology,COMEDK,2024,229950,92790,10923,27583,361246,333663,Yes
GMIT,Aerospace Engineering,COMEDK,2024,198418,61728,12815,18989,291950,272961,No
VemanaIT,Information Science and Engineering,COMEDK,2024,228442,86770,16193,10566,341971,331405,No
AEC,Robotics and Automation Engineering,KCET,2023,52052,72888,9292,21734,155966,134232,No
BITM,Electronics and Communication Engineering,COMEDK,2023,226621,72122,19272,13187,331202,318015,No
VIT,Electronics and Communication Engineering,KCET,2024,63123,74590,8348,26794,172855,146061,Yes
VVIT,Chemical Engineering,KCET,2024,78819,81650,11103,17169,188741,171572,Yes
SDMIT,Electronics and Communication Engineering,KCET,2023,62047,83352,16123,19758,181280,161522,No
VemanaIT,Civil Engineering,KCET,2024,65338,87071,10193,20945,183547,162602,Yes
DSCE,Robotics and Automation Engineering,COMEDK,2023,195658,73556,9499,16283,294996,278713,Yes
NIE,Mechanical Engineering,KCET,2023,51548,79258,10475,17479,158760,141281,Yes
PESCE,Artificial Intelligence and Data Science,KCET,2024,64003,94236,19333,19851,197423,177572,No
KLSGIT,Computer Science and Engineering,COMEDK,2023,240227,86089,12201,27377,365894,338517,No
RAIT,Computer Science and Engineering,COMEDK,2024,244814,63029,10105,17494,335442,317948,No
VSM,Civil Engineering,KCET,2024,71000,87323,10877,26804,196004,169200,Yes
AEC,Information Science and Engineering,COMEDK,2023,228189,85059,15689,25300,354237,328937,No
NCET,Data Science,COMEDK,2024,234446,73103,16294,12653,336496,323843,No
SCEM,Aerospace Engineering,KCET,2024,60891,66084,18975,11682,157632,145950,No
SCEM,Electrical and Electronics Engineering,KCET,2023,50088,85228,17756,27708,180780,153072,No
JNNCE,Aerospace Engineering,COMEDK,2024,168945,85521,16007,13549,284022,270473,Yes
RIT,Chemical Engineering,COMEDK,2023,196661,81627,13742,21469,313499,292030,Yes
AITM,Information Science and Engineering,COMEDK,2024,239865,75446,14052,17347,346710,329363,No
KLSGIT,Chemical Engineering,KCET,2024,52095,63287,18333,14149,147864,133715,Yes
KLEIT,Biotechnology,COMEDK,2024,220235,78763,18852,14815,332665,317850,No
BMSIT,Robotics and Automation Engineering,KCET,2023,76349,75244,11130,15863,178586,162723,No
BMSIT,Electrical and Electronics Engineering,COMEDK,2023,196657,64491,14939,22115,298202,276087,No
SJBIT,Data Science,COMEDK,2024,183689,85894,15973,19884,305440,285556,No
NHCE,Aerospace Engineering,COMEDK,2023,176016,83718,8937,21416,290087,268671,No
DSCE,Mechanical Engineering,KCET,2023,55145,91988,8913,23027,179073,156046,No
BMSIT,Aerospace Engineering,COMEDK,2024,222260,84463,11542,23301,341566,318265,No
SDMCET,Biotechnology,KCET,2023,83604,87877,10702,19821,202004,182183,No
MSRIT,Civil Engineering,COMEDK,2024,185838,92034,10093,19458,307423,287965,No
RVUNIV,Mechanical Engineering,COMEDK,2024,180724,78911,11724,14281,285640,271359,Yes
VSM,Computer Science and Engineering,KCET,2024,72715,66928,18356,16710,174709,157999,No
SIT,Data Science,COMEDK,2024,223397,83498,9587,26027,342509,316482,Yes
MVJCE,Aerospace Engineering,COMEDK,2023,236512,78081,16176,21883,352652,330769,No
NMIT,Chemical Engineering,KCET,2024,72388,62258,12923,27789,175358,147569,Yes
RVUNIV,Artificial Intelligence and Data Science,COMEDK,2023,221538,78294,9796,14847,324475,309628,No
RNSIT,Artificial Intelligence and Data Science,KCET,2023,66611,69289,17946,23831,177677,153846,No
HKBK,Biotechnology,COMEDK,2024,240977,73966,12391,23793,351127,327334,Yes
BNMIT,Information Science and Engineering,COMEDK,2024,230202,71834,9678,24089,335803,311714,Yes
JNNCE,Civil Engineering,COMEDK,2023,235492,81160,17732,14361,348745,334384,No
GMIT,Mechanical Engineering,KCET,2024,61285,62122,16148,10927,150482,139555,Yes
SIT,Data Science,KCET,2023,59998,62539,9217,12099,143853,131754,Yes
KLEIT,Data Science,COMEDK,2023,209058,67575,10348,26920,313901,286981,Yes
DSATM,Electronics and Communication Engineering,COMEDK,2023,243554,61934,13001,26196,344685,318489,No
NMIT,Civil Engineering,COMEDK,2023,227842,82996,8063,20655,339556,318901,Yes
SITM,Civil Engineering,COMEDK,2023,213870,87638,9711,17866,329085,311219,No
VIT,Biotechnology,COMEDK,2024,206926,67359,11795,12798,298878,286080,Yes
RAIT,Information Science and Engineering,KCET,2023,55932,74359,12545,20595,163431,142836,Yes
HKBK,Mechanical Engineering,COMEDK,2023,185674,93294,8249,28606,315823,287217,Yes
DBIT,Data Science,COMEDK,2023,249351,64448,8033,27654,349486,321832,No
NIE,Electronics and Communication Engineering,COMEDK,2024,168738,70370,8815,22703,270626,247923,Yes
BNMIT,Biotechnology,COMEDK,2023,181227,94348,13488,20652,309715,289063,No
NMIT,Biotechnology,COMEDK,2024,201566,93499,19663,29412,344140,314728,Yes
KSIT,Mechanical Engineering,KCET,2024,51700,84240,14863,13742,164545,150803,Yes
ACU,Data Science,COMEDK,2023,210982,84936,11459,17270,324647,307377,Yes
PESU,Aerospace Engineering,KCET,2024,78898,92648,12969,25047,209562,184515,Yes
SJBCE,Computer Science and Engineering,COMEDK,2024,212060,69768,19465,16408,317701,301293,Yes
AIT,Data Science,COMEDK,2024,168149,76540,17500,16807,278996,262189,Yes
MSRUAS,Electrical and Electronics Engineering,COMEDK,2024,246725,68889,10411,13366,339391,326025,Yes
NIE,Electrical and Electronics Engineering,KCET,2024,74606,74142,19799,22621,191168,168547,No
VIT,Civil Engineering,KCET,2024,50026,88057,14600,12855,165538,152683,No
SIT,Electronics and Communication Engineering,KCET,2024,72895,76345,18389,26922,194551,167629,No
KLEIT,Civil Engineering,COMEDK,2023,176892,93039,11326,13358,294615,281257,Yes
AEC,Robotics and Automation Engineering,COMEDK,2023,190274,83202,14232,18219,305927,287708,Yes
RNSIT,Information Science and Engineering,KCET,2023,71901,72854,14084,14178,173017,158839,Yes
MSRIT,Mechanical Engineering,COMEDK,2023,161379,87904,14492,12150,275925,263775,No
VVIT,Artificial Intelligence and Data Science,COMEDK,2023,223685,75687,8404,23347,331123,307776,No
CMRIT,Mechanical Engineering,COMEDK,2024,222453,88579,9105,17263,337400,320137,Yes
ACU,Computer Science and Engineering,COMEDK,2024,202349,73419,8896,25693,310357,284664,Yes
BMIT,Mechanical Engineering,KCET,2024,57836,93828,13569,18169,183402,165233,Yes
NMIT,Mechanical Engineering,KCET,2024,67739,64592,11509,12569,156409,143840,No
BIT,Electrical and Electronics Engineering,COMEDK,2024,216523,70353,11981,10125,308982,298857,No
VemanaIT,Data Science,KCET,2024,76693,86793,19714,25155,208355,183200,No
KLSGIT,Electronics and Communication Engineering,COMEDK,2024,248769,74988,17674,10206,351637,341431,Yes
JNNCE,Chemical Engineering,KCET,2023,57828,72080,15316,27917,173141,145224,No
BITM,Electrical and Electronics Engineering,KCET,2024,54827,79918,8098,17528,160371,142843,Yes
KLEIT,Electrical and Electronics Engineering,KCET,2023,50302,60598,8903,25632,145435,119803,Yes
HKBK,Artificial Intelligence and Data Science,KCET,2024,56795,91557,17044,27430,192826,165396,Yes
VVCE,Electrical and Electronics Engineering,KCET,2023,68281,92351,16409,23399,200440,177041,Yes
UVCE,Robotics and Automation Engineering,KCET,2024,62922,61577,14258,15322,154079,138757,No
BMIT,Data Science,KCET,2024,71328,68417,15533,23444,178722,155278,No
BNMIT,Biotechnology,KCET,2024,59858,89205,11075,17793,177931,160138,Yes
VVIT,Electronics and Communication Engineering,COMEDK,2024,238068,89681,9508,10093,347350,337257,Yes
SITM,Biotechnology,KCET,2023,77963,76117,9833,19711,183624,163913,No
UVCE,Mechanical Engineering,KCET,2023,63889,90348,16958,25092,196287,171195,Yes
SITM,Mechanical Engineering,KCET,2023,66407,67827,14370,20904,169508,148604,Yes
SCEM,Chemical Engineering,COMEDK,2024,164059,68943,10587,15250,258839,243589,Yes
JNNCE,Chemical Engineering,KCET,2023,78253,81192,10313,19873,189631,169758,Yes
AEC,Data Science,COMEDK,2024,167781,94032,17668,28983,308464,279481,Yes
PESCE,Computer Science and Engineering,KCET,2023,68588,76354,14283,19256,178481,159225,No
UVCE,Computer Science and Engineering,KCET,2024,64030,75602,12463,26244,178339,152095,Yes
EastPoint,Robotics and Automation Engineering,KCET,2024,76667,61187,8875,13036,159765,146729,No
NIE,Electronics and Communication Engineering,KCET,2023,66324,81622,9343,23252,180541,157289,Yes
AITM,Electrical and Electronics Engineering,KCET,2023,53662,93717,8985,11727,168091,156364,Yes
RAIT,Civil Engineering,KCET,2024,63066,69630,18309,11611,162616,151005,No
CMRIT,Aerospace Engineering,COMEDK,2023,170125,72323,8464,15107,266019,250912,Yes
SJBIT,Robotics and Automation Engineering,COMEDK,2023,242481,83324,14326,26390,366521,340131,No
VSM,Artificial Intelligence and Data Science,KCET,2023,71710,70619,13281,27863,183473,155610,Yes
BIT,Computer Science and Engineering,COMEDK,2024,171623,64466,16165,23026,275280,252254,No
NMIT,Robotics and Automation Engineering,KCET,2023,54303,73154,19757,22909,170123,147214,No
AEC,Computer Science and Engineering,KCET,2024,67026,72601,9838,29213,178678,149465,Yes
BIT,Information Science and Engineering,KCET,2023,79643,69475,14190,14317,177625,163308,No
AECMandya,Biotechnology,KCET,2023,78649,93329,10696,18296,200970,182674,Yes
GMIT,Chemical Engineering,COMEDK,2023,244803,83368,12129,28107,368407,340300,No
YKCE,Data Science,KCET,2023,51298,74064,9979,18204,153545,135341,No
KLSGIT,Chemical Engineering,COMEDK,2024,185708,93111,19003,11781,309603,297822,No
KLEIT,Computer Science and Engineering,KCET,2023,55252,72785,9829,12896,150762,137866,No
BIT,Chemical Engineering,KCET,2024,69465,73035,13980,23665,180145,156480,No
NMIT,Artificial Intelligence and Data Science,KCET,2024,77314,78652,16365,12153,184484,172331,Yes
NIE,Electronics and Communication Engineering,KCET,2024,83113,90703,19000,13594,206410,192816,No
BMSIT,Mechanical Engineering,KCET,2023,62158,91321,13216,25030,191725,166695,No
BMIT,Biotechnology,COMEDK,2023,171703,63868,13489,23670,272730,249060,No
AEC,Robotics and Automation Engineering,KCET,2023,50774,80231,10269,27427,168701,141274,No
RIT,Information Science and Engineering,KCET,2023,59373,60778,16492,10496,147139,136643,No
KLEIT,Aerospace Engineering,KCET,2024,74890,90964,16545,28120,210519,182399,No
BNMIT,Information Science and Engineering,KCET,2023,70933,67029,17046,23315,178323,155008,Yes
PRES,Mechanical Engineering,COMEDK,2023,218076,66308,13423,12317,310124,297807,Yes
SJBCE,Artificial Intelligence and Data Science,COMEDK,2024,219617,90705,17305,11677,339304,327627,No
VSM,Mechanical Engineering,COMEDK,2023,234545,85827,15209,15107,350688,335581,No
PESCE,Biotechnology,COMEDK,2024,198852,65160,8104,11489,283605,272116,Yes
AEC,Electronics and Communication Engineering,COMEDK,2023,231207,74144,12943,21889,340183,318294,Yes
RVUNIV,Information Science and Engineering,KCET,2024,65413,84697,9308,13186,172604,159418,Yes
GIT,Artificial Intelligence and Data Science,COMEDK,2024,229366,78560,18880,12568,339374,326806,Yes
DBIT,Mechanical Engineering,COMEDK,2024,212561,60962,15911,28214,317648,289434,No
UVCE,Electrical and Electronics Engineering,COMEDK,2024,164297,63313,11558,28490,267658,239168,Yes
DBIT,Robotics and Automation Engineering,KCET,2023,74878,75717,17419,21754,189768,168014,Yes
PESU,Robotics and Automation Engineering,COMEDK,2023,161046,85622,19267,26360,292295,265935,Yes
PRES,Data Science,KCET,2023,65486,65605,16311,27106,174508,147402,No
SJBCE,Chemical Engineering,COMEDK,2024,170398,87446,19728,21111,298683,277572,Yes
MVJCE,Chemical Engineering,COMEDK,2024,202183,68363,16277,21069,307892,286823,No
SDMIT,Robotics and Automation Engineering,COMEDK,2023,200389,74453,9419,25037,309298,284261,Yes
PRES,Artificial Intelligence and Data Science,KCET,2024,81429,82373,9346,12239,185387,173148,Yes
RAIT,Aerospace Engineering,KCET,2024,82339,85437,11547,26936,206259,179323,No
RIT,Mechanical Engineering,KCET,2024,83881,62278,9577,28698,184434,155736,Yes
VemanaIT,Information Science and Engineering,COMEDK,2023,223790,74206,17508,15286,330790,315504,No
DSATM,Electrical and Electronics Engineering,COMEDK,2023,193708,68254,19834,24094,305890,281796,No
CMRIT,Data Science,COMEDK,2023,217896,69178,12915,28904,328893,299989,Yes
DSATM,Electrical and Electronics Engineering,KCET,2023,60679,93731,11745,20056,186211,166155,No
GMIT,Information Science and Engineering,KCET,2024,61160,70745,11261,13422,156588,143166,No
REVA,Chemical Engineering,KCET,2023,78907,88588,8480,27426,203401,175975,Yes
JNNCE,Data Science,COMEDK,2024,187055,67967,17415,14937,287374,272437,Yes
DSATM,Artificial Intelligence and Data Science,KCET,2023,63673,81415,18241,20609,183938,163329,Yes
BMSCE,Robotics and Automation Engineering,COMEDK,2023,197504,67615,9538,27509,302166,274657,No
GIT,Chemical Engineering,COMEDK,2024,182075,89803,16336,24692,312906,288214,Yes
NHCE,Artificial Intelligence and Data Science,COMEDK,2024,200708,90288,16865,21672,329533,307861,No
SJBCE,Data Science,KCET,2023,79931,81197,13932,14405,189465,175060,Yes
RVCE,Robotics and Automation Engineering,COMEDK,2023,198018,64662,9756,26420,298856,272436,No
NMIT,Electronics and Communication Engineering,KCET,2023,69247,83204,14239,23739,190429,166690,Yes
RVUNIV,Chemical Engineering,COMEDK,2023,196532,73835,13879,20625,304871,284246,Yes
CMRIT,Biotechnology,COMEDK,2023,189901,87666,9541,24197,311305,287108,No
BMIT,Civil Engineering,COMEDK,2023,224006,80974,14077,29857,348914,319057,No
BIT,Robotics and Automation Engineering,KCET,2023,60134,88616,17363,13252,179365,166113,No
SDMCET,Information Science and Engineering,KCET,2024,64618,61113,19386,26865,171982,145117,No
EastPoint,Robotics and Automation Engineering,COMEDK,2023,227323,69113,17837,11039,325312,314273,Yes
BITM,Chemical Engineering,COMEDK,2023,240394,67387,18424,28621,354826,326205,No
JNNCE,Artificial Intelligence and Data Science,KCET,2023,63516,76934,11167,26101,177718,151617,No
RVUNIV,Information Science and Engineering,COMEDK,2024,174118,88733,10752,23217,296820,273603,No
YKCE,Data Science,COMEDK,2024,192066,66690,17515,25712,301983,276271,No
RAIT,Computer Science and Engineering,KCET,2023,71505,91546,16896,15403,195350,179947,Yes
KLEIT,Data Science,KCET,2023,63148,83066,9411,15718,171343,155625,No
AECMandya,Electrical and Electronics Engineering,COMEDK,2023,223500,69057,10756,13901,317214,303313,No
DrAIT,Robotics and Automation Engineering,KCET,2024,55464,85856,15464,11720,168504,156784,No
SJBCE,Electrical and Electronics Engineering,COMEDK,2023,183977,68160,12346,18576,283059,264483,Yes
PRES,Mechanical Engineering,COMEDK,2024,216040,87676,17041,14421,335178,320757,No
BMSIT,Data Science,COMEDK,2024,165631,73758,14005,26069,279463,253394,Yes
DSATM,Information Science and Engineering,KCET,2024,67203,86962,18859,13219,186243,173024,Yes
HKBK,Mechanical Engineering,KCET,2023,82402,91765,13219,16189,203575,187386,No
PRES,Chemical Engineering,COMEDK,2023,194414,71126,19567,18756,303863,285107,Yes
SIT,Information Science and Engineering,KCET,2023,63728,88984,14029,18671,185412,166741,Yes
REVA,Civil Engineering,KCET,2023,64471,89843,18772,20170,193256,173086,Yes
GIT,Information Science and Engineering,COMEDK,2023,229526,76107,8822,29878,344333,314455,Yes
NCET,Robotics and Automation Engineering,COMEDK,2024,206613,71186,12727,21638,312164,290526,Yes
KLSGIT,Biotechnology,COMEDK,2024,196561,66074,10753,28167,301555,273388,No
RAIT,Electronics and Communication Engineering,COMEDK,2023,171647,71738,16271,16442,276098,259656,Yes
SJBCE,Artificial Intelligence and Data Science,KCET,2023,83777,93175,17896,13232,208080,194848,Yes
SDMIT,Electronics and Communication Engineering,COMEDK,2023,162326,83585,10044,12500,268455,255955,Yes
MVJCE,Civil Engineering,KCET,2024,82843,65757,14793,23921,187314,163393,No
RVUNIV,Computer Science and Engineering,KCET,2023,62171,79366,8248,24434,174219,149785,No
SJBCE,Electrical and Electronics Engineering,KCET,2024,75650,60664,10421,10950,157685,146735,Yes
JNNCE,Electrical and Electronics Engineering,COMEDK,2023,203301,83721,13094,29632,329748,300116,Yes
SDMCET,Computer Science and Engineering,KCET,2023,64164,77698,9071,17450,168383,150933,No
KSIT,Artificial Intelligence and Data Science,KCET,2024,68311,80874,10544,16144,175873,159729,Yes
JSSSTU,Chemical Engineering,COMEDK,2024,185416,73027,17394,18647,294484,275837,Yes
BIT,Electrical and Electronics Engineering,KCET,2024,80922,92215,10652,22081,205870,183789,No
DBIT,Mechanical Engineering,KCET,2024,74145,91946,14115,29312,209518,180206,No
CMRIT,Aerospace Engineering,KCET,2024,65045,85666,10449,25151,186311,161160,No
AECMandya,Aerospace Engineering,KCET,2023,55726,94233,9563,14916,174438,159522,No
MSRUAS,Biotechnology,COMEDK,2023,177598,87294,17041,19136,301069,281933,No
VemanaIT,Computer Science and Engineering,KCET,2024,58808,92099,14214,24380,189501,165121,Yes
CMRIT,Mechanical Engineering,KCET,2023,53159,61016,18996,15531,148702,133171,No
KLSGIT,Information Science and Engineering,KCET,2024,83176,67504,18613,26815,196108,169293,Yes
MSRUAS,Electronics and Communication Engineering,KCET,2024,65412,85454,12915,15340,179121,163781,Yes
DSATM,Chemical Engineering,COMEDK,2023,215571,66244,13640,28094,323549,295455,No
AITM,Artificial Intelligence and Data Science,KCET,2023,72330,94139,11509,22413,200391,177978,No
VemanaIT,Chemical Engineering,KCET,2023,57280,85269,13775,18767,175091,156324,No
EastPoint,Computer Science and Engineering,KCET,2023,61065,92878,17518,11925,183386,171461,Yes
CMRIT,Computer Science and Engineering,COMEDK,2024,179747,81803,16008,20386,297944,277558,Yes
PRES,Mechanical Engineering,COMEDK,2023,195171,72097,11697,22366,301331,278965,Yes
SJBIT,Information Science and Engineering,COMEDK,2023,220184,85542,17071,17291,340088,322797,Yes
PESU,Electrical and Electronics Engineering,KCET,2023,51978,69507,8324,29569,159378,129809,No
BITM,Information Science and Engineering,KCET,2023,51687,69322,16410,23622,161041,137419,Yes
VVCE,Robotics and Automation Engineering,COMEDK,2023,214105,72634,9509,22582,318830,296248,Yes
RNSIT,Biotechnology,KCET,2023,53043,94825,12551,19362,179781,160419,Yes
BITM,Electrical and Electronics Engineering,KCET,2023,59485,77665,18589,22416,178155,155739,Yes
SDMCET,Robotics and Automation Engineering,COMEDK,2024,209430,90889,13988,27223,341530,314307,No
RVCE,Artificial Intelligence and Data Science,COMEDK,2024,192794,79055,8878,15950,296677,280727,No
NCET,Data Science,COMEDK,2024,174017,66503,18050,19632,278202,258570,No
CITGubbi,Chemical Engineering,COMEDK,2024,199146,86744,14725,28873,329488,300615,No
UVCE,Artificial Intelligence and Data Science,KCET,2024,72449,79106,13721,24630,189906,165276,No
KLSGIT,Electronics and Communication Engineering,COMEDK,2024,191911,64162,16412,16837,289322,272485,No
VSM,Electrical and Electronics Engineering,COMEDK,2023,204758,84400,18676,29119,336953,307834,No
VSM,Electronics and Communication Engineering,COMEDK,2023,172241,62881,16043,23767,274932,251165,No
EastPoint,Civil Engineering,COMEDK,2023,195181,94886,8229,20174,318470,298296,No
VVCE,Electronics and Communication Engineering,COMEDK,2024,161794,89393,16840,20798,288825,268027,Yes
EastPoint,Artificial Intelligence and Data Science,KCET,2024,57090,65438,15804,10691,149023,138332,Yes
VVIT,Information Science and Engineering,KCET,2023,71634,60636,12374,22810,167454,144644,No
KSIT,Data Science,KCET,2023,74509,76454,17244,25585,193792,168207,Yes
VIT,Chemical Engineering,COMEDK,2024,232425,79572,8717,19037,339751,320714,No
SJBIT,Chemical Engineering,KCET,2023,56682,84429,13440,28594,183145,154551,Yes
VSM,Electrical and Electronics Engineering,KCET,2024,65991,94259,12644,12230,185124,172894,No
UVCE,Mechanical Engineering,KCET,2023,53486,84827,8645,11040,157998,146958,Yes
SIT,Robotics and Automation Engineering,KCET,2023,61467,72284,19807,23907,177465,153558,No
BMSCE,Artificial Intelligence and Data Science,KCET,2023,51328,78542,13225,25023,168118,143095,Yes
DSATM,Information Science and Engineering,KCET,2024,79758,61775,17140,22126,180799,158673,Yes
EastPoint,Aerospace Engineering,COMEDK,2023,228985,93607,14488,29689,366769,337080,No
UVCE,Artificial Intelligence and Data Science,KCET,2023,73624,69641,8760,13564,165589,152025,Yes
SJBIT,Data Science,COMEDK,2023,197666,92359,17695,28056,335776,307720,Yes
SIT,Biotechnology,KCET,2023,80906,74905,13082,28349,197242,168893,Yes
DrAIT,Civil Engineering,KCET,2024,51746,86922,10374,14630,163672,149042,No
AECMandya,Information Science and Engineering,COMEDK,2023,214385,76629,18804,16529,326347,309818,Yes
PRES,Data Science,COMEDK,2023,224139,63205,18246,19823,325413,305590,No
NMIT,Robotics and Automation Engineering,KCET,2024,69373,61766,10308,12279,153726,141447,Yes
REVA,Mechanical Engineering,COMEDK,2024,229502,85873,13630,19691,348696,329005,No
SJBCE,Robotics and Automation Engineering,KCET,2024,69479,72903,9266,21723,173371,151648,Yes
PESU,Electrical and Electronics Engineering,COMEDK,2023,240598,62635,10164,22239,335636,313397,Yes
JSSSTU,Electronics and Communication Engineering,COMEDK,2024,209657,80878,8265,15715,314515,298800,No
KSIT,Artificial Intelligence and Data Science,COMEDK,2023,164163,84576,12730,24450,285919,261469,No
SITM,Robotics and Automation Engineering,KCET,2024,61638,86940,9601,24457,182636,158179,Yes
BITM,Electronics and Communication Engineering,COMEDK,2023,231631,68587,15123,15743,331084,315341,No
RAIT,Data Science,KCET,2023,59823,61957,9181,29960,160921,130961,No
UVCE,Electronics and Communication Engineering,KCET,2024,84278,88095,16846,26238,215457,189219,No
SDMCET,Civil Engineering,KCET,2024,65016,88115,16779,27196,197106,169910,No
SJBIT,Artificial Intelligence and Data Science,COMEDK,2024,167132,72651,9185,23771,272739,248968,No
GIT,Information Science and Engineering,COMEDK,2024,208151,81415,8546,12177,310289,298112,No
AIT,Electronics and Communication Engineering,COMEDK,2024,163037,73799,12690,13204,262730,249526,Yes
GIT,Civil Engineering,KCET,2024,62556,66868,12877,17059,159360,142301,No
KSIT,Aerospace Engineering,COMEDK,2023,222808,66624,18427,21413,329272,307859,No
VIT,Computer Science and Engineering,COMEDK,2023,205795,78968,12275,15719,312757,297038,Yes
PESCE,Computer Science and Engineering,KCET,2024,62758,62005,9111,26653,160527,133874,No
PRES,Biotechnology,COMEDK,2024,210645,90370,18657,26537,346209,319672,No
EastPoint,Robotics and Automation Engineering,COMEDK,2023,218227,76089,12153,21596,328065,306469,Yes
PESCE,Electronics and Communication Engineering,COMEDK,2023,249209,86416,19049,10743,365417,354674,Yes
KLEIT,Mechanical Engineering,COMEDK,2023,160813,88058,9093,13040,271004,257964,Yes
SITM,Information Science and Engineering,KCET,2023,79116,94736,16799,19257,209908,190651,Yes
KLEIT,Electrical and Electronics Engineering,KCET,2023,83841,93033,17851,13402,208127,194725,Yes
PESCE,Robotics and Automation Engineering,KCET,2024,74248,60438,13003,25646,173335,147689,No
BMIT,Civil Engineering,COMEDK,2024,236681,74759,18388,19839,349667,329828,Yes
SITM,Civil Engineering,KCET,2023,53623,85560,15502,23623,178308,154685,Yes
RVCE,Biotechnology,COMEDK,2024,173571,84593,16498,17157,291819,274662,Yes
DrAIT,Artificial Intelligence and Data Science,COMEDK,2023,238801,77792,16815,25622,359030,333408,No
GIT,Artificial Intelligence and Data Science,COMEDK,2023,217883,70421,19341,15313,322958,307645,No
NHCE,Data Science,COMEDK,2024,200019,68170,10949,28962,308100,279138,No
NIE,Aerospace Engineering,COMEDK,2023,181473,80339,16874,13833,292519,278686,No
RAIT,Biotechnology,KCET,2023,78823,65091,18703,17335,179952,162617,Yes
PESU,Robotics and Automation Engineering,KCET,2024,82014,93765,19864,13038,208681,195643,Yes
BITM,Data Science,COMEDK,2023,197940,94919,12549,20238,325646,305408,Yes
AEC,Aerospace Engineering,KCET,2024,63578,93034,11113,13196,180921,167725,No
SJBIT,Robotics and Automation Engineering,COMEDK,2024,201881,93726,16084,25311,337002,311691,Yes
MSRUAS,Civil Engineering,KCET,2024,75266,75981,11196,29722,192165,162443,Yes
MSRUAS,Computer Science and Engineering,KCET,2024,63194,61159,16990,20595,161938,141343,Yes
JNNCE,Computer Science and Engineering,KCET,2023,83481,88785,17337,18715,208318,189603,Yes
JNNCE,Chemical Engineering,COMEDK,2023,202134,89928,13448,17127,322637,305510,Yes
NIE,Computer Science and Engineering,COMEDK,2024,228699,78059,18788,16205,341751,325546,No
AITM,Robotics and Automation Engineering,KCET,2023,62415,84830,17551,15705,180501,164796,Yes
JIT,Biotechnology,COMEDK,2024,203662,88257,19122,10242,321283,311041,Yes
AEC,Mechanical Engineering,KCET,2023,52916,85417,15825,21372,175530,154158,Yes
SCEM,Artificial Intelligence and Data Science,COMEDK,2023,239625,83219,14762,20418,358024,337606,No
KLSGIT,Artificial Intelligence and Data Science,COMEDK,2024,194084,73528,8173,29120,304905,275785,No
JIT,Mechanical Engineering,COMEDK,2023,246711,88192,18123,13846,366872,353026,Yes
KLEIT,Robotics and Automation Engineering,COMEDK,2024,172417,86736,10225,27462,296840,269378,Yes
RNSIT,Computer Science and Engineering,KCET,2023,79415,69629,8525,10349,167918,157569,Yes
GMIT,Artificial Intelligence and Data Science,COMEDK,2024,222513,70372,9961,21022,323868,302846,No
BNMIT,Data Science,KCET,2023,67432,77366,19150,11715,175663,163948,Yes
ACU,Civil Engineering,COMEDK,2023,178978,90804,10288,21235,301305,280070,Yes
RAIT,Electrical and Electronics Engineering,COMEDK,2024,197085,75035,17982,13443,303545,290102,No
VVIT,Robotics and Automation Engineering,KCET,2023,54224,72914,18186,20421,165745,145324,No
CITGubbi,Aerospace Engineering,KCET,2023,81212,60845,17127,11228,170412,159184,No
RVCE,Information Science and Engineering,KCET,2023,73831,82276,9532,21512,187151,165639,Yes
NIE,Data Science,COMEDK,2024,161477,83168,13715,29013,287373,258360,Yes
DSCE,Robotics and Automation Engineering,KCET,2023,52996,72651,13501,19670,158818,139148,Yes
YKCE,Robotics and Automation Engineering,COMEDK,2023,161904,74260,17954,26368,280486,254118,No
NCET,Electrical and Electronics Engineering,KCET,2024,52586,68145,12567,24353,157651,133298,No
JNNCE,Electronics and Communication Engineering,COMEDK,2023,192022,78008,12885,24364,307279,282915,Yes
JNNCE,Robotics and Automation Engineering,COMEDK,2024,245538,87113,11448,20877,364976,344099,No
EastPoint,Artificial Intelligence and Data Science,COMEDK,2024,234985,73845,14614,22361,345805,323444,No
SIT,Aerospace Engineering,KCET,2024,76724,92281,18123,28642,215770,187128,Yes
KSIT,Civil Engineering,COMEDK,2024,214372,60896,16918,21108,313294,292186,Yes
AIT,Electronics and Communication Engineering,KCET,2024,74672,66939,16962,27303,185876,158573,Yes
SDMIT,Data Science,KCET,2023,58223,87404,9016,17002,171645,154643,No
SJBIT,Chemical Engineering,COMEDK,2023,168510,78447,14615,15763,277335,261572,No
EastPoint,Mechanical Engineering,COMEDK,2024,228999,94167,8822,12876,344864,331988,Yes
BNMIT,Civil Engineering,KCET,2023,52519,91446,14419,29180,187564,158384,Yes
AECMandya,Chemical Engineering,KCET,2024,60871,82852,9012,12850,165585,152735,No
MSRIT,Mechanical Engineering,COMEDK,2024,249219,60269,18354,17207,345049,327842,No
RAIT,Robotics and Automation Engineering,KCET,2023,65403,76134,14281,20177,175995,155818,Yes
SITM,Civil Engineering,KCET,2023,81851,66122,10978,27988,186939,158951,Yes
SDMCET,Computer Science and Engineering,KCET,2024,65307,64673,16954,25197,172131,146934,Yes
PESU,Electrical and Electronics Engineering,COMEDK,2024,231741,77446,8887,21071,339145,318074,No
BIT,Chemical Engineering,COMEDK,2024,215506,75696,14575,15242,321019,305777,Yes
RVCE,Chemical Engineering,KCET,2023,58934,61181,12495,23957,156567,132610,No
VVIT,Artificial Intelligence and Data Science,COMEDK,2023,247851,79177,17322,20020,364370,344350,Yes
DSATM,Biotechnology,KCET,2024,51647,87210,11820,20572,171249,150677,No
JSSSTU,Electrical and Electronics Engineering,KCET,2024,65519,87486,17335,25278,195618,170340,No
NHCE,Biotechnology,KCET,2024,64412,91221,13057,25771,194461,168690,Yes
NMIT,Artificial Intelligence and Data Science,COMEDK,2023,190297,80982,14976,14380,300635,286255,Yes
REVA,Biotechnology,COMEDK,2023,183775,87140,11233,27178,309326,282148,No
DSATM,Electrical and Electronics Engineering,KCET,2024,83910,68905,10328,29920,193063,163143,No
SDMIT,Civil Engineering,KCET,2024,74446,70789,9039,16000,170274,154274,No
BNMIT,Electrical and Electronics Engineering,KCET,2024,83446,65102,10878,26592,186018,159426,No
VVIT,Mechanical Engineering,KCET,2023,63167,66895,11966,14975,157003,142028,Yes
DSCE,Chemical Engineering,KCET,2024,83606,85012,13924,18296,200838,182542,Yes
SIT,Biotechnology,COMEDK,2024,197773,89527,10632,15740,313672,297932,No
RNSIT,Mechanical Engineering,COMEDK,2023,223704,87179,11715,16745,339343,322598,No
VIT,Artificial Intelligence and Data Science,COMEDK,2023,235672,73440,15697,26495,351304,324809,No
JIT,Biotechnology,KCET,2024,81533,91595,18730,18566,210424,191858,No
AIT,Biotechnology,KCET,2024,67963,91828,12671,26737,199199,172462,Yes
SJBCE,Data Science,COMEDK,2023,230454,89146,13408,11421,344429,333008,Yes
ACU,Artificial Intelligence and Data Science,COMEDK,2024,231409,65192,17046,16154,329801,313647,No
MVJCE,Biotechnology,COMEDK,2023,160606,71537,19013,28051,279207,251156,Yes
SDMIT,Mechanical Engineering,COMEDK,2023,215564,76416,14233,19263,325476,306213,No
AIT,Aerospace Engineering,COMEDK,2023,220125,87726,9453,15537,332841,317304,No
NMIT,Biotechnology,COMEDK,2024,222611,79502,13435,16675,332223,315548,No
MVJCE,Electrical and Electronics Engineering,KCET,2023,78389,80890,19553,16293,195125,178832,No
GIT,Aerospace Engineering,KCET,2023,81976,84316,13567,18407,198266,179859,Yes
CMRIT,Biotechnology,KCET,2023,58180,71278,13857,16077,159392,143315,Yes
RVCE,Mechanical Engineering,COMEDK,2024,187008,64164,17040,27323,295535,268212,No
BIT,Civil Engineering,COMEDK,2024,208546,60721,16232,25525,311024,285499,No
YKCE,Electrical and Electronics Engineering,COMEDK,2023,241638,66151,15926,12070,335785,323715,No
JSSSTU,Robotics and Automation Engineering,COMEDK,2024,171642,94628,16914,17468,300652,283184,No
BNMIT,Robotics and Automation Engineering,COMEDK,2023,232537,60114,13147,19974,325772,305798,No
RAIT,Aerospace Engineering,COMEDK,2023,186886,61393,14967,16136,279382,263246,Yes
AITM,Civil Engineering,COMEDK,2023,227584,66287,8335,14761,316967,302206,No
SIT,Robotics and Automation Engineering,COMEDK,2024,205415,92391,13007,10408,321221,310813,Yes
SITM,Data Science,COMEDK,2023,183235,92425,12084,15229,302973,287744,Yes
VVIT,Biotechnology,COMEDK,2024,206214,61229,15211,17554,300208,282654,No
ACU,Chemical Engineering,COMEDK,2023,224972,73915,16299,22813,337999,315186,No
RAIT,Computer Science and Engineering,KCET,2024,63254,65576,9977,26768,165575,138807,Yes
REVA,Electrical and Electronics Engineering,COMEDK,2024,166238,65603,15432,11576,258849,247273,No
NMIT,Electronics and Communication Engineering,COMEDK,2023,226189,85763,8572,14389,334913,320524,No
RVUNIV,Computer Science and Engineering,KCET,2023,52785,85647,13098,26682,178212,151530,No
NHCE,Electrical and Electronics Engineering,KCET,2023,71394,75197,11345,12774,170710,157936,Yes
NMIT,Electrical and Electronics Engineering,KCET,2024,83814,91940,17829,23914,217497,193583,Yes
VVCE,Computer Science and Engineering,COMEDK,2023,164591,62197,19726,20330,266844,246514,No
HKBK,Computer Science and Engineering,COMEDK,2024,211827,70569,13655,23933,319984,296051,No
BIT,Robotics and Automation Engineering,COMEDK,2023,213033,68850,18189,28938,329010,300072,Yes
HKBK,Computer Science and Engineering,COMEDK,2024,215993,84601,9581,18055,328230,310175,Yes
VVIT,Data Science,COMEDK,2024,185506,94420,8602,16424,304952,288528,Yes
VemanaIT,Data Science,KCET,2024,71993,68847,15403,28592,184835,156243,Yes
JNNCE,Artificial Intelligence and Data Science,KCET,2023,74099,63407,12546,10843,160895,150052,No
GMIT,Computer Science and Engineering,COMEDK,2023,201782,72924,16029,27081,317816,290735,Yes
SJBIT,Electronics and Communication Engineering,KCET,2024,65191,86057,11062,26069,188379,162310,No
BITM,Biotechnology,COMEDK,2024,236527,69958,19746,13369,339600,326231,Yes
GIT,Artificial Intelligence and Data Science,KCET,2024,79262,64827,12473,25173,181735,156562,No
CMRIT,Aerospace Engineering,COMEDK,2023,187380,91000,18389,28161,324930,296769,Yes
CMRIT,Electronics and Communication Engineering,COMEDK,2024,202077,82139,12211,19703,316130,296427,No
DSATM,Mechanical Engineering,COMEDK,2024,207551,78166,17217,20908,323842,302934,Yes
YKCE,Data Science,COMEDK,2024,225357,88282,8130,26240,348009,321769,Yes
REVA,Artificial Intelligence and Data Science,KCET,2024,60975,84320,8918,18995,173208,154213,Yes
KSIT,Computer Science and Engineering,COMEDK,2023,234217,81564,16183,24960,356924,331964,No
DSCE,Computer Science and Engineering,COMEDK,2023,201199,61051,18454,16764,297468,280704,Yes
BMSCE,Chemical Engineering,KCET,2024,76114,94606,8135,13248,192103,178855,No
DBIT,Civil Engineering,COMEDK,2023,160622,64667,18834,17381,261504,244123,No
PESU,Electronics and Communication Engineering,COMEDK,2024,194411,83800,16365,17306,311882,294576,No
VVIT,Mechanical Engineering,COMEDK,2024,247349,76786,13699,12498,350332,337834,Yes
AIT,Data Science,KCET,2023,52731,85838,19676,27726,185971,158245,No
VIT,Data Science,COMEDK,2023,218589,64972,14505,26164,324230,298066,No
CITGubbi,Data Science,COMEDK,2023,221840,60732,13376,10997,306945,295948,No
SDMCET,Data Science,COMEDK,2023,186311,65597,18679,12341,282928,270587,No
SITM,Data Science,KCET,2024,61760,63641,10549,25990,161940,135950,No
SITM,Mechanical Engineering,KCET,2023,68404,74805,17157,25577,185943,160366,No
KSIT,Mechanical Engineering,KCET,2024,61643,79338,18778,11541,171300,159759,No
NIE,Information Science and Engineering,COMEDK,2024,202042,68947,9837,25415,306241,280826,No
NHCE,Biotechnology,COMEDK,2023,201237,80483,16567,23777,322064,298287,No
UVCE,Chemical Engineering,KCET,2023,50434,73024,13312,26154,162924,136770,No
VemanaIT,Electronics and Communication Engineering,COMEDK,2024,244058,81174,19464,22447,367143,344696,No
AEC,Mechanical Engineering,COMEDK,2023,198486,84374,15878,29502,328240,298738,Yes
DSCE,Chemical Engineering,KCET,2023,75354,84310,11968,19123,190755,171632,Yes
JSSSTU,Chemical Engineering,COMEDK,2023,180705,65866,12092,29431,288094,258663,No
RVUNIV,Artificial Intelligence and Data Science,COMEDK,2024,211062,74911,13084,12743,311800,299057,Yes
AITM,Electronics and Communication Engineering,COMEDK,2023,177179,61251,15336,22531,276297,253766,No
NHCE,Chemical Engineering,COMEDK,2023,163583,77468,10955,11992,263998,252006,No
BMIT,Computer Science and Engineering,KCET,2024,55609,67044,12232,14500,149385,134885,Yes
BITM,Electronics and Communication Engineering,COMEDK,2024,193162,71526,17099,25988,307775,281787,No
SIT,Electronics and Communication Engineering,KCET,2023,77454,89515,19550,25364,211883,186519,Yes
NCET,Data Science,KCET,2023,82486,82906,19862,14747,200001,185254,Yes
PESU,Artificial Intelligence and Data Science,COMEDK,2024,207527,84715,19311,11827,323380,311553,No
MVJCE,Aerospace Engineering,COMEDK,2024,243331,65197,12036,18143,338707,320564,Yes
SJBCE,Aerospace Engineering,COMEDK,2023,187713,85204,17246,28981,319144,290163,Yes
SIT,Aerospace Engineering,COMEDK,2023,210389,91568,17479,23817,343253,319436,No
VSM,Data Science,KCET,2024,60658,62996,16309,14113,154076,139963,Yes
SITM,Mechanical Engineering,COMEDK,2024,214389,84409,14806,12816,326420,313604,No
AECMandya,Data Science,KCET,2024,76790,83720,15817,20881,197208,176327,No
KLEIT,Civil Engineering,COMEDK,2024,161764,81506,9278,21756,274304,252548,No
BITM,Biotechnology,KCET,2023,57291,88904,19279,15954,181428,165474,Yes
NMIT,Electrical and Electronics Engineering,COMEDK,2024,167938,86486,11111,19306,284841,265535,Yes
SDMIT,Civil Engineering,KCET,2023,71298,79033,16948,12055,179334,167279,No
VVIT,Aerospace Engineering,COMEDK,2023,224177,88566,10225,10767,333735,322968,No
EastPoint,Biotechnology,COMEDK,2023,248381,63369,11427,10123,333300,323177,No
KSIT,Computer Science and Engineering,COMEDK,2023,194508,75959,15379,28835,314681,285846,Yes
AECMandya,Mechanical Engineering,COMEDK,2023,202729,94252,8694,12904,318579,305675,Yes
MSRUAS,Mechanical Engineering,KCET,2023,80675,65589,11148,11910,169322,157412,No
VVCE,Computer Science and Engineering,COMEDK,2023,193944,85672,12628,21685,313929,292244,No
AECMandya,Chemical Engineering,COMEDK,2024,177151,88978,16847,28466,311442,282976,Yes
UVCE,Biotechnology,COMEDK,2024,237279,85429,13903,18757,355368,336611,No
JIT,Aerospace Engineering,COMEDK,2023,196854,63138,8522,19449,287963,268514,No
CITGubbi,Data Science,COMEDK,2023,203027,80589,11008,29078,323702,294624,Yes
KLSGIT,Computer Science and Engineering,KCET,2024,71803,69431,15694,28367,185295,156928,Yes
BMSCE,Electronics and Communication Engineering,COMEDK,2023,217881,94790,14409,13262,340342,327080,No
RVCE,Civil Engineering,COMEDK,2023,228364,67657,8456,19824,324301,304477,Yes
AEC,Civil Engineering,COMEDK,2024,249434,75761,19515,22868,367578,344710,No
CITGubbi,Aerospace Engineering,KCET,2023,53201,61991,12555,23085,150832,127747,Yes
BMSCE,Electrical and Electronics Engineering,COMEDK,2023,183955,61290,13381,11585,270211,258626,Yes
RIT,Robotics and Automation Engineering,KCET,2024,67574,78041,18306,10183,174104,163921,Yes
VVIT,Information Science and Engineering,COMEDK,2024,231634,64096,18718,10505,324953,314448,No
REVA,Aerospace Engineering,KCET,2024,51359,89665,17581,24656,183261,158605,No
EastPoint,Electronics and Communication Engineering,KCET,2024,57699,90041,11935,26193,185868,159675,No
HKBK,Chemical Engineering,KCET,2023,63947,65104,9306,13071,151428,138357,No
PESU,Chemical Engineering,COMEDK,2024,238194,80694,19147,13576,351611,338035,No
CITGubbi,Electronics and Communication Engineering,KCET,2024,50921,90864,18950,22548,183283,160735,No
DSCE,Electrical and Electronics Engineering,COMEDK,2023,211560,90492,16268,27035,345355,318320,Yes
VemanaIT,Civil Engineering,COMEDK,2023,218217,64739,9867,15115,307938,292823,No
PRES,Information Science and Engineering,COMEDK,2023,230651,87448,13312,17566,348977,331411,Yes
MSRUAS,Computer Science and Engineering,KCET,2023,81189,87101,10230,20348,198868,178520,Yes
AEC,Data Science,KCET,2023,56244,63309,10305,24093,153951,129858,No
YKCE,Aerospace Engineering,KCET,2024,73788,91922,12788,26426,204924,178498,Yes
BIT,Data Science,KCET,2023,71396,72088,17475,27401,188360,160959,Yes
MVJCE,Electronics and Communication Engineering,KCET,2023,61986,73647,17274,19055,171962,152907,No
NIE,Electronics and Communication Engineering,KCET,2023,81689,72360,15138,27787,196974,169187,Yes
VSM,Electrical and Electronics Engineering,KCET,2024,75744,67661,18940,18494,180839,162345,No
AECMandya,Chemical Engineering,KCET,2024,55675,73427,10464,21785,161351,139566,No
AITM,Civil Engineering,KCET,2024,80797,69287,17015,21132,188231,167099,Yes
NMIT,Electronics and Communication Engineering,COMEDK,2024,188381,68171,15688,27547,299787,272240,No
RAIT,Data Science,COMEDK,2023,229648,75383,12303,10480,327814,317334,No
BIT,Data Science,KCET,2023,73953,79762,8186,12448,174349,161901,No
DrAIT,Computer Science and Engineering,COMEDK,2024,188505,72149,9072,19961,289687,269726,No
BNMIT,Civil Engineering,COMEDK,2023,172191,88032,10269,12672,283164,270492,Yes
SJBCE,Electronics and Communication Engineering,KCET,2023,60378,91957,12282,21056,185673,164617,Yes
MVJCE,Mechanical Engineering,KCET,2023,70561,88127,19570,10358,188616,178258,No
VVIT,Robotics and Automation Engineering,COMEDK,2024,190410,68338,14635,27245,300628,273383,No
RVUNIV,Electrical and Electronics Engineering,COMEDK,2024,240898,93518,17623,27835,379874,352039,No
MSRIT,Data Science,KCET,2024,59896,88387,18362,18021,184666,166645,Yes
VVCE,Artificial Intelligence and Data Science,KCET,2024,56498,72576,19330,22813,171217,148404,No
SCEM,Mechanical Engineering,COMEDK,2023,179731,71609,12649,11504,275493,263989,Yes
GIT,Aerospace Engineering,KCET,2023,58097,64452,12026,29138,163713,134575,Yes
RNSIT,Aerospace Engineering,COMEDK,2024,208571,63572,19285,21049,312477,291428,No
VSM,Electronics and Communication Engineering,KCET,2023,66421,75958,19516,27254,189149,161895,No
PRES,Data Science,KCET,2023,75836,88639,8143,28580,201198,172618,Yes
KLEIT,Artificial Intelligence and Data Science,KCET,2023,50821,65745,16983,27368,160917,133549,No
KLEIT,Artificial Intelligence and Data Science,KCET,2024,66895,60550,16176,22937,166558,143621,No
VVCE,Computer Science and Engineering,KCET,2023,73152,61580,19462,26609,180803,154194,No
NMIT,Chemical Engineering,KCET,2024,74607,68403,19846,14456,177312,162856,No
BMSIT,Computer Science and Engineering,KCET,2023,65252,71579,8846,23771,169448,145677,Yes
DSCE,Information Science and Engineering,COMEDK,2023,202076,78194,13609,27996,321875,293879,Yes
RVUNIV,Robotics and Automation Engineering,KCET,2023,56783,87405,12897,17511,174596,157085,Yes
MVJCE,Computer Science and Engineering,KCET,2024,76795,77302,16856,28239,199192,170953,Yes
GMIT,Aerospace Engineering,KCET,2024,65699,66024,14952,12309,158984,146675,Yes
SITM,Computer Science and Engineering,COMEDK,2023,189149,88705,11182,15512,304548,289036,No
AECMandya,Robotics and Automation Engineering,KCET,2024,79730,60872,12631,21716,174949,153233,Yes
SDMCET,Aerospace Engineering,COMEDK,2024,231490,62746,17378,20921,332535,311614,Yes
BMSIT,Civil Engineering,COMEDK,2023,208832,70230,10716,22693,312471,289778,Yes
AIT,Mechanical Engineering,KCET,2024,53464,76541,8537,14313,152855,138542,No
AECMandya,Artificial Intelligence and Data Science,COMEDK,2023,181811,65626,14001,11861,273299,261438,No
HKBK,Information Science and Engineering,KCET,2024,51699,79944,16026,24985,172654,147669,Yes
EastPoint,Civil Engineering,COMEDK,2024,191269,74861,11351,20767,298248,277481,Yes
REVA,Information Science and Engineering,KCET,2023,71247,77384,8254,29119,186004,156885,Yes
RVUNIV,Biotechnology,COMEDK,2023,227546,75683,18819,29113,351161,322048,No
SITM,Information Science and Engineering,COMEDK,2023,168030,79238,8064,14863,270195,255332,Yes
BMSCE,Artificial Intelligence and Data Science,COMEDK,2023,166317,70243,19922,13061,269543,256482,No
NIE,Aerospace Engineering,COMEDK,2024,192744,76835,18386,16442,304407,287965,Yes
CITGubbi,Electrical and Electronics Engineering,COMEDK,2024,216933,67539,10478,18882,313832,294950,Yes
SDMIT,Civil Engineering,KCET,2024,50477,85279,14457,26868,177081,150213,No
VVIT,Aerospace Engineering,KCET,2024,69327,65233,9006,28786,172352,143566,No
CITGubbi,Artificial Intelligence and Data Science,KCET,2024,65230,64705,15244,17471,162650,145179,Yes
BITM,Aerospace Engineering,COMEDK,2023,205440,80250,16816,17065,319571,302506,No
PRES,Chemical Engineering,KCET,2023,83380,88388,8897,24000,204665,180665,No
DSCE,Biotechnology,COMEDK,2023,215982,70462,16001,29835,332280,302445,Yes
SCEM,Robotics and Automation Engineering,COMEDK,2024,173485,75469,8494,16251,273699,257448,Yes
VIT,Chemical Engineering,COMEDK,2024,216606,88358,19929,22727,347620,324893,No
NHCE,Aerospace Engineering,COMEDK,2024,217983,81241,11065,10154,320443,310289,No
SITM,Civil Engineering,COMEDK,2024,179449,88607,19609,28162,315827,287665,No
DSCE,Electronics and Communication Engineering,KCET,2024,69639,78397,17717,19662,185415,165753,Yes
SDMCET,Civil Engineering,KCET,2023,76897,79251,13574,29540,199262,169722,Yes
NCET,Civil Engineering,COMEDK,2024,222276,93375,13470,26238,355359,329121,No
BIT,Mechanical Engineering,KCET,2024,52194,88897,16466,29088,186645,157557,No
RAIT,Artificial Intelligence and Data Science,COMEDK,2024,211192,79023,12350,12048,314613,302565,Yes
VSM,Data Science,KCET,2024,71102,79350,11526,24662,186640,161978,Yes
RAIT,Information Science and Engineering,COMEDK,2023,199220,83885,10397,15923,309425,293502,Yes
BITM,Electrical and Electronics Engineering,COMEDK,2023,231450,89701,16828,24245,362224,337979,Yes
DBIT,Biotechnology,COMEDK,2024,181610,80421,17460,14303,293794,279491,Yes
BIT,Chemical Engineering,COMEDK,2024,225293,67779,17624,11389,322085,310696,No
DSCE,Electronics and Communication Engineering,KCET,2024,52926,91418,10521,12560,167425,154865,No
AIT,Civil Engineering,COMEDK,2024,232587,67406,16428,27581,344002,316421,No
DrAIT,Electronics and Communication Engineering,KCET,2024,67398,67052,15085,13284,162819,149535,No
BITM,Information Science and Engineering,COMEDK,2024,170451,88999,8599,24092,292141,268049,No
SDMIT,Chemical Engineering,COMEDK,2023,225959,60783,13847,12128,312717,300589,No
SIT,Computer Science and Engineering,COMEDK,2023,207211,84470,18413,20149,330243,310094,No
SCEM,Robotics and Automation Engineering,KCET,2023,84709,86561,14046,10537,195853,185316,No
MSRUAS,Information Science and Engineering,KCET,2023,77117,72806,11857,23133,184913,161780,Yes
CITGubbi,Chemical Engineering,COMEDK,2024,215540,85040,15608,16924,333112,316188,No
SDMCET,Robotics and Automation Engineering,KCET,2023,56042,91168,8153,19775,175138,155363,No
DBIT,Biotechnology,COMEDK,2023,236440,79213,8525,12025,336203,324178,Yes
RVCE,Computer Science and Engineering,COMEDK,2023,197785,66585,11319,18479,294168,275689,Yes
RIT,Robotics and Automation Engineering,KCET,2023,67004,69785,8819,22176,167784,145608,Yes
GIT,Electronics and Communication Engineering,COMEDK,2024,197748,68885,17834,10836,295303,284467,No
SDMCET,Aerospace Engineering,COMEDK,2024,246811,82417,8537,11728,349493,337765,Yes
NIE,Data Science,KCET,2024,69391,91225,13919,11307,185842,174535,Yes
BMIT,Electronics and Communication Engineering,COMEDK,2024,187927,74146,17521,20705,300299,279594,Yes
BITM,Biotechnology,COMEDK,2024,207593,63617,19512,28268,318990,290722,Yes
UVCE,Data Science,COMEDK,2024,214013,84860,18411,17473,334757,317284,Yes
DSCE,Chemical Engineering,KCET,2024,57033,82889,16434,24822,181178,156356,Yes
HKBK,Computer Science and Engineering,COMEDK,2023,192884,75530,12209,24380,305003,280623,Yes
BMSCE,Electronics and Communication Engineering,COMEDK,2024,229072,89737,19363,15853,354025,338172,Yes
KLEIT,Electronics and Communication Engineering,COMEDK,2023,248808,90596,16353,20164,375921,355757,No
JSSSTU,Aerospace Engineering,COMEDK,2023,246245,67615,11950,15870,341680,325810,Yes
MSRUAS,Chemical Engineering,KCET,2023,56879,90490,19030,29567,195966,166399,Yes
CMRIT,Electrical and Electronics Engineering,COMEDK,2023,201196,64886,11819,15868,293769,277901,Yes
NIE,Electrical and Electronics Engineering,COMEDK,2024,215699,67333,8844,10500,302376,291876,Yes
KLEIT,Robotics and Automation Engineering,COMEDK,2023,229253,93569,18720,28339,369881,341542,No
UVCE,Information Science and Engineering,COMEDK,2023,184312,92856,11917,12687,301772,289085,No
VIT,Electronics and Communication Engineering,COMEDK,2024,219977,66223,10051,20870,317121,296251,Yes
BMIT,Computer Science and Engineering,KCET,2024,72583,89243,9377,28534,199737,171203,No
JNNCE,Mechanical Engineering,COMEDK,2024,245456,80394,8301,10163,344314,334151,No
NIE,Electrical and Electronics Engineering,COMEDK,2024,191461,85203,13154,28703,318521,289818,No
SITM,Electrical and Electronics Engineering,KCET,2024,54532,68242,9181,18223,150178,131955,Yes
BMIT,Civil Engineering,KCET,2024,50446,92174,12201,13511,168332,154821,Yes
NMIT,Chemical Engineering,KCET,2023,64988,89313,17006,15922,187229,171307,No
KLSGIT,Computer Science and Engineering,COMEDK,2023,168920,92755,17574,15552,294801,279249,Yes
AEC,Data Science,COMEDK,2023,244297,68233,10365,19410,342305,322895,No
NHCE,Information Science and Engineering,KCET,2023,56383,72413,8638,14117,151551,137434,No
SIT,Electronics and Communication Engineering,COMEDK,2023,190596,68907,19846,25749,305098,279349,Yes
AITM,Mechanical Engineering,KCET,2023,66703,71971,10414,10239,159327,149088,Yes
DSCE,Chemical Engineering,COMEDK,2023,226571,72896,16861,28224,344552,316328,No
EastPoint,Artificial Intelligence and Data Science,COMEDK,2023,234258,69696,19956,10441,334351,323910,Yes
BIT,Electrical and Electronics Engineering,COMEDK,2024,203350,93224,13895,10112,320581,310469,No
SJBIT,Aerospace Engineering,KCET,2024,76371,79331,14810,18695,189207,170512,No
BITM,Aerospace Engineering,KCET,2024,78918,65724,14080,27055,185777,158722,No
BITM,Data Science,KCET,2024,56841,85698,8548,11166,162253,151087,Yes
DBIT,Data Science,COMEDK,2023,213974,70750,10151,27227,322102,294875,No
CMRIT,Artificial Intelligence and Data Science,KCET,2023,80528,85749,12747,25118,204142,179024,No
BNMIT,Chemical Engineering,COMEDK,2023,173036,67413,10969,22802,274220,251418,Yes
AECMandya,Civil Engineering,COMEDK,2023,233569,73188,18359,17071,342187,325116,No
REVA,Electronics and Communication Engineering,KCET,2024,62024,78122,16635,15917,172698,156781,Yes
AECMandya,Data Science,KCET,2023,69610,87153,18819,24200,199782,175582,No
PRES,Computer Science and Engineering,KCET,2023,84008,81260,19078,27478,211824,184346,Yes
KLSGIT,Electronics and Communication Engineering,KCET,2024,68741,84610,18387,14219,185957,171738,No
HKBK,Electrical and Electronics Engineering,KCET,2024,51840,85285,17099,23234,177458,154224,Yes
BIT,Civil Engineering,KCET,2023,57785,70037,11660,28469,167951,139482,No
KLEIT,Chemical Engineering,COMEDK,2023,224956,66847,11969,22333,326105,303772,Yes
VIT,Aerospace Engineering,COMEDK,2024,191290,73041,9581,10832,284744,273912,No
ACU,Biotechnology,KCET,2024,70095,61032,12345,27975,171447,143472,Yes
NMIT,Chemical Engineering,KCET,2023,65066,77601,9903,26180,178750,152570,No
SDMCET,Electronics and Communication Engineering,KCET,2024,80019,76866,17207,16274,190366,174092,Yes
KLSGIT,Data Science,COMEDK,2023,229647,91336,16874,21077,358934,337857,Yes
RAIT,Biotechnology,KCET,2023,53530,64581,9649,25998,153758,127760,No
EastPoint,Information Science and Engineering,KCET,2023,80363,94850,11264,11027,197504,186477,No
BMSCE,Mechanical Engineering,COMEDK,2023,167174,72555,14697,26310,280736,254426,No
UVCE,Biotechnology,KCET,2023,84880,66919,16672,14237,182708,168471,Yes
JNNCE,Aerospace Engineering,KCET,2024,50605,89825,17225,26352,184007,157655,No
YKCE,Aerospace Engineering,COMEDK,2023,174570,76316,12405,10340,273631,263291,Yes
VVIT,Robotics and Automation Engineering,KCET,2023,64692,72810,16141,13516,167159,153643,No
AITM,Electronics and Communication Engineering,COMEDK,2023,199548,70917,16508,24861,311834,286973,Yes
EastPoint,Mechanical Engineering,COMEDK,2024,219822,66849,14862,24270,325803,301533,No
AIT,Robotics and Automation Engineering,COMEDK,2023,238768,61654,16603,29011,346036,317025,No
VVIT,Chemical Engineering,COMEDK,2024,180679,91416,13845,18005,303945,285940,Yes
SCEM,Artificial Intelligence and Data Science,KCET,2024,61047,90946,10317,20046,182356,162310,Yes
REVA,Electronics and Communication Engineering,COMEDK,2023,179780,71698,18800,26892,297170,270278,Yes
SJBCE,Biotechnology,KCET,2024,80617,93245,13359,19924,207145,187221,Yes
VIT,Biotechnology,KCET,2023,70664,68379,14415,15159,168617,153458,Yes
GMIT,Chemical Engineering,COMEDK,2023,204882,82935,14599,25195,327611,302416,No
BIT,Mechanical Engineering,COMEDK,2023,205038,83836,12034,27989,328897,300908,Yes
MVJCE,Data Science,KCET,2024,73083,91466,10546,11854,186949,175095,No
RVCE,Data Science,KCET,2024,60362,89662,8344,19829,178197,158368,Yes
JIT,Chemical Engineering,COMEDK,2023,208528,71495,10622,18179,308824,290645,No
NMIT,Civil Engineering,KCET,2023,64997,86134,18654,21461,191246,169785,Yes
MSRUAS,Artificial Intelligence and Data Science,COMEDK,2023,207828,92094,17173,10224,327319,317095,Yes
DSATM,Civil Engineering,KCET,2024,55165,93093,11967,27938,188163,160225,Yes
ACU,Mechanical Engineering,COMEDK,2023,161686,84766,8922,16969,272343,255374,Yes
SIT,Mechanical Engineering,COMEDK,2023,231952,64567,19574,12890,328983,316093,Yes
GIT,Artificial Intelligence and Data Science,COMEDK,2023,183855,65685,10613,28649,288802,260153,No
SDMIT,Information Science and Engineering,COMEDK,2024,244339,85605,8826,24509,363279,338770,No
BMSCE,Information Science and Engineering,COMEDK,2024,164901,83993,15362,26474,290730,264256,No
NMIT,Electronics and Communication Engineering,KCET,2023,54641,90329,12095,20365,177430,157065,Yes
DSCE,Electronics and Communication Engineering,COMEDK,2024,215667,71674,13436,16609,317386,300777,Yes
KSIT,Chemical Engineering,COMEDK,2024,185490,77194,17509,15719,295912,280193,No
BIT,Information Science and Engineering,COMEDK,2023,220963,70419,17490,12987,321859,308872,Yes
RAIT,Mechanical Engineering,COMEDK,2023,183227,94096,8988,21739,308050,286311,Yes
AEC,Aerospace Engineering,COMEDK,2024,223015,70282,9599,22430,325326,302896,Yes
YKCE,Robotics and Automation Engineering,COMEDK,2023,186866,86843,19272,24570,317551,292981,Yes
RAIT,Mechanical Engineering,KCET,2023,66504,90866,15927,23706,197003,173297,No
DSCE,Civil Engineering,KCET,2024,51791,63522,13627,19686,148626,128940,Yes
PESCE,Aerospace Engineering,COMEDK,2024,185228,94579,17509,10894,308210,297316,Yes
VemanaIT,Data Science,COMEDK,2024,247857,92709,11367,12933,364866,351933,No
CMRIT,Electrical and Electronics Engineering,KCET,2024,63016,89413,17339,10881,180649,169768,No
AITM,Chemical Engineering,COMEDK,2023,173846,85950,11787,13055,284638,271583,No
DSATM,Information Science and Engineering,COMEDK,2023,238158,72132,13048,11039,334377,323338,Yes
HKBK,Information Science and Engineering,COMEDK,2024,200656,78866,12338,20184,312044,291860,Yes
RAIT,Data Science,KCET,2023,57084,94422,14159,18037,183702,165665,Yes
SDMCET,Robotics and Automation Engineering,COMEDK,2023,233017,81045,11516,25723,351301,325578,Yes
JSSSTU,Biotechnology,KCET,2023,67535,65011,17995,26422,176963,150541,Yes
VSM,Chemical Engineering,KCET,2024,83903,77128,11763,26274,199068,172794,No
AEC,Computer Science and Engineering,KCET,2024,77787,78423,10349,21282,187841,166559,Yes
REVA,Computer Science and Engineering,COMEDK,2024,203619,72204,15887,12660,304370,291710,No
NIE,Artificial Intelligence and Data Science,KCET,2024,61081,64489,15289,11442,152301,140859,Yes
VVIT,Civil Engineering,KCET,2023,60967,74439,12932,28725,177063,148338,Yes
RVUNIV,Data Science,COMEDK,2023,168080,91970,17175,24969,302194,277225,Yes
JNNCE,Information Science and Engineering,KCET,2023,72936,69892,9012,29258,181098,151840,Yes
RVUNIV,Computer Science and Engineering,KCET,2023,71807,93704,14784,14812,195107,180295,Yes
NIE,Civil Engineering,COMEDK,2024,209476,68059,10738,16578,304851,288273,No
BITM,Artificial Intelligence and Data Science,COMEDK,2023,236891,73495,17553,22538,350477,327939,Yes
BITM,Electronics and Communication Engineering,COMEDK,2024,218183,63765,15368,21505,318821,297316,No
JIT,Computer Science and Engineering,COMEDK,2024,238789,73225,16040,15654,343708,328054,Yes
EastPoint,Data Science,KCET,2024,66858,87099,14787,10217,178961,168744,No
RIT,Aerospace Engineering,KCET,2023,77618,67813,15591,24661,185683,161022,No
JNNCE,Electrical and Electronics Engineering,COMEDK,2024,234076,82593,11467,27925,356061,328136,No
RNSIT,Artificial Intelligence and Data Science,COMEDK,2023,248261,68275,18315,26708,361559,334851,Yes
SITM,Electrical and Electronics Engineering,COMEDK,2024,168820,80131,13091,12228,274270,262042,No
SCEM,Data Science,COMEDK,2024,187961,90654,9634,28498,316747,288249,No
ACU,Data Science,KCET,2023,51830,73124,8238,29545,162737,133192,Yes
NHCE,Biotechnology,KCET,2023,77235,74299,17658,24740,193932,169192,Yes
HKBK,Robotics and Automation Engineering,KCET,2024,55862,87179,11848,21260,176149,154889,No
BMIT,Chemical Engineering,COMEDK,2023,176419,68266,8664,22959,276308,253349,Yes
PESU,Data Science,KCET,2023,64368,68608,19720,27437,180133,152696,Yes
MSRUAS,Mechanical Engineering,COMEDK,2023,195976,79308,16186,28248,319718,291470,No
EastPoint,Artificial Intelligence and Data Science,KCET,2024,72752,91885,10708,12127,187472,175345,Yes
DSATM,Electronics and Communication Engineering,COMEDK,2024,212853,72766,9035,23278,317932,294654,No
VSM,Mechanical Engineering,KCET,2024,68092,68181,18397,19772,174442,154670,No
PRES,Data Science,COMEDK,2023,193828,65505,10620,14627,284580,269953,No
JSSSTU,Robotics and Automation Engineering,KCET,2023,69897,74173,8304,13762,166136,152374,Yes
RVCE,Biotechnology,COMEDK,2023,182919,70757,19140,27612,300428,272816,No
HKBK,Civil Engineering,KCET,2024,71416,84774,15618,29822,201630,171808,Yes
HKBK,Robotics and Automation Engineering,COMEDK,2023,223022,75363,8136,14572,321093,306521,Yes
GMIT,Data Science,KCET,2023,75466,68983,17491,10112,172052,161940,Yes
MSRIT,Chemical Engineering,COMEDK,2024,169526,89854,17803,10821,288004,277183,No
AITM,Electrical and Electronics Engineering,COMEDK,2023,179589,86963,11129,13820,291501,277681,Yes
MSRUAS,Computer Science and Engineering,KCET,2023,73063,89348,11182,25162,198755,173593,No
AITM,Chemical Engineering,KCET,2023,65647,84024,10151,25514,185336,159822,Yes
BIT,Electrical and Electronics Engineering,KCET,2023,81722,92114,14627,18878,207341,188463,Yes
EastPoint,Computer Science and Engineering,KCET,2023,58773,77940,14528,18713,169954,151241,Yes
KSIT,Aerospace Engineering,KCET,2024,54595,89480,17582,16281,177938,161657,No
PRES,Computer Science and Engineering,COMEDK,2023,162594,92002,11613,18970,285179,266209,Yes
VemanaIT,Data Science,KCET,2024,74872,78164,13106,11664,177806,166142,No
BIT,Aerospace Engineering,KCET,2023,75646,75036,13074,26386,190142,163756,No
VemanaIT,Data Science,COMEDK,2024,245886,65533,19907,20812,352138,331326,Yes
DBIT,Biotechnology,COMEDK,2024,224195,76734,11582,21004,333515,312511,No
REVA,Electrical and Electronics Engineering,KCET,2024,53639,86768,18670,28822,187899,159077,Yes
MSRUAS,Electrical and Electronics Engineering,COMEDK,2024,162014,94257,14945,21972,293188,271216,Yes
REVA,Information Science and Engineering,COMEDK,2023,210986,62358,10601,23213,307158,283945,No
PESU,Computer Science and Engineering,COMEDK,2024,244909,80331,8607,19701,353548,333847,No
AECMandya,Biotechnology,KCET,2024,59049,94142,19241,27915,200347,172432,No
VIT,Data Science,KCET,2023,80185,72545,10241,17091,180062,162971,Yes
PESU,Biotechnology,KCET,2024,73629,75976,14375,28695,192675,163980,No
BMIT,Data Science,KCET,2023,69764,91325,8394,15313,184796,169483,No
JIT,Computer Science and Engineering,KCET,2023,62985,82452,11014,17485,173936,156451,Yes
REVA,Biotechnology,KCET,2023,80774,85959,17924,12148,196805,184657,No
VVCE,Biotechnology,KCET,2023,53149,82893,18115,22667,176824,154157,No
DSATM,Electronics and Communication Engineering,KCET,2023,69347,86989,10761,13657,180754,167097,No
KLSGIT,Mechanical Engineering,KCET,2023,78817,85555,13167,25275,202814,177539,No
UVCE,Computer Science and Engineering,COMEDK,2024,241808,89869,17421,25211,374309,349098,No
PESCE,Robotics and Automation Engineering,COMEDK,2023,231390,88683,8986,28300,357359,329059,No
RNSIT,Chemical Engineering,KCET,2024,65697,94103,11154,26744,197698,170954,Yes
SIT,Data Science,KCET,2023,78863,91693,17980,12704,201240,188536,No
GMIT,Information Science and Engineering,KCET,2023,73984,69817,9957,17265,171023,153758,Yes
BMIT,Aerospace Engineering,KCET,2023,78434,60756,19205,12672,171067,158395,Yes
AIT,Civil Engineering,KCET,2023,56776,79520,11841,22932,171069,148137,Yes
DrAIT,Electrical and Electronics Engineering,COMEDK,2024,163163,78867,11611,12171,265812,253641,No
GIT,Information Science and Engineering,COMEDK,2024,236504,62768,17155,27832,344259,316427,Yes
BMSIT,Electronics and Communication Engineering,COMEDK,2023,166242,63810,8062,15321,253435,238114,Yes
NCET,Chemical Engineering,KCET,2024,63112,90620,8182,27465,189379,161914,Yes
JIT,Artificial Intelligence and Data Science,COMEDK,2023,246145,75869,19572,19579,361165,341586,Yes
VVCE,Electrical and Electronics Engineering,KCET,2023,61700,68736,9138,22741,162315,139574,Yes
BMIT,Electronics and Communication Engineering,KCET,2023,55833,79482,9155,26934,171404,144470,Yes
SITM,Biotechnology,KCET,2024,53441,65037,11429,29185,159092,129907,Yes
NHCE,Chemical Engineering,KCET,2023,59830,93033,18359,20805,192027,171222,Yes
KLEIT,Aerospace Engineering,KCET,2024,60145,67446,9568,18843,156002,137159,No
SJBIT,Robotics and Automation Engineering,KCET,2024,51702,75403,10618,15640,153363,137723,Yes
NMIT,Aerospace Engineering,KCET,2024,77521,68024,16113,29377,191035,161658,Yes
AECMandya,Electrical and Electronics Engineering,COMEDK,2023,231075,94756,15893,13675,355399,341724,Yes
DrAIT,Civil Engineering,KCET,2024,84939,60987,12264,12691,170881,158190,Yes
RIT,Aerospace Engineering,COMEDK,2023,228549,78683,17433,13239,337904,324665,No
MVJCE,Electrical and Electronics Engineering,COMEDK,2023,186529,60402,19004,28310,294245,265935,No
PESU,Information Science and Engineering,KCET,2024,67583,66373,10121,14176,158253,144077,No
BIT,Chemical Engineering,COMEDK,2024,174784,84647,19466,18031,296928,278897,No
RVCE,Data Science,KCET,2024,66179,67747,12267,20388,166581,146193,No
DrAIT,Computer Science and Engineering,KCET,2024,74663,60344,18407,27196,180610,153414,Yes
NCET,Civil Engineering,COMEDK,2023,168404,65760,17798,23078,275040,251962,No
PRES,Electronics and Communication Engineering,KCET,2024,75083,85458,16574,26725,203840,177115,Yes
MSRIT,Data Science,COMEDK,2024,170039,87235,10723,22569,290566,267997,No
KSIT,Robotics and Automation Engineering,COMEDK,2024,216339,63771,16305,14234,310649,296415,Yes
UVCE,Information Science and Engineering,COMEDK,2023,191466,71340,9816,27999,300621,272622,No
BIT,Mechanical Engineering,COMEDK,2023,229673,89756,12025,11599,343053,331454,Yes
VVIT,Information Science and Engineering,COMEDK,2024,184764,73344,10976,10807,279891,269084,No
VVIT,Electrical and Electronics Engineering,COMEDK,2023,245282,87310,11304,28259,372155,343896,Yes
NHCE,Chemical Engineering,KCET,2023,70403,64672,9290,21695,166060,144365,Yes
JIT,Data Science,KCET,2024,82577,63272,18653,19896,184398,164502,No
GIT,Data Science,COMEDK,2023,229697,86471,18606,21812,356586,334774,Yes
BMSCE,Mechanical Engineering,KCET,2024,67475,67871,10019,27065,172430,145365,Yes
VSM,Artificial Intelligence and Data Science,COMEDK,2024,197268,61981,19562,27048,305859,278811,No
BMIT,Biotechnology,KCET,2024,60177,60914,10418,11784,143293,131509,No
BMIT,Computer Science and Engineering,KCET,2023,57989,91468,17586,20044,187087,167043,Yes
VIT,Computer Science and Engineering,KCET,2023,66996,75968,10012,23637,176613,152976,No
RVUNIV,Chemical Engineering,KCET,2024,71580,94115,13852,27858,207405,179547,No
SITM,Information Science and Engineering,COMEDK,2024,185741,73713,16942,12302,288698,276396,No
SDMCET,Aerospace Engineering,KCET,2024,51735,94513,10693,20133,177074,156941,No
KSIT,Data Science,COMEDK,2024,199140,61217,8809,10512,279678,269166,No
UVCE,Computer Science and Engineering,COMEDK,2024,211903,65348,11545,11709,300505,288796,Yes
BMSCE,Electronics and Communication Engineering,COMEDK,2023,220987,93819,9708,21316,345830,324514,No
SJBIT,Chemical Engineering,KCET,2023,82727,63667,19140,24833,190367,165534,Yes
EastPoint,Biotechnology,KCET,2024,66998,89256,14427,24220,194901,170681,No
YKCE,Electronics and Communication Engineering,COMEDK,2024,164014,77341,8975,16220,266550,250330,Yes
MSRIT,Artificial Intelligence and Data Science,COMEDK,2024,168643,64318,13136,23447,269544,246097,Yes
BMSIT,Aerospace Engineering,KCET,2024,50850,62604,11149,26405,151008,124603,Yes
SJBCE,Aerospace Engineering,KCET,2023,71458,91837,15765,19051,198111,179060,No
AECMandya,Information Science and Engineering,COMEDK,2023,222040,82515,11702,11276,327533,316257,No
NHCE,Electronics and Communication Engineering,KCET,2023,70442,65643,11211,25068,172364,147296,Yes
HKBK,Chemical Engineering,KCET,2023,54207,76312,17718,20929,169166,148237,No
DBIT,Electronics and Communication Engineering,KCET,2023,55940,64068,13751,21892,155651,133759,Yes
CMRIT,Aerospace Engineering,KCET,2023,73492,93405,18573,26271,211741,185470,No
GIT,Electrical and Electronics Engineering,COMEDK,2024,237922,69929,8543,14853,331247,316394,No
BMIT,Mechanical Engineering,COMEDK,2023,161271,82842,18928,20218,283259,263041,Yes
ACU,Information Science and Engineering,KCET,2023,57625,92440,13849,17001,180915,163914,Yes
AECMandya,Chemical Engineering,COMEDK,2024,201921,76398,15984,24819,319122,294303,No
PESU,Data Science,KCET,2023,64283,61340,18471,10017,154111,144094,No
MSRIT,Electrical and Electronics Engineering,KCET,2023,69685,89539,8980,10460,178664,168204,No
UVCE,Electronics and Communication Engineering,KCET,2023,83939,83072,15072,25403,207486,182083,No
RAIT,Robotics and Automation Engineering,KCET,2024,77866,88362,18772,29881,214881,185000,Yes
AITM,Aerospace Engineering,KCET,2023,71497,79925,8580,27134,187136,160002,No
MSRUAS,Aerospace Engineering,COMEDK,2023,171246,87201,15589,17524,291560,274036,Yes
KSIT,Civil Engineering,COMEDK,2024,199622,70012,18852,27083,315569,288486,No
GMIT,Electrical and Electronics Engineering,KCET,2024,75135,80561,17296,26535,199527,172992,No
VSM,Robotics and Automation Engineering,KCET,2024,76349,73170,10371,23873,183763,159890,No
AECMandya,Electronics and Communication Engineering,KCET,2024,50809,75041,18968,18871,163689,144818,Yes
MVJCE,Robotics and Automation Engineering,KCET,2023,74543,74622,14547,11114,174826,163712,Yes
BITM,Information Science and Engineering,COMEDK,2024,190680,62297,9178,11065,273220,262155,Yes
AITM,Artificial Intelligence and Data Science,COMEDK,2023,227514,84555,17499,29861,359429,329568,No
PESCE,Biotechnology,COMEDK,2023,239433,70275,16901,17065,343674,326609,Yes
NIE,Information Science and Engineering,COMEDK,2023,186064,60659,14097,12078,272898,260820,No
VemanaIT,Computer Science and Engineering,COMEDK,2024,181664,94572,9973,16014,302223,286209,No
PRES,Aerospace Engineering,KCET,2024,80100,71773,16484,14459,182816,168357,Yes
SDMIT,Computer Science and Engineering,KCET,2024,51017,78012,17269,29398,175696,146298,Yes
RAIT,Information Science and Engineering,KCET,2023,79262,60651,19374,12965,172252,159287,Yes
VemanaIT,Computer Science and Engineering,COMEDK,2023,170302,88195,11863,25471,295831,270360,Yes
RNSIT,Data Science,COMEDK,2024,228688,73597,10896,23188,336369,313181,Yes
DBIT,Computer Science and Engineering,KCET,2023,52569,69432,8077,21468,151546,130078,No
RVCE,Information Science and Engineering,KCET,2023,74081,60406,9098,13357,156942,143585,Yes
KSIT,Electrical and Electronics Engineering,KCET,2024,83761,63070,14280,14126,175237,161111,Yes
VIT,Aerospace Engineering,COMEDK,2024,227730,75028,10518,17605,330881,313276,No
BITM,Mechanical Engineering,COMEDK,2023,219654,75557,9536,16491,321238,304747,Yes
VSM,Data Science,KCET,2024,81864,84611,8091,14578,189144,174566,Yes
JNNCE,Mechanical Engineering,COMEDK,2024,209768,62782,15157,21288,308995,287707,No
VVCE,Data Science,KCET,2023,59981,65483,18088,15201,158753,143552,Yes
KSIT,Biotechnology,COMEDK,2024,206397,68606,11657,25965,312625,286660,No
BITM,Artificial Intelligence and Data Science,KCET,2023,78231,80055,11174,10310,179770,169460,Yes
DBIT,Data Science,KCET,2024,64329,69083,14388,23208,171008,147800,Yes
YKCE,Electronics and Communication Engineering,KCET,2023,57410,61786,16640,12334,148170,135836,Yes
SIT,Civil Engineering,COMEDK,2024,185840,86404,16393,20781,309418,288637,Yes
RAIT,Biotechnology,KCET,2023,63807,70349,17080,24254,175490,151236,No
VIT,Information Science and Engineering,COMEDK,2024,196742,68808,10840,13147,289537,276390,Yes
AECMandya,Mechanical Engineering,COMEDK,2024,228645,80914,8465,12756,330780,318024,No
SDMIT,Biotechnology,KCET,2023,57163,87722,11219,16213,172317,156104,No
CMRIT,Aerospace Engineering,COMEDK,2024,236528,86841,16508,28656,368533,339877,No
VVIT,Chemical Engineering,KCET,2024,69767,85518,18353,14048,187686,173638,Yes
RAIT,Aerospace Engineering,KCET,2024,68779,81491,14770,17074,182114,165040,Yes
BITM,Chemical Engineering,KCET,2023,50534,65846,15134,19800,151314,131514,No
SJBIT,Information Science and Engineering,COMEDK,2023,235475,89661,16158,24020,365314,341294,Yes
SITM,Biotechnology,KCET,2024,79082,84948,13371,16404,193805,177401,No
KSIT,Information Science and Engineering,KCET,2023,54180,69733,8166,20660,152739,132079,Yes
MSRUAS,Biotechnology,COMEDK,2024,166826,88049,15413,26125,296413,270288,No
KSIT,Artificial Intelligence and Data Science,COMEDK,2024,179939,75946,14435,21620,291940,270320,No
GIT,Mechanical Engineering,KCET,2023,51198,70909,11849,24003,157959,133956,Yes
PESCE,Data Science,COMEDK,2023,176769,78393,10354,29883,295399,265516,Yes
CITGubbi,Civil Engineering,KCET,2024,57309,61572,14649,10912,144442,133530,Yes
VIT,Computer Science and Engineering,COMEDK,2023,203946,88523,9889,25252,327610,302358,Yes
GIT,Computer Science and Engineering,KCET,2024,63526,80715,16594,15403,176238,160835,Yes
EastPoint,Civil Engineering,KCET,2023,57800,86474,9428,22896,176598,153702,Yes
BNMIT,Electronics and Communication Engineering,KCET,2023,78982,92640,9319,20476,201417,180941,No
BIT,Robotics and Automation Engineering,COMEDK,2024,188568,90922,17656,29218,326364,297146,Yes
DrAIT,Artificial Intelligence and Data Science,KCET,2023,73080,64725,17690,13116,168611,155495,Yes
HKBK,Civil Engineering,COMEDK,2024,162935,91510,8474,10073,272992,262919,Yes
VSM,Aerospace Engineering,COMEDK,2023,168443,94845,15231,20528,299047,278519,No
VVIT,Biotechnology,KCET,2024,73896,90341,16871,24534,205642,181108,No
CMRIT,Electrical and Electronics Engineering,COMEDK,2024,232283,64223,9793,18932,325231,306299,Yes
BMSCE,Civil Engineering,COMEDK,2024,218959,65719,18805,23833,327316,303483,Yes
EastPoint,Information Science and Engineering,COMEDK,2023,216680,61879,10814,23711,313084,289373,No
BMIT,Computer Science and Engineering,KCET,2023,51217,65169,19792,16725,152903,136178,Yes
VSM,Mechanical Engineering,KCET,2024,68242,86807,19023,17560,191632,174072,No
KLSGIT,Artificial Intelligence and Data Science,COMEDK,2023,190581,61606,13374,25262,290823,265561,Yes
ACU,Computer Science and Engineering,KCET,2024,54284,93126,8608,22168,178186,156018,Yes
RVUNIV,Electrical and Electronics Engineering,COMEDK,2023,219627,70926,13528,13017,317098,304081,Yes
PRES,Biotechnology,KCET,2024,53718,76401,19736,17153,167008,149855,No
SITM,Computer Science and Engineering,COMEDK,2023,234106,72361,16472,25052,347991,322939,Yes
SJBCE,Mechanical Engineering,COMEDK,2024,198523,69031,19342,17370,304266,286896,No
BMSIT,Chemical Engineering,KCET,2023,50911,88555,9221,22032,170719,148687,Yes
SIT,Electronics and Communication Engineering,COMEDK,2024,171081,62784,11949,16772,262586,245814,Yes
RVCE,Civil Engineering,KCET,2024,84059,69446,8622,13283,175410,162127,No
SIT,Computer Science and Engineering,KCET,2024,51675,74224,18961,25668,170528,144860,Yes
VVCE,Electrical and Electronics Engineering,KCET,2024,65001,71887,19645,11128,167661,156533,No
PESU,Robotics and Automation Engineering,KCET,2024,73708,87102,10084,11540,182434,170894,Yes
NHCE,Robotics and Automation Engineering,COMEDK,2023,175330,72939,9573,16669,274511,257842,No
CITGubbi,Artificial Intelligence and Data Science,COMEDK,2023,212234,60407,16765,11122,300528,289406,Yes
KLSGIT,Artificial Intelligence and Data Science,KCET,2023,75260,81717,12344,26915,196236,169321,No
SDMCET,Information Science and Engineering,COMEDK,2023,204982,94218,19450,24198,342848,318650,No
EastPoint,Biotechnology,COMEDK,2024,177715,74146,18269,15748,285878,270130,Yes
REVA,Civil Engineering,KCET,2024,78159,75340,15669,12382,181550,169168,No
SITM,Data Science,KCET,2023,70589,70208,9486,24823,175106,150283,Yes
DSCE,Chemical Engineering,COMEDK,2023,240858,68441,16650,14526,340475,325949,Yes
KSIT,Electrical and Electronics Engineering,KCET,2024,66062,92971,15905,25884,200822,174938,Yes
SJBIT,Biotechnology,COMEDK,2023,192947,64270,8977,16849,283043,266194,No
BIT,Electronics and Communication Engineering,COMEDK,2024,206164,66285,11202,23472,307123,283651,No
ACU,Information Science and Engineering,COMEDK,2023,184012,87617,10540,20515,302684,282169,No
VIT,Robotics and Automation Engineering,COMEDK,2023,172205,78193,16450,12213,279061,266848,Yes
REVA,Information Science and Engineering,COMEDK,2023,176219,75801,8334,23372,283726,260354,Yes
AIT,Electrical and Electronics Engineering,KCET,2023,75102,71189,15141,23383,184815,161432,Yes
BMSCE,Biotechnology,COMEDK,2024,248709,83882,18141,21649,372381,350732,Yes
RVUNIV,Electronics and Communication Engineering,COMEDK,2024,212836,66238,16373,13891,309338,295447,Yes
RNSIT,Mechanical Engineering,COMEDK,2024,163998,82242,12269,23557,282066,258509,No
JNNCE,Information Science and Engineering,KCET,2024,68108,84721,14454,26368,193651,167283,No
DSCE,Electrical and Electronics Engineering,KCET,2023,60432,82407,14049,28007,184895,156888,Yes
SITM,Electrical and Electronics Engineering,KCET,2023,51687,70393,18942,12088,153110,141022,No
CITGubbi,Information Science and Engineering,KCET,2023,71521,68140,17466,28620,185747,157127,Yes
SDMCET,Information Science and Engineering,COMEDK,2023,208178,76143,19615,15104,319040,303936,No
REVA,Computer Science and Engineering,KCET,2023,51550,84476,8084,24291,168401,144110,Yes
SJBIT,Artificial Intelligence and Data Science,COMEDK,2023,183287,88146,15439,12397,299269,286872,Yes
DSATM,Artificial Intelligence and Data Science,KCET,2024,64200,74095,14497,14834,167626,152792,No
DSATM,Chemical Engineering,KCET,2023,71155,82201,8465,14775,176596,161821,No
BMSCE,Artificial Intelligence and Data Science,KCET,2024,80497,88688,9213,29940,208338,178398,Yes
VVCE,Information Science and Engineering,COMEDK,2024,178982,81826,8272,11509,280589,269080,Yes
GMIT,Computer Science and Engineering,COMEDK,2023,223641,65761,13792,21262,324456,303194,Yes
KSIT,Electronics and Communication Engineering,COMEDK,2023,248364,75564,9690,18723,352341,333618,No
NCET,Biotechnology,COMEDK,2024,180266,74626,12135,29040,296067,267027,Yes
SJBCE,Mechanical Engineering,COMEDK,2023,184315,74613,10713,18205,287846,269641,No
NMIT,Electrical and Electronics Engineering,COMEDK,2023,236842,64154,9210,19736,329942,310206,No
EastPoint,Robotics and Automation Engineering,COMEDK,2024,173219,75618,18102,10933,277872,266939,No
RVUNIV,Mechanical Engineering,KCET,2023,82169,76074,10493,22759,191495,168736,No
DBIT,Electronics and Communication Engineering,KCET,2023,52073,89568,12075,14526,168242,153716,Yes
DrAIT,Aerospace Engineering,KCET,2023,65247,70375,12756,21802,170180,148378,No
SDMCET,Computer Science and Engineering,KCET,2023,69905,62225,9949,20519,162598,142079,Yes
VemanaIT,Artificial Intelligence and Data Science,COMEDK,2024,207932,76816,19455,16395,320598,304203,Yes
BIT,Robotics and Automation Engineering,COMEDK,2023,219501,64536,13247,12673,309957,297284,Yes
AECMandya,Information Science and Engineering,COMEDK,2023,173142,77405,11262,10460,272269,261809,No
RVCE,Artificial Intelligence and Data Science,COMEDK,2024,183600,70450,14038,10344,278432,268088,No
KSIT,Mechanical Engineering,COMEDK,2024,185415,66657,10374,10295,272741,262446,No
JIT,Biotechnology,COMEDK,2024,238190,63807,8169,29400,339566,310166,Yes
BMSIT,Aerospace Engineering,COMEDK,2023,163225,92984,12733,12524,281466,268942,No
DSCE,Robotics and Automation Engineering,KCET,2024,69279,84623,19714,20803,194419,173616,No
RVUNIV,Computer Science and Engineering,KCET,2024,54835,63746,8680,29795,157056,127261,Yes
RIT,Biotechnology,KCET,2023,72263,93555,17325,17485,200628,183143,No
RAIT,Civil Engineering,KCET,2024,63240,93311,8653,24417,189621,165204,No
VVIT,Data Science,KCET,2023,73574,60466,11989,13995,160024,146029,No
SJBCE,Data Science,COMEDK,2023,184668,78677,15133,23024,301502,278478,No
GIT,Biotechnology,COMEDK,2023,220864,89491,10673,27685,348713,321028,Yes
RIT,Artificial Intelligence and Data Science,KCET,2024,77475,70110,13007,28875,189467,160592,Yes
UVCE,Robotics and Automation Engineering,COMEDK,2023,225597,73353,14917,28507,342374,313867,Yes
VVCE,Civil Engineering,COMEDK,2024,184230,81391,15115,21567,302303,280736,No
VemanaIT,Chemical Engineering,KCET,2023,72470,69392,10644,24113,176619,152506,No
SDMCET,Electrical and Electronics Engineering,KCET,2023,74842,67488,15037,22614,179981,157367,Yes
VSM,Data Science,COMEDK,2024,166636,74652,15486,23744,280518,256774,Yes
SCEM,Data Science,COMEDK,2024,189242,73645,19416,16675,298978,282303,No
MVJCE,Computer Science and Engineering,COMEDK,2023,199342,76715,18051,24932,319040,294108,Yes
CMRIT,Biotechnology,KCET,2023,56745,93250,12272,26492,188759,162267,No
VIT,Electronics and Communication Engineering,KCET,2024,70362,76851,12289,10140,169642,159502,No
JIT,Computer Science and Engineering,KCET,2024,84528,73316,18461,17542,193847,176305,No
AITM,Aerospace Engineering,KCET,2024,60774,94009,17256,10316,182355,172039,No
SDMCET,Mechanical Engineering,COMEDK,2023,193034,83532,19440,23853,319859,296006,No
EastPoint,Data Science,COMEDK,2023,231894,67571,17547,21843,338855,317012,Yes
EastPoint,Electrical and Electronics Engineering,COMEDK,2024,217123,83824,18480,16365,335792,319427,No
UVCE,Chemical Engineering,COMEDK,2024,201059,94540,14713,16394,326706,310312,Yes
GMIT,Mechanical Engineering,COMEDK,2023,185144,76281,16195,16195,293815,277620,Yes
SJBCE,Aerospace Engineering,KCET,2023,78814,74604,17997,16006,187421,171415,Yes
AEC,Information Science and Engineering,KCET,2024,67087,72695,13164,24192,177138,152946,No
AECMandya,Robotics and Automation Engineering,KCET,2024,63386,85960,12069,28031,189446,161415,Yes
NMIT,Electrical and Electronics Engineering,COMEDK,2024,183965,67007,12339,11306,274617,263311,No
RVUNIV,Aerospace Engineering,COMEDK,2024,207021,61820,14949,22872,306662,283790,No
NIE,Biotechnology,KCET,2023,81027,71712,8095,12355,173189,160834,No
VSM,Civil Engineering,COMEDK,2023,245421,93116,19026,18663,376226,357563,Yes
SJBCE,Aerospace Engineering,KCET,2024,61611,73333,16170,25865,176979,151114,Yes
GMIT,Robotics and Automation Engineering,KCET,2024,78156,80087,12786,28628,199657,171029,No
MSRIT,Computer Science and Engineering,COMEDK,2024,201794,84684,16404,27677,330559,302882,Yes
AECMandya,Civil Engineering,COMEDK,2023,161030,79678,8527,28631,277866,249235,No
RIT,Computer Science and Engineering,KCET,2023,75719,91150,16505,18468,201842,183374,No
VSM,Civil Engineering,COMEDK,2024,165055,92519,12349,28273,298196,269923,Yes
BMIT,Computer Science and Engineering,COMEDK,2024,241579,75980,19219,16928,353706,336778,No
JSSSTU,Mechanical Engineering,COMEDK,2023,189261,64953,10021,25110,289345,264235,Yes
EastPoint,Electronics and Communication Engineering,KCET,2023,58373,92682,14353,27468,192876,165408,Yes
JIT,Electronics and Communication Engineering,COMEDK,2023,195584,75227,15456,16009,302276,286267,No
HKBK,Aerospace Engineering,KCET,2024,71237,69177,15193,26598,182205,155607,No
JNNCE,Robotics and Automation Engineering,KCET,2024,67536,82149,16679,10942,177306,166364,No
CITGubbi,Electrical and Electronics Engineering,COMEDK,2024,234161,89556,13758,14293,351768,337475,Yes
RVCE,Chemical Engineering,KCET,2023,54253,60848,15036,13914,144051,130137,Yes
JNNCE,Robotics and Automation Engineering,COMEDK,2024,169945,84699,17653,28787,301084,272297,Yes
JIT,Information Science and Engineering,KCET,2024,80205,83672,14623,18176,196676,178500,Yes
VVCE,Artificial Intelligence and Data Science,KCET,2023,51931,67286,11028,23800,154045,130245,Yes
VSM,Artificial Intelligence and Data Science,KCET,2023,67485,68210,19900,25028,180623,155595,No
AITM,Robotics and Automation Engineering,COMEDK,2024,186297,75839,9904,17143,289183,272040,No
BMIT,Electronics and Communication Engineering,COMEDK,2024,243157,79354,17606,24160,364277,340117,Yes
NMIT,Civil Engineering,KCET,2023,55760,89156,19319,22364,186599,164235,Yes
KSIT,Electronics and Communication Engineering,COMEDK,2024,224400,91900,19658,29360,365318,335958,No
KSIT,Robotics and Automation Engineering,KCET,2023,75058,82177,19342,13945,190522,176577,No
RVUNIV,Robotics and Automation Engineering,COMEDK,2023,206131,60984,9542,19293,295950,276657,No
VIT,Data Science,COMEDK,2023,163364,90651,11596,13034,278645,265611,Yes
KLSGIT,Computer Science and Engineering,KCET,2023,60852,69186,10423,12880,153341,140461,No
NHCE,Aerospace Engineering,COMEDK,2024,203742,61757,12994,29030,307523,278493,Yes
AEC,Electrical and Electronics Engineering,COMEDK,2023,228867,69526,10920,22576,331889,309313,No
CITGubbi,Chemical Engineering,COMEDK,2023,243795,82698,19161,12938,358592,345654,No
UVCE,Electrical and Electronics Engineering,KCET,2024,80608,62465,16757,13818,173648,159830,No
DBIT,Chemical Engineering,COMEDK,2023,177437,62375,14175,23925,277912,253987,Yes
DSCE,Electronics and Communication Engineering,COMEDK,2024,199404,76723,12556,29575,318258,288683,Yes
BITM,Chemical Engineering,KCET,2023,55282,62809,10253,25696,154040,128344,Yes
SJBIT,Civil Engineering,KCET,2024,53255,60230,18997,21569,154051,132482,No
BMSIT,Information Science and Engineering,KCET,2023,68309,72256,10354,25887,176806,150919,No
MSRIT,Electrical and Electronics Engineering,KCET,2024,81147,89936,9644,23160,203887,180727,Yes
NHCE,Artificial Intelligence and Data Science,KCET,2023,59580,79591,19336,11346,169853,158507,Yes
MSRUAS,Data Science,KCET,2023,80152,62504,19269,14944,176869,161925,No
BMIT,Computer Science and Engineering,COMEDK,2023,181997,63613,13238,10659,269507,258848,Yes
DrAIT,Biotechnology,KCET,2023,71015,84330,15446,27403,198194,170791,Yes
PESCE,Electronics and Communication Engineering,KCET,2023,53235,61201,13123,24246,151805,127559,Yes
CMRIT,Chemical Engineering,COMEDK,2024,237891,90721,17757,11984,358353,346369,Yes
ACU,Electronics and Communication Engineering,COMEDK,2023,179691,89753,9625,12679,291748,279069,No
YKCE,Robotics and Automation Engineering,KCET,2023,82550,63740,14544,16058,176892,160834,Yes
MVJCE,Chemical Engineering,COMEDK,2024,170753,80765,8093,12368,271979,259611,Yes
DSATM,Artificial Intelligence and Data Science,COMEDK,2023,219159,84127,17583,23678,344547,320869,No
GMIT,Biotechnology,KCET,2024,76804,67431,16995,15491,176721,161230,No
SDMCET,Biotechnology,KCET,2024,60400,60927,8182,12810,142319,129509,Yes
RIT,Aerospace Engineering,KCET,2024,77460,79719,13239,14198,184616,170418,Yes
CMRIT,Robotics and Automation Engineering,KCET,2024,80341,82326,14605,12721,189993,177272,No
MVJCE,Computer Science and Engineering,COMEDK,2024,183668,67830,13441,12098,277037,264939,Yes
NCET,Artificial Intelligence and Data Science,KCET,2023,58226,62641,11903,28437,161207,132770,Yes
NHCE,Robotics and Automation Engineering,COMEDK,2023,168870,74722,16717,11001,271310,260309,Yes
MSRIT,Mechanical Engineering,COMEDK,2024,176926,87695,15944,13269,293834,280565,Yes
MSRIT,Information Science and Engineering,KCET,2023,71002,74771,14567,26327,186667,160340,Yes
CMRIT,Aerospace Engineering,COMEDK,2024,164749,82891,14721,14087,276448,262361,Yes
JIT,Electronics and Communication Engineering,KCET,2024,55606,77984,10023,24195,167808,143613,No
NIE,Information Science and Engineering,KCET,2023,50844,73375,13993,16708,154920,138212,Yes
KSIT,Electrical and Electronics Engineering,COMEDK,2024,231634,69496,17003,29694,347827,318133,Yes
RIT,Robotics and Automation Engineering,KCET,2023,62174,65017,15297,14218,156706,142488,No
VVCE,Computer Science and Engineering,KCET,2024,50513,68719,19192,26281,164705,138424,Yes
BNMIT,Mechanical Engineering,COMEDK,2024,238790,85816,14908,19962,359476,339514,No
BIT,Biotechnology,COMEDK,2023,218887,75182,10302,16072,320443,304371,Yes
RVCE,Chemical Engineering,COMEDK,2023,245676,73862,19934,14751,354223,339472,No
RVCE,Aerospace Engineering,COMEDK,2023,178689,83472,18681,14034,294876,280842,No
RIT,Biotechnology,KCET,2023,72489,72269,12612,10348,167718,157370,No
EastPoint,Chemical Engineering,COMEDK,2024,186877,73484,8870,23064,292295,269231,Yes
MSRUAS,Information Science and Engineering,COMEDK,2024,164720,71034,17877,14711,268342,253631,No
SIT,Robotics and Automation Engineering,COMEDK,2023,242696,74242,16627,26002,359567,333565,Yes
JNNCE,Computer Science and Engineering,COMEDK,2024,183712,83402,19780,10319,297213,286894,No
NHCE,Electronics and Communication Engineering,KCET,2024,76055,86272,10499,23433,196259,172826,No
SDMIT,Electronics and Communication Engineering,COMEDK,2024,169444,66992,12034,27696,276166,248470,No
PESCE,Information Science and Engineering,COMEDK,2024,226883,91074,11475,10140,339572,329432,Yes
KLEIT,Chemical Engineering,KCET,2024,57422,80311,14683,25000,177416,152416,No
RVUNIV,Computer Science and Engineering,COMEDK,2024,169117,62046,15584,25413,272160,246747,No
RNSIT,Computer Science and Engineering,COMEDK,2023,184592,76845,17133,21259,299829,278570,No
REVA,Information Science and Engineering,COMEDK,2023,213615,87669,16147,27859,345290,317431,Yes
MSRUAS,Mechanical Engineering,KCET,2023,75315,83477,10515,22014,191321,169307,No
VVCE,Electrical and Electronics Engineering,COMEDK,2023,239362,79637,9197,16295,344491,328196,No
EastPoint,Civil Engineering,COMEDK,2023,183643,90392,14207,21656,309898,288242,Yes
NCET,Information Science and Engineering,KCET,2023,62407,78139,8770,17934,167250,149316,No
KSIT,Information Science and Engineering,COMEDK,2024,168743,78297,12010,10577,269627,259050,No
PESCE,Robotics and Automation Engineering,KCET,2023,75181,77258,17713,10163,180315,170152,No
BMSCE,Biotechnology,COMEDK,2024,210000,92603,15959,23300,341862,318562,No
MVJCE,Aerospace Engineering,COMEDK,2024,194569,67461,16533,19658,298221,278563,Yes
RNSIT,Computer Science and Engineering,COMEDK,2024,243561,77977,14166,12217,347921,335704,No
RVCE,Computer Science and Engineering,COMEDK,2024,213590,75739,14648,12535,316512,303977,No
SITM,Information Science and Engineering,KCET,2024,52860,73756,17002,29984,173602,143618,No
SDMCET,Electrical and Electronics Engineering,COMEDK,2024,172709,77950,17448,13936,282043,268107,Yes
VSM,Aerospace Engineering,COMEDK,2024,227642,70997,11657,22273,332569,310296,No
VVIT,Data Science,COMEDK,2023,233723,74127,10093,23230,341173,317943,No
DrAIT,Information Science and Engineering,COMEDK,2023,202686,61572,13480,24045,301783,277738,Yes
PRES,Electrical and Electronics Engineering,COMEDK,2023,239655,86281,16459,29707,372102,342395,No
MVJCE,Civil Engineering,COMEDK,2023,225328,72188,19830,14631,331977,317346,No
VVCE,Civil Engineering,KCET,2023,56940,87644,16393,24481,185458,160977,Yes
GMIT,Data Science,COMEDK,2023,216752,62749,19589,17241,316331,299090,Yes
SDMIT,Computer Science and Engineering,KCET,2023,80510,65584,9414,15385,170893,155508,No
KLEIT,Aerospace Engineering,COMEDK,2023,168355,87505,14350,14828,285038,270210,No
SJBCE,Chemical Engineering,COMEDK,2024,201331,69818,11188,23054,305391,282337,No
UVCE,Civil Engineering,KCET,2024,82793,94178,17655,12304,206930,194626,Yes
SJBIT,Electronics and Communication Engineering,KCET,2023,76175,82122,14844,26967,200108,173141,No
AECMandya,Information Science and Engineering,COMEDK,2024,213615,62215,10894,11003,297727,286724,No
BMIT,Mechanical Engineering,COMEDK,2024,220359,68854,10399,10109,309721,299612,Yes
NMIT,Robotics and Automation Engineering,COMEDK,2023,231773,60331,19897,23579,335580,312001,No
DSATM,Mechanical Engineering,COMEDK,2024,175233,66791,11643,21916,275583,253667,Yes
AITM,Electronics and Communication Engineering,KCET,2024,69648,78761,11862,28804,189075,160271,No
EastPoint,Electrical and Electronics Engineering,KCET,2024,62981,73340,13994,25411,175726,150315,Yes
EastPoint,Civil Engineering,KCET,2023,56027,69447,9709,12943,148126,135183,Yes
CMRIT,Chemical Engineering,KCET,2024,73281,87877,17426,23498,202082,178584,Yes
NMIT,Civil Engineering,COMEDK,2024,207022,83226,14118,16829,321195,304366,No
EastPoint,Chemical Engineering,KCET,2024,71359,82919,9441,14807,178526,163719,No
VVCE,Data Science,COMEDK,2024,181587,73358,13992,29225,298162,268937,Yes
SCEM,Computer Science and Engineering,KCET,2023,66462,64637,18916,28631,178646,150015,Yes
AIT,Electronics and Communication Engineering,KCET,2023,63704,73032,11671,20216,168623,148407,Yes
MSRIT,Data Science,KCET,2024,58690,66289,19884,24704,169567,144863,No
KLSGIT,Electrical and Electronics Engineering,KCET,2024,52311,66708,14939,22932,156890,133958,Yes
BIT,Computer Science and Engineering,KCET,2024,57328,80790,15218,29932,183268,153336,Yes
RIT,Information Science and Engineering,COMEDK,2024,224183,85362,10435,14480,334460,319980,No
SDMCET,Biotechnology,COMEDK,2024,204124,91567,11689,10406,317786,307380,Yes
DSATM,Computer Science and Engineering,COMEDK,2023,185855,66629,15743,25181,293408,268227,Yes
AECMandya,Electronics and Communication Engineering,COMEDK,2024,207845,82714,17547,21618,329724,308106,Yes
AECMandya,Artificial Intelligence and Data Science,KCET,2024,62291,62251,14716,24547,163805,139258,Yes
MVJCE,Computer Science and Engineering,KCET,2023,53820,74170,11294,23434,162718,139284,Yes
BMIT,Biotechnology,COMEDK,2024,231375,90702,10242,17960,350279,332319,Yes
MSRUAS,Artificial Intelligence and Data Science,COMEDK,2024,166386,66960,8534,20007,261887,241880,Yes
YKCE,Artificial Intelligence and Data Science,KCET,2023,55194,73618,9575,13799,152186,138387,No
DrAIT,Data Science,KCET,2023,72277,69494,9069,16391,167231,150840,No
KSIT,Mechanical Engineering,COMEDK,2023,180862,92453,12437,27014,312766,285752,No
UVCE,Chemical Engineering,COMEDK,2024,242579,89878,14168,27851,374476,346625,Yes
MSRIT,Information Science and Engineering,COMEDK,2023,208223,61753,11164,21727,302867,281140,Yes
REVA,Electronics and Communication Engineering,COMEDK,2023,167885,87604,8741,28924,293154,264230,Yes
PESCE,Robotics and Automation Engineering,KCET,2024,64189,69780,14423,29928,178320,148392,No
RNSIT,Information Science and Engineering,COMEDK,2024,220320,82619,17232,28944,349115,320171,No
RNSIT,Mechanical Engineering,COMEDK,2023,239659,62493,17768,21600,341520,319920,Yes
AEC,Biotechnology,COMEDK,2024,160574,90997,18737,24397,294705,270308,Yes
SCEM,Mechanical Engineering,KCET,2024,67861,72778,10566,16465,167670,151205,Yes
NMIT,Computer Science and Engineering,COMEDK,2023,227918,80533,14663,25733,348847,323114,No
BITM,Electronics and Communication Engineering,COMEDK,2023,208263,83644,10892,26032,328831,302799,Yes
SCEM,Biotechnology,COMEDK,2024,186508,71872,16952,22860,298192,275332,Yes
RVCE,Mechanical Engineering,KCET,2024,53375,74873,14732,17411,160391,142980,Yes
CMRIT,Electrical and Electronics Engineering,KCET,2024,78294,61292,9272,16090,164948,148858,No
JSSSTU,Aerospace Engineering,KCET,2024,59971,72553,8007,26171,166702,140531,No
UVCE,Mechanical Engineering,KCET,2024,57770,84617,9257,29742,181386,151644,Yes
JNNCE,Aerospace Engineering,KCET,2023,72897,63257,13981,22043,172178,150135,Yes
NHCE,Data Science,KCET,2023,57933,72673,8648,29682,168936,139254,No
HKBK,Chemical Engineering,COMEDK,2024,175123,93901,9525,15342,293891,278549,Yes
RAIT,Civil Engineering,KCET,2024,66913,92997,13981,29294,203185,173891,No
UVCE,Electrical and Electronics Engineering,KCET,2024,67502,74953,13091,24954,180500,155546,No
EastPoint,Artificial Intelligence and Data Science,KCET,2024,69226,79363,15611,22423,186623,164200,No
REVA,Computer Science and Engineering,KCET,2023,64873,91617,13160,23229,192879,169650,No
VVIT,Electrical and Electronics Engineering,KCET,2023,80284,92449,11482,17097,201312,184215,Yes
SITM,Electronics and Communication Engineering,KCET,2024,81691,92408,13878,14691,202668,187977,No
SDMCET,Robotics and Automation Engineering,COMEDK,2023,245374,71973,19199,18617,355163,336546,Yes
KLEIT,Electrical and Electronics Engineering,COMEDK,2023,225361,68890,10476,15055,319782,304727,Yes
CMRIT,Biotechnology,KCET,2024,60223,60332,14021,28812,163388,134576,No
RVUNIV,Civil Engineering,COMEDK,2024,204231,64301,16694,29981,315207,285226,Yes
AIT,Information Science and Engineering,KCET,2024,77048,81908,9473,12435,180864,168429,No
BMSCE,Chemical Engineering,KCET,2023,67333,83304,16011,17266,183914,166648,Yes
VSM,Civil Engineering,KCET,2024,63771,71388,9317,18260,162736,144476,Yes
DrAIT,Chemical Engineering,COMEDK,2023,223344,82058,14071,13707,333180,319473,No
JSSSTU,Biotechnology,COMEDK,2023,216030,80837,11986,16434,325287,308853,Yes
MSRIT,Computer Science and Engineering,KCET,2024,82164,76607,16562,20867,196200,175333,No
VVCE,Computer Science and Engineering,KCET,2024,76719,82787,11727,14621,185854,171233,Yes
EastPoint,Chemical Engineering,COMEDK,2024,178333,92217,19585,17204,307339,290135,Yes
GIT,Mechanical Engineering,COMEDK,2024,248007,83353,12789,21007,365156,344149,Yes
SJBIT,Artificial Intelligence and Data Science,KCET,2024,52755,60756,9214,27798,150523,122725,No
RVUNIV,Aerospace Engineering,KCET,2023,53373,71519,9968,25393,160253,134860,Yes
JIT,Chemical Engineering,COMEDK,2023,220302,93137,11184,25227,349850,324623,No
VSM,Computer Science and Engineering,KCET,2023,58726,84101,18261,25509,186597,161088,No
DBIT,Robotics and Automation Engineering,KCET,2023,50384,88012,10534,25901,174831,148930,Yes
VVIT,Chemical Engineering,COMEDK,2024,244949,80596,19667,19754,364966,345212,No
DSATM,Robotics and Automation Engineering,KCET,2023,72704,82010,19021,14543,188278,173735,No
AEC,Data Science,COMEDK,2023,247654,61831,10258,17223,336966,319743,No
BIT,Data Science,COMEDK,2023,233188,85827,17116,29311,365442,336131,No
AITM,Computer Science and Engineering,KCET,2024,63381,65544,15519,15866,160310,144444,Yes
RNSIT,Information Science and Engineering,KCET,2023,71424,82963,13987,17943,186317,168374,No
BIT,Information Science and Engineering,KCET,2024,82538,90498,12045,18908,203989,185081,Yes
NHCE,Data Science,COMEDK,2023,201479,71292,15956,11360,300087,288727,No
SITM,Information Science and Engineering,KCET,2023,65647,72584,17725,14934,170890,155956,Yes
HKBK,Information Science and Engineering,COMEDK,2024,245670,83965,14257,21575,365467,343892,Yes
MVJCE,Electronics and Communication Engineering,KCET,2024,64843,66746,17477,27647,176713,149066,No
BNMIT,Robotics and Automation Engineering,KCET,2023,51633,90738,18971,10727,172069,161342,No
PESCE,Aerospace Engineering,KCET,2023,82800,84914,12393,11389,191496,180107,No
RVUNIV,Robotics and Automation Engineering,KCET,2024,68297,72276,10567,21874,173014,151140,No
JIT,Computer Science and Engineering,KCET,2024,52119,90282,8988,22039,173428,151389,No
VSM,Electronics and Communication Engineering,KCET,2023,73102,63945,14496,28171,179714,151543,Yes
SITM,Civil Engineering,KCET,2024,80081,75183,14871,16659,186794,170135,No
BITM,Aerospace Engineering,COMEDK,2023,192960,82825,10415,11818,298018,286200,Yes
VIT,Computer Science and Engineering,COMEDK,2023,199273,72215,15217,28288,314993,286705,No
KLSGIT,Mechanical Engineering,COMEDK,2024,226420,71306,10954,26296,334976,308680,No
HKBK,Civil Engineering,COMEDK,2023,237841,88837,14729,11223,352630,341407,No
PRES,Mechanical Engineering,COMEDK,2024,204688,70220,18427,23863,317198,293335,No
PESU,Computer Science and Engineering,COMEDK,2024,183828,62922,11630,12374,270754,258380,No
GIT,Artificial Intelligence and Data Science,COMEDK,2024,240030,63197,16412,21071,340710,319639,No
VemanaIT,Electronics and Communication Engineering,KCET,2023,62408,79847,10446,10872,163573,152701,Yes
CITGubbi,Mechanical Engineering,COMEDK,2023,208329,63512,12505,12457,296803,284346,Yes
SCEM,Mechanical Engineering,KCET,2024,81273,85849,18063,19345,204530,185185,Yes
EastPoint,Artificial Intelligence and Data Science,COMEDK,2023,170569,67785,13364,15673,267391,251718,Yes
DBIT,Electrical and Electronics Engineering,COMEDK,2024,195048,91996,9226,22811,319081,296270,Yes
RAIT,Artificial Intelligence and Data Science,KCET,2024,72935,70413,18859,24433,186640,162207,Yes
DSCE,Computer Science and Engineering,COMEDK,2023,221495,82820,16715,20120,341150,321030,Yes
KLEIT,Chemical Engineering,KCET,2024,57813,78967,14603,12348,163731,151383,No
EastPoint,Electrical and Electronics Engineering,COMEDK,2023,200768,73289,17165,23380,314602,291222,Yes
SIT,Electronics and Communication Engineering,COMEDK,2024,193987,91518,17717,17451,320673,303222,Yes
EastPoint,Information Science and Engineering,COMEDK,2024,187256,86187,15510,13982,302935,288953,Yes
PESCE,Artificial Intelligence and Data Science,COMEDK,2024,218022,91915,16164,13401,339502,326101,Yes
SJBCE,Mechanical Engineering,KCET,2023,67138,84636,17119,21086,189979,168893,No
KLSGIT,Robotics and Automation Engineering,KCET,2024,60502,73925,8184,12838,155449,142611,No
MSRIT,Computer Science and Engineering,KCET,2024,74983,67983,19890,15797,178653,162856,Yes
RVCE,Data Science,KCET,2023,59464,78330,16170,16610,170574,153964,No
GIT,Civil Engineering,KCET,2023,81477,74760,9621,14339,180197,165858,No
GMIT,Information Science and Engineering,KCET,2024,61286,76912,19512,17074,174784,157710,Yes
BIT,Chemical Engineering,COMEDK,2023,225575,64051,14023,18724,322373,303649,Yes
SCEM,Data Science,KCET,2024,67551,89784,16281,23205,196821,173616,Yes
JNNCE,Civil Engineering,COMEDK,2024,201176,92968,11234,29123,334501,305378,No
DSCE,Information Science and Engineering,KCET,2024,81967,94388,15112,18323,209790,191467,Yes
MSRIT,Electronics and Communication Engineering,COMEDK,2024,162967,91524,19072,21111,294674,273563,No
AEC,Mechanical Engineering,KCET,2024,76415,82183,15491,20047,194136,174089,No
VemanaIT,Data Science,KCET,2023,76580,62959,17300,24633,181472,156839,No
BIT,Aerospace Engineering,COMEDK,2023,235126,75850,14907,25789,351672,325883,Yes
RVCE,Artificial Intelligence and Data Science,COMEDK,2023,188176,73308,13556,27707,302747,275040,No
MSRUAS,Mechanical Engineering,COMEDK,2023,175414,87628,18218,19673,300933,281260,No
VemanaIT,Electronics and Communication Engineering,KCET,2024,70409,68160,16310,21298,176177,154879,Yes
CITGubbi,Electronics and Communication Engineering,KCET,2024,70478,66035,10152,24015,170680,146665,No
HKBK,Electronics and Communication Engineering,COMEDK,2024,186535,87388,13085,23025,310033,287008,Yes
REVA,Mechanical Engineering,KCET,2024,83158,82338,12279,16146,193921,177775,No
SJBCE,Civil Engineering,COMEDK,2024,182106,80911,15460,26464,304941,278477,Yes
PESU,Chemical Engineering,COMEDK,2024,209174,70383,17505,18074,315136,297062,No
VVCE,Aerospace Engineering,KCET,2023,53117,87717,15563,23049,179446,156397,Yes
BITM,Artificial Intelligence and Data Science,COMEDK,2024,214995,81477,17488,29744,343704,313960,Yes
RAIT,Mechanical Engineering,COMEDK,2024,186246,77669,13227,22041,299183,277142,Yes
AIT,Robotics and Automation Engineering,COMEDK,2023,194761,77618,13366,27584,313329,285745,No
AIT,Aerospace Engineering,KCET,2023,54009,67329,11902,19262,152502,133240,Yes
BNMIT,Aerospace Engineering,COMEDK,2024,198890,62200,10281,11561,282932,271371,No
AIT,Information Science and Engineering,COMEDK,2024,166974,62879,8540,21702,260095,238393,No
JIT,Artificial Intelligence and Data Science,COMEDK,2024,196042,93964,16513,16846,323365,306519,Yes
RIT,Mechanical Engineering,KCET,2023,73664,73204,12988,13464,173320,159856,No
GMIT,Aerospace Engineering,KCET,2024,76287,60072,18883,13509,168751,155242,No
YKCE,Data Science,COMEDK,2024,229533,74638,16085,26155,346411,320256,No
NIE,Robotics and Automation Engineering,KCET,2023,84036,83906,13455,14118,195515,181397,No
VSM,Data Science,KCET,2023,69345,63321,11191,28612,172469,143857,No
DBIT,Civil Engineering,COMEDK,2023,229918,91312,18638,21115,360983,339868,Yes
RAIT,Civil Engineering,KCET,2023,75436,87206,15410,21742,199794,178052,No
SJBIT,Aerospace Engineering,COMEDK,2023,245645,93650,17280,15155,371730,356575,Yes
NIE,Artificial Intelligence and Data Science,COMEDK,2024,248118,93708,9265,17190,368281,351091,No
SDMIT,Electronics and Communication Engineering,KCET,2024,78719,62746,19161,16318,176944,160626,No
KSIT,Robotics and Automation Engineering,COMEDK,2024,246763,88361,10169,22818,368111,345293,No
SDMCET,Electronics and Communication Engineering,KCET,2023,54633,66286,16827,10762,148508,137746,No
NCET,Aerospace Engineering,COMEDK,2024,182209,92134,12637,14434,301414,286980,Yes
KLEIT,Electrical and Electronics Engineering,KCET,2023,62776,63372,14073,13479,153700,140221,Yes
BMIT,Mechanical Engineering,COMEDK,2024,240610,66120,12728,22546,342004,319458,Yes
HKBK,Civil Engineering,KCET,2024,50140,61316,17611,19096,148163,129067,No
GIT,Robotics and Automation Engineering,COMEDK,2024,238154,61851,18819,23395,342219,318824,Yes
VemanaIT,Information Science and Engineering,KCET,2024,54457,87333,17630,23532,182952,159420,No
MSRUAS,Civil Engineering,KCET,2024,73966,75664,19085,25977,194692,168715,No
NCET,Mechanical Engineering,COMEDK,2023,180752,75838,18045,22530,297165,274635,Yes
UVCE,Computer Science and Engineering,KCET,2024,51737,73866,18264,25811,169678,143867,Yes
VSM,Information Science and Engineering,COMEDK,2024,162235,67576,14221,13148,257180,244032,Yes
VVCE,Chemical Engineering,KCET,2023,58227,92402,14471,15882,180982,165100,Yes
SIT,Computer Science and Engineering,COMEDK,2023,176407,92839,17093,27807,314146,286339,No
BIT,Biotechnology,KCET,2023,79013,76939,10711,12051,178714,166663,Yes
RNSIT,Civil Engineering,COMEDK,2023,245349,64931,11846,24897,347023,322126,Yes
NMIT,Biotechnology,KCET,2023,80930,73864,17113,17913,189820,171907,Yes
SIT,Artificial Intelligence and Data Science,KCET,2024,84297,83727,8316,19743,196083,176340,No
SDMCET,Electronics and Communication Engineering,KCET,2024,63552,66603,9239,18245,157639,139394,Yes
GMIT,Chemical Engineering,KCET,2024,59943,72857,8748,14095,155643,141548,Yes
SITM,Electrical and Electronics Engineering,KCET,2023,82373,89151,18697,12277,202498,190221,Yes
VIT,Data Science,COMEDK,2024,197823,63280,8675,13678,283456,269778,No
KLEIT,Electrical and Electronics Engineering,KCET,2024,54188,71946,19136,13105,158375,145270,Yes
RNSIT,Chemical Engineering,KCET,2024,53540,94769,16325,28504,193138,164634,Yes
KLSGIT,Electronics and Communication Engineering,COMEDK,2023,170573,62429,12199,19322,264523,245201,Yes
PRES,Artificial Intelligence and Data Science,KCET,2023,77364,81352,15323,16473,190512,174039,No
SJBCE,Mechanical Engineering,KCET,2023,52913,79844,12522,26429,171708,145279,Yes
NHCE,Computer Science and Engineering,COMEDK,2024,172442,62149,10305,23573,268469,244896,No
BITM,Robotics and Automation Engineering,KCET,2024,65450,63303,15342,17154,161249,144095,No
RNSIT,Data Science,COMEDK,2023,214324,64438,9119,23744,311625,287881,No
KLEIT,Artificial Intelligence and Data Science,COMEDK,2024,191565,81707,8031,18544,299847,281303,No
SDMIT,Robotics and Automation Engineering,COMEDK,2024,194542,78552,19723,17695,310512,292817,Yes
RAIT,Biotechnology,KCET,2024,51777,73339,8416,22801,156333,133532,Yes
AEC,Robotics and Automation Engineering,COMEDK,2023,203848,84575,15926,17983,322332,304349,Yes
BIT,Chemical Engineering,COMEDK,2023,231590,72149,19705,12205,335649,323444,No
SDMIT,Chemical Engineering,COMEDK,2024,200212,90066,12019,23124,325421,302297,Yes
PESU,Civil Engineering,COMEDK,2024,227679,60148,13417,26044,327288,301244,Yes
VVIT,Mechanical Engineering,KCET,2024,80100,71813,13738,13545,179196,165651,No
AITM,Aerospace Engineering,COMEDK,2024,175626,75073,15501,27406,293606,266200,No
VVIT,Electronics and Communication Engineering,KCET,2023,56889,81312,15155,15105,168461,153356,Yes
GMIT,Robotics and Automation Engineering,KCET,2023,77461,86029,13815,23751,201056,177305,Yes
VSM,Chemical Engineering,COMEDK,2024,227381,88374,10434,11877,338066,326189,No
DSCE,Artificial Intelligence and Data Science,COMEDK,2024,230739,70328,18850,20970,340887,319917,No
CITGubbi,Computer Science and Engineering,COMEDK,2023,227121,93709,9231,24860,354921,330061,Yes
RIT,Electronics and Communication Engineering,COMEDK,2023,215042,88188,13849,14434,331513,317079,Yes
NCET,Information Science and Engineering,COMEDK,2024,203451,73730,16417,16104,309702,293598,No
SIT,Robotics and Automation Engineering,COMEDK,2023,200913,78369,14301,16166,309749,293583,No
VIT,Civil Engineering,COMEDK,2024,196740,64929,16854,10092,288615,278523,No
UVCE,Data Science,COMEDK,2024,210493,66952,18900,29790,326135,296345,No
SDMIT,Computer Science and Engineering,KCET,2024,61671,88937,17226,25606,193440,167834,Yes
PESU,Computer Science and Engineering,KCET,2024,66989,76002,16229,17879,177099,159220,Yes
YKCE,Electronics and Communication Engineering,KCET,2023,54267,62955,12873,18257,148352,130095,Yes
AECMandya,Biotechnology,COMEDK,2023,179352,70857,10525,11755,272489,260734,No
RVUNIV,Data Science,KCET,2023,59078,61769,12130,14674,147651,132977,No
KLSGIT,Electrical and Electronics Engineering,KCET,2023,50853,80669,9512,26668,167702,141034,No
PESCE,Chemical Engineering,KCET,2024,62126,76863,17162,23027,179178,156151,Yes
HKBK,Computer Science and Engineering,KCET,2023,72199,81592,16155,17593,187539,169946,Yes
BMIT,Biotechnology,COMEDK,2023,215029,72557,15088,17910,320584,302674,No
DSCE,Computer Science and Engineering,COMEDK,2024,171410,68553,12311,26065,278339,252274,No
RIT,Robotics and Automation Engineering,COMEDK,2023,184752,76114,18698,24589,304153,279564,Yes
MSRUAS,Data Science,KCET,2024,76254,90116,12626,11346,190342,178996,No
PESCE,Aerospace Engineering,KCET,2024,70170,87100,17907,29057,204234,175177,Yes
BMSCE,Aerospace Engineering,KCET,2024,71085,75853,9638,24880,181456,156576,Yes
AECMandya,Mechanical Engineering,KCET,2023,56177,62579,12814,13138,144708,131570,Yes
KLSGIT,Electronics and Communication Engineering,COMEDK,2023,210805,74242,19194,16714,320955,304241,No
HKBK,Data Science,KCET,2023,65552,86948,18156,21069,191725,170656,No
SDMCET,Computer Science and Engineering,COMEDK,2023,214879,83696,12330,17609,328514,310905,No
EastPoint,Civil Engineering,KCET,2023,68401,60511,15256,10618,154786,144168,No
NIE,Robotics and Automation Engineering,COMEDK,2023,187772,85092,13105,28697,314666,285969,No
RAIT,Civil Engineering,COMEDK,2023,237569,76573,16111,24618,354871,330253,No
RIT,Data Science,COMEDK,2023,235243,92323,17434,20440,365440,345000,Yes
ACU,Aerospace Engineering,COMEDK,2024,221509,68576,19793,27529,337407,309878,Yes
SCEM,Robotics and Automation Engineering,COMEDK,2024,233035,81638,18607,13152,346432,333280,No
DBIT,Computer Science and Engineering,KCET,2023,56122,67751,8277,12933,145083,132150,Yes
KLSGIT,Robotics and Automation Engineering,KCET,2023,63183,72233,14863,26081,176360,150279,Yes
YKCE,Mechanical Engineering,COMEDK,2024,234454,93746,17401,12152,357753,345601,No
RIT,Electronics and Communication Engineering,KCET,2024,71524,93433,18213,15852,199022,183170,No
NMIT,Data Science,COMEDK,2024,190258,72809,15342,27841,306250,278409,No
EastPoint,Information Science and Engineering,KCET,2023,51949,93687,17779,18946,182361,163415,No
VVCE,Computer Science and Engineering,COMEDK,2024,194313,60073,17822,26121,298329,272208,Yes
VVCE,Robotics and Automation Engineering,KCET,2024,53209,74367,14657,15963,158196,142233,No
VemanaIT,Civil Engineering,KCET,2023,67933,60985,17713,19895,166526,146631,Yes
NHCE,Civil Engineering,COMEDK,2023,237923,70639,8908,28353,345823,317470,No
BITM,Civil Engineering,KCET,2024,52124,60113,9184,21621,143042,121421,No
DBIT,Electronics and Communication Engineering,COMEDK,2024,208325,71030,10337,15024,304716,289692,Yes
MVJCE,Aerospace Engineering,COMEDK,2024,165724,86458,12159,26180,290521,264341,Yes
YKCE,Artificial Intelligence and Data Science,COMEDK,2023,189920,74728,14006,11764,290418,278654,Yes
DrAIT,Computer Science and Engineering,COMEDK,2024,218820,94156,16435,27560,356971,329411,Yes
JIT,Biotechnology,KCET,2023,77806,71440,9313,26290,184849,158559,No
MSRUAS,Civil Engineering,KCET,2023,61325,83735,15531,10408,170999,160591,No
DSCE,Robotics and Automation Engineering,KCET,2023,68327,68116,8182,11192,155817,144625,No
VVIT,Electrical and Electronics Engineering,COMEDK,2024,175402,74724,18164,27526,295816,268290,Yes
DSATM,Civil Engineering,COMEDK,2024,225079,64564,10637,25567,325847,300280,No
BMIT,Data Science,KCET,2024,72783,73658,12848,13580,172869,159289,Yes
KSIT,Chemical Engineering,KCET,2023,57866,68165,13032,18789,157852,139063,Yes
MSRUAS,Electronics and Communication Engineering,COMEDK,2023,177856,79249,19532,10233,286870,276637,Yes
KLEIT,Computer Science and Engineering,COMEDK,2024,172799,86414,13591,13076,285880,272804,No
DrAIT,Artificial Intelligence and Data Science,KCET,2024,80398,74912,13000,26320,194630,168310,No
GIT,Civil Engineering,KCET,2024,83227,78610,14240,13404,189481,176077,No
HKBK,Computer Science and Engineering,KCET,2024,78125,91490,14390,21488,205493,184005,Yes
SJBIT,Civil Engineering,KCET,2024,54265,93645,16629,18001,182540,164539,No
RVCE,Robotics and Automation Engineering,COMEDK,2023,220548,72066,12812,19526,324952,305426,Yes
DSCE,Artificial Intelligence and Data Science,KCET,2024,57809,71938,16932,23031,169710,146679,Yes
BIT,Data Science,KCET,2024,59112,67280,16610,27043,170045,143002,Yes
RAIT,Data Science,KCET,2023,79506,83841,10148,14777,188272,173495,No
PESCE,Electronics and Communication Engineering,COMEDK,2024,229638,89593,16761,12195,348187,335992,Yes
CITGubbi,Electrical and Electronics Engineering,KCET,2023,76570,89369,13601,17143,196683,179540,No
KLEIT,Artificial Intelligence and Data Science,COMEDK,2024,234980,90569,8658,27141,361348,334207,Yes
MSRIT,Civil Engineering,KCET,2024,69689,75084,13585,25807,184165,158358,Yes
DSCE,Aerospace Engineering,KCET,2023,81502,80280,10028,25670,197480,171810,No
SJBIT,Biotechnology,COMEDK,2023,243172,77137,17409,26127,363845,337718,Yes
SITM,Chemical Engineering,COMEDK,2024,179287,87158,11674,11920,290039,278119,No
AITM,Civil Engineering,KCET,2023,57617,63810,15245,27208,163880,136672,No
MSRUAS,Data Science,COMEDK,2023,209378,94139,10117,21138,334772,313634,Yes
GIT,Civil Engineering,COMEDK,2023,176979,80269,19068,16634,292950,276316,No
BIT,Electronics and Communication Engineering,COMEDK,2023,237325,75867,8168,11741,333101,321360,Yes
JIT,Biotechnology,COMEDK,2023,247414,86646,16162,23433,373655,350222,No
SIT,Information Science and Engineering,COMEDK,2023,195513,80116,13226,16361,305216,288855,Yes
AIT,Electronics and Communication Engineering,KCET,2023,62827,65288,12962,15519,156596,141077,Yes
AIT,Mechanical Engineering,KCET,2023,58056,78852,12591,21109,170608,149499,Yes
NHCE,Information Science and Engineering,KCET,2024,80450,73179,14495,26594,194718,168124,No
DSCE,Biotechnology,KCET,2024,58587,85555,11672,28472,184286,155814,Yes
KSIT,Electrical and Electronics Engineering,KCET,2023,65413,88031,18606,16250,188300,172050,Yes
DBIT,Robotics and Automation Engineering,COMEDK,2023,240652,63768,17312,29654,351386,321732,No
KLSGIT,Robotics and Automation Engineering,KCET,2024,62220,86164,14096,12077,174557,162480,No
AEC,Artificial Intelligence and Data Science,KCET,2024,54224,74333,8780,27378,164715,137337,Yes
SIT,Electronics and Communication Engineering,KCET,2024,67934,65012,13634,17813,164393,146580,No
KSIT,Mechanical Engineering,KCET,2024,80565,77293,8152,17326,183336,166010,No
JSSSTU,Mechanical Engineering,COMEDK,2024,246983,75032,8292,14617,344924,330307,No
MVJCE,Aerospace Engineering,COMEDK,2024,205191,76377,19875,12496,313939,301443,No
MSRUAS,Robotics and Automation Engineering,KCET,2023,61751,80511,15888,26679,184829,158150,Yes
KLEIT,Civil Engineering,COMEDK,2024,197117,65444,18751,13401,294713,281312,No
SCEM,Mechanical Engineering,KCET,2024,58250,77187,15859,23929,175225,151296,No
SJBCE,Biotechnology,COMEDK,2023,170953,60153,12800,26808,270714,243906,Yes
SDMCET,Mechanical Engineering,KCET,2024,81909,84828,15135,17565,199437,181872,No
NMIT,Robotics and Automation Engineering,COMEDK,2024,185575,68097,17062,22392,293126,270734,No
PESU,Chemical Engineering,KCET,2023,78465,91317,17601,17706,205089,187383,No
AITM,Electronics and Communication Engineering,KCET,2023,84616,76468,13448,28921,203453,174532,No
MVJCE,Robotics and Automation Engineering,KCET,2023,73977,73447,13214,27280,187918,160638,No
JIT,Robotics and Automation Engineering,KCET,2024,71451,74748,16063,21741,184003,162262,Yes
GIT,Aerospace Engineering,KCET,2024,56143,79036,13448,23135,171762,148627,No
VIT,Information Science and Engineering,COMEDK,2024,243323,75419,17385,18471,354598,336127,Yes
VIT,Civil Engineering,COMEDK,2024,166219,69758,16322,10670,262969,252299,No
KLSGIT,Mechanical Engineering,KCET,2024,75436,76991,10186,21222,183835,162613,Yes
BMSCE,Artificial Intelligence and Data Science,KCET,2023,71144,92948,18023,23227,205342,182115,Yes
AITM,Biotechnology,KCET,2024,82200,64911,18835,14007,179953,165946,Yes
AECMandya,Aerospace Engineering,KCET,2023,50820,82374,10463,17705,161362,143657,Yes
DSATM,Robotics and Automation Engineering,COMEDK,2024,162996,62532,13994,15494,255016,239522,Yes
JIT,Chemical Engineering,KCET,2024,71855,81261,10540,10677,174333,163656,Yes
NHCE,Chemical Engineering,COMEDK,2024,191918,76920,19070,21337,309245,287908,Yes
SJBIT,Artificial Intelligence and Data Science,KCET,2024,64108,63863,19370,18591,165932,147341,Yes
AEC,Data Science,KCET,2024,84053,69915,18951,14285,187204,172919,Yes
RVUNIV,Robotics and Automation Engineering,COMEDK,2024,182413,88198,13312,28696,312619,283923,Yes
RAIT,Computer Science and Engineering,COMEDK,2023,231023,67938,14453,16320,329734,313414,No
SJBIT,Electrical and Electronics Engineering,COMEDK,2024,177607,90104,9656,15417,292784,277367,Yes
AECMandya,Chemical Engineering,KCET,2023,56637,64988,17226,10318,149169,138851,No
RVUNIV,Data Science,COMEDK,2024,178980,73843,14779,22192,289794,267602,Yes
DSATM,Artificial Intelligence and Data Science,COMEDK,2023,206949,70021,9715,10757,297442,286685,No
MVJCE,Artificial Intelligence and Data Science,KCET,2023,58115,78636,18983,16529,172263,155734,Yes
RVCE,Computer Science and Engineering,COMEDK,2023,213111,72299,13372,18082,316864,298782,Yes
KLEIT,Electronics and Communication Engineering,COMEDK,2023,221850,80405,14268,21211,337734,316523,No
UVCE,Data Science,KCET,2024,59309,78584,12540,10636,161069,150433,Yes
NCET,Aerospace Engineering,COMEDK,2023,174813,63556,8448,21972,268789,246817,No
NCET,Electronics and Communication Engineering,COMEDK,2023,200358,80820,15673,22110,318961,296851,Yes
YKCE,Chemical Engineering,COMEDK,2024,242686,85260,14547,19383,361876,342493,Yes
PESU,Robotics and Automation Engineering,KCET,2023,58852,62152,12086,19510,152600,133090,Yes
UVCE,Chemical Engineering,KCET,2023,69364,82254,8456,28964,189038,160074,Yes
YKCE,Computer Science and Engineering,KCET,2023,76129,68407,11650,10036,166222,156186,No
NMIT,Computer Science and Engineering,COMEDK,2023,200733,74247,10472,25706,311158,285452,Yes
KSIT,Artificial Intelligence and Data Science,KCET,2024,55259,79702,9620,21174,165755,144581,Yes
NCET,Computer Science and Engineering,KCET,2023,82899,70287,13298,29070,195554,166484,Yes
BNMIT,Artificial Intelligence and Data Science,COMEDK,2024,231141,70973,9937,14506,326557,312051,No
BNMIT,Electronics and Communication Engineering,COMEDK,2023,190918,68119,16614,19416,295067,275651,Yes
CITGubbi,Biotechnology,COMEDK,2023,160180,69450,9298,20866,259794,238928,Yes
SITM,Electronics and Communication Engineering,COMEDK,2023,223804,86250,14851,22310,347215,324905,No
AEC,Civil Engineering,COMEDK,2023,175546,79417,10942,26352,292257,265905,No
SDMCET,Aerospace Engineering,COMEDK,2024,182276,77393,13724,17786,291179,273393,No
BMSIT,Robotics and Automation Engineering,COMEDK,2023,174698,75702,14389,13491,278280,264789,No
VVIT,Mechanical Engineering,KCET,2023,73634,67593,14805,26221,182253,156032,No
JIT,Mechanical Engineering,KCET,2024,56456,91668,9009,29868,187001,157133,No
NHCE,Electrical and Electronics Engineering,KCET,2024,72337,90027,11823,15778,189965,174187,No
VemanaIT,Chemical Engineering,KCET,2024,50599,75958,10424,28264,165245,136981,Yes
CMRIT,Electrical and Electronics Engineering,COMEDK,2024,195527,88072,10366,12938,306903,293965,No
YKCE,Mechanical Engineering,KCET,2024,71320,62526,8220,22998,165064,142066,No
CITGubbi,Electronics and Communication Engineering,KCET,2023,62032,69056,12539,16705,160332,143627,No
VSM,Electronics and Communication Engineering,KCET,2023,65725,84289,12608,27771,190393,162622,No
VemanaIT,Information Science and Engineering,COMEDK,2023,165309,82315,9659,11653,268936,257283,Yes
NCET,Artificial Intelligence and Data Science,KCET,2024,50929,64128,12751,17652,145460,127808,No
VVIT,Artificial Intelligence and Data Science,COMEDK,2024,186814,83675,12451,13042,295982,282940,No
GMIT,Artificial Intelligence and Data Science,COMEDK,2024,176843,91680,15034,22740,306297,283557,Yes
BITM,Chemical Engineering,COMEDK,2023,178061,60316,14183,17663,270223,252560,No
MSRIT,Electronics and Communication Engineering,COMEDK,2023,176450,74705,15670,17107,283932,266825,No
SDMCET,Information Science and Engineering,KCET,2024,82393,75643,17459,12838,188333,175495,No
AIT,Information Science and Engineering,COMEDK,2024,228964,80556,14045,26725,350290,323565,Yes
SDMIT,Civil Engineering,COMEDK,2024,211945,79404,8629,13701,313679,299978,No
DBIT,Information Science and Engineering,KCET,2024,65707,63873,9177,27869,166626,138757,Yes
CMRIT,Aerospace Engineering,KCET,2024,67491,93983,9493,16359,187326,170967,No
JNNCE,Civil Engineering,KCET,2023,62157,60358,17669,28628,168812,140184,Yes
JIT,Biotechnology,KCET,2023,51149,73739,15085,10906,150879,139973,Yes
AIT,Data Science,KCET,2024,55145,78675,16178,21584,171582,149998,No
RIT,Robotics and Automation Engineering,COMEDK,2023,207656,68157,19750,16956,312519,295563,Yes
EastPoint,Aerospace Engineering,KCET,2024,70582,78337,16627,26700,192246,165546,No
REVA,Chemical Engineering,COMEDK,2024,170158,72629,15686,16443,274916,258473,No
YKCE,Electrical and Electronics Engineering,KCET,2023,56755,66261,8483,21503,153002,131499,Yes
RAIT,Chemical Engineering,KCET,2023,68722,74573,12398,15950,171643,155693,Yes
PESCE,Artificial Intelligence and Data Science,KCET,2024,80037,68094,13300,22719,184150,161431,Yes
AITM,Aerospace Engineering,KCET,2023,77088,75106,15663,27746,195603,167857,No
ACU,Artificial Intelligence and Data Science,COMEDK,2023,197233,73093,13843,10729,294898,284169,Yes
ACU,Electrical and Electronics Engineering,KCET,2023,77574,66250,16204,19661,179689,160028,Yes
CMRIT,Mechanical Engineering,COMEDK,2024,248699,74608,14144,13566,351017,337451,No
KLEIT,Artificial Intelligence and Data Science,KCET,2023,64169,65283,9635,13256,152343,139087,Yes
MSRIT,Mechanical Engineering,KCET,2024,57405,82541,14465,26404,180815,154411,Yes
JIT,Biotechnology,KCET,2023,68689,64292,10938,20026,163945,143919,No
SCEM,Data Science,COMEDK,2024,217711,73464,8337,28559,328071,299512,No
MVJCE,Artificial Intelligence and Data Science,KCET,2024,69784,79067,12105,26715,187671,160956,Yes
ACU,Biotechnology,COMEDK,2024,162371,75051,18107,20311,275840,255529,Yes
RIT,Electrical and Electronics Engineering,KCET,2024,50898,90311,9690,11581,162480,150899,No
SITM,Electrical and Electronics Engineering,KCET,2024,56048,87692,16387,26557,186684,160127,No
CMRIT,Robotics and Automation Engineering,KCET,2023,75768,88025,13089,27503,204385,176882,Yes
RVUNIV,Robotics and Automation Engineering,COMEDK,2024,177160,63324,17551,27724,285759,258035,No
MSRUAS,Information Science and Engineering,KCET,2024,77387,85144,18393,20111,201035,180924,Yes
DSATM,Biotechnology,COMEDK,2023,224084,63606,15159,28433,331282,302849,No
BMSIT,Aerospace Engineering,COMEDK,2024,225295,63096,14386,29929,332706,302777,Yes
DSATM,Information Science and Engineering,KCET,2023,71761,62337,17368,15626,167092,151466,Yes
ACU,Civil Engineering,KCET,2023,60978,74665,14074,26145,175862,149717,No
KSIT,Electronics and Communication Engineering,COMEDK,2023,192432,62370,16046,25729,296577,270848,Yes
AIT,Electrical and Electronics Engineering,KCET,2024,53144,93598,12144,25475,184361,158886,Yes
AITM,Robotics and Automation Engineering,KCET,2024,56062,79467,14289,27518,177336,149818,No
KSIT,Artificial Intelligence and Data Science,KCET,2023,55087,82516,16992,29689,184284,154595,No
JIT,Mechanical Engineering,COMEDK,2023,239591,85358,10744,27489,363182,335693,Yes
BMSCE,Robotics and Automation Engineering,KCET,2024,74820,73386,14453,11549,174208,162659,Yes
NCET,Electrical and Electronics Engineering,COMEDK,2023,221530,73282,9792,10595,315199,304604,Yes
HKBK,Civil Engineering,COMEDK,2024,187567,79074,18899,15429,300969,285540,No
DrAIT,Electronics and Communication Engineering,KCET,2024,58041,71923,10770,13509,154243,140734,No
NMIT,Robotics and Automation Engineering,COMEDK,2024,169178,87968,17509,10021,284676,274655,Yes
VSM,Data Science,COMEDK,2023,234142,65786,17063,27721,344712,316991,Yes
VIT,Artificial Intelligence and Data Science,COMEDK,2024,225820,61094,8105,14402,309421,295019,No
MSRIT,Data Science,KCET,2023,78900,69500,14785,13190,176375,163185,No
KSIT,Aerospace Engineering,KCET,2024,55247,65966,11968,24741,157922,133181,No
VemanaIT,Computer Science and Engineering,COMEDK,2023,191845,83210,15149,11807,302011,290204,No
PRES,Civil Engineering,COMEDK,2024,221617,63559,14894,27315,327385,300070,No
DSATM,Robotics and Automation Engineering,COMEDK,2023,204839,79232,14745,26451,325267,298816,No
NCET,Data Science,COMEDK,2024,200141,77671,14458,26330,318600,292270,Yes
NMIT,Computer Science and Engineering,COMEDK,2024,203308,72708,10615,26695,313326,286631,No
KLEIT,Biotechnology,KCET,2023,75973,89708,17422,19464,202567,183103,No
AEC,Data Science,KCET,2024,63586,62056,17658,10073,153373,143300,Yes
KLSGIT,Civil Engineering,KCET,2023,73043,82960,15213,27284,198500,171216,No
BNMIT,Aerospace Engineering,KCET,2024,82929,75319,13323,10353,181924,171571,No
VVIT,Computer Science and Engineering,COMEDK,2023,208134,84739,10575,20167,323615,303448,Yes
AEC,Robotics and Automation Engineering,KCET,2024,61434,74553,17154,25044,178185,153141,Yes
VSM,Information Science and Engineering,KCET,2023,58946,87586,8209,26186,180927,154741,Yes
KSIT,Information Science and Engineering,KCET,2023,53607,72861,11854,17593,155915,138322,No
GMIT,Information Science and Engineering,KCET,2023,82379,79277,9345,12934,183935,171001,No
GMIT,Computer Science and Engineering,KCET,2024,79489,93244,14350,11545,198628,187083,Yes
CMRIT,Electronics and Communication Engineering,COMEDK,2024,172776,67190,19483,29009,288458,259449,No
BIT,Mechanical Engineering,COMEDK,2024,234251,77112,14717,25913,351993,326080,Yes
SITM,Computer Science and Engineering,KCET,2023,83213,64360,11401,26115,185089,158974,No
SJBCE,Robotics and Automation Engineering,COMEDK,2023,222868,91666,11491,10418,336443,326025,Yes
VSM,Information Science and Engineering,COMEDK,2023,246360,69505,16062,28048,359975,331927,No
SDMIT,Electrical and Electronics Engineering,KCET,2024,80776,74301,16531,22585,194193,171608,No
MVJCE,Electrical and Electronics Engineering,KCET,2023,73807,65518,15492,23041,177858,154817,Yes
AEC,Data Science,COMEDK,2024,165820,69988,18127,16242,270177,253935,No
NMIT,Electrical and Electronics Engineering,COMEDK,2024,188262,66811,15542,18409,289024,270615,Yes
VSM,Information Science and Engineering,KCET,2024,80702,89905,14572,25920,211099,185179,No
PESU,Electrical and Electronics Engineering,COMEDK,2023,202593,66713,19203,24138,312647,288509,No
AIT,Computer Science and Engineering,KCET,2023,77840,85651,9562,13019,186072,173053,Yes
SCEM,Aerospace Engineering,COMEDK,2024,227098,63334,17820,26638,334890,308252,Yes
SDMCET,Biotechnology,COMEDK,2024,232099,89478,18041,27055,366673,339618,Yes
SITM,Electrical and Electronics Engineering,COMEDK,2023,186288,93773,19687,11138,310886,299748,No
RAIT,Civil Engineering,COMEDK,2024,163456,90148,19747,18416,291767,273351,No
PESCE,Aerospace Engineering,COMEDK,2024,226056,93031,15173,13338,347598,334260,No
YKCE,Mechanical Engineering,COMEDK,2024,216494,82880,13141,13394,325909,312515,No
JNNCE,Electrical and Electronics Engineering,COMEDK,2024,198825,65300,8836,14898,287859,272961,No
BMIT,Artificial Intelligence and Data Science,KCET,2024,81769,84851,12630,12161,191411,179250,Yes
RAIT,Chemical Engineering,COMEDK,2024,232364,77101,17840,13940,341245,327305,No
SJBCE,Information Science and Engineering,KCET,2023,53871,93290,9160,13789,170110,156321,No
YKCE,Information Science and Engineering,KCET,2024,83473,65483,17448,29517,195921,166404,No
JNNCE,Robotics and Automation Engineering,COMEDK,2023,248604,64891,18825,10200,342520,332320,No
SDMIT,Artificial Intelligence and Data Science,KCET,2023,66675,60397,19433,28347,174852,146505,No
VSM,Biotechnology,COMEDK,2023,207597,82715,13432,21100,324844,303744,Yes
PRES,Information Science and Engineering,COMEDK,2023,163012,64337,11712,19783,258844,239061,No
PESCE,Artificial Intelligence and Data Science,COMEDK,2023,217980,69926,12986,21510,322402,300892,Yes
DBIT,Data Science,COMEDK,2024,212776,80409,19221,27614,340020,312406,No
BMSIT,Data Science,COMEDK,2024,201166,74016,10858,18852,304892,286040,No
GMIT,Electrical and Electronics Engineering,COMEDK,2023,232492,65240,9232,19665,326629,306964,Yes
BMSCE,Electrical and Electronics Engineering,KCET,2024,56259,65170,14696,12147,148272,136125,Yes
DBIT,Electrical and Electronics Engineering,COMEDK,2023,175375,66126,15021,17390,273912,256522,No
SITM,Chemical Engineering,KCET,2024,64951,75788,13121,10377,164237,153860,No
VVIT,Civil Engineering,COMEDK,2024,208883,67680,14402,16621,307586,290965,No
KLSGIT,Chemical Engineering,COMEDK,2024,247702,67795,18149,15160,348806,333646,No
RVCE,Artificial Intelligence and Data Science,COMEDK,2024,179721,75414,9839,26729,291703,264974,Yes
UVCE,Robotics and Automation Engineering,KCET,2023,71858,62719,9465,23372,167414,144042,No
SCEM,Electronics and Communication Engineering,KCET,2023,54417,75831,18987,13190,162425,149235,Yes
HKBK,Data Science,COMEDK,2023,230295,69303,18764,25410,343772,318362,Yes
AIT,Artificial Intelligence and Data Science,COMEDK,2023,194385,73690,16259,22839,307173,284334,Yes
AEC,Aerospace Engineering,COMEDK,2024,227689,70026,15499,10367,323581,313214,Yes
JNNCE,Biotechnology,COMEDK,2023,214313,70080,18106,24469,326968,302499,Yes
GIT,Computer Science and Engineering,KCET,2023,56396,78238,12741,28978,176353,147375,Yes
NHCE,Computer Science and Engineering,KCET,2023,53322,74887,15659,28515,172383,143868,Yes
ACU,Chemical Engineering,COMEDK,2023,227077,61082,12614,15152,315925,300773,No
JNNCE,Aerospace Engineering,KCET,2023,53968,84312,13411,26125,177816,151691,Yes
NIE,Mechanical Engineering,COMEDK,2024,197859,69504,18065,18767,304195,285428,No
MSRUAS,Information Science and Engineering,KCET,2023,52268,79772,10783,16819,159642,142823,No
AECMandya,Computer Science and Engineering,COMEDK,2024,235768,87130,18007,20088,360993,340905,No
DBIT,Electronics and Communication Engineering,COMEDK,2024,187538,76942,10837,14995,290312,275317,No
RVUNIV,Biotechnology,COMEDK,2023,222184,60877,9312,12903,305276,292373,No
DrAIT,Computer Science and Engineering,KCET,2024,60566,87639,9242,13076,170523,157447,Yes
SDMIT,Information Science and Engineering,KCET,2023,67456,71623,15538,14178,168795,154617,No
SJBCE,Mechanical Engineering,COMEDK,2024,238794,68180,12302,19980,339256,319276,Yes
NMIT,Biotechnology,COMEDK,2023,187499,79184,10846,19066,296595,277529,No
AITM,Chemical Engineering,KCET,2024,58745,84917,12499,24658,180819,156161,Yes
RNSIT,Computer Science and Engineering,KCET,2023,82431,61277,19112,11887,174707,162820,Yes
RVCE,Electrical and Electronics Engineering,COMEDK,2023,236558,85224,10565,29635,361982,332347,Yes
CMRIT,Biotechnology,KCET,2023,72071,75670,15302,29632,192675,163043,No
KLEIT,Robotics and Automation Engineering,COMEDK,2024,235371,68726,17103,19497,340697,321200,Yes
VemanaIT,Robotics and Automation Engineering,COMEDK,2024,190010,79419,18194,24612,312235,287623,No
VIT,Information Science and Engineering,COMEDK,2024,188700,64321,9440,15094,277555,262461,No
KLSGIT,Aerospace Engineering,KCET,2024,58513,76415,8354,11542,154824,143282,No
VSM,Chemical Engineering,COMEDK,2023,232705,63980,19989,19401,336075,316674,Yes
HKBK,Electronics and Communication Engineering,KCET,2024,63033,75608,14061,15446,168148,152702,Yes
VemanaIT,Mechanical Engineering,COMEDK,2023,218870,76555,14582,25989,335996,310007,No
SJBIT,Aerospace Engineering,COMEDK,2024,176881,79693,14149,28964,299687,270723,No
SJBCE,Electronics and Communication Engineering,KCET,2023,70370,86770,11341,19671,188152,168481,No
KLEIT,Aerospace Engineering,COMEDK,2024,231972,81271,8870,23306,345419,322113,Yes
RNSIT,Electronics and Communication Engineering,COMEDK,2024,162305,86306,16051,12642,277304,264662,No
ACU,Biotechnology,COMEDK,2024,180086,73802,16195,17149,287232,270083,Yes
NMIT,Artificial Intelligence and Data Science,KCET,2024,68618,67762,11895,16109,164384,148275,No
DBIT,Information Science and Engineering,COMEDK,2024,180781,67806,10800,16925,276312,259387,Yes
CMRIT,Chemical Engineering,KCET,2024,55964,71775,10552,10156,148447,138291,Yes
AECMandya,Mechanical Engineering,KCET,2023,65420,87379,8723,12386,173908,161522,Yes
VSM,Information Science and Engineering,KCET,2024,83636,88278,17711,28794,218419,189625,Yes
NHCE,Biotechnology,COMEDK,2024,201318,86067,13391,23029,323805,300776,No
VIT,Mechanical Engineering,KCET,2024,82636,93315,13306,11006,200263,189257,Yes
RVUNIV,Robotics and Automation Engineering,KCET,2023,52676,83736,10972,13162,160546,147384,Yes
AEC,Chemical Engineering,KCET,2023,54131,61364,12680,15221,143396,128175,Yes
BMSCE,Mechanical Engineering,KCET,2023,58627,76193,18426,16202,169448,153246,No
NIE,Computer Science and Engineering,COMEDK,2024,222725,79076,18016,28118,347935,319817,No
RVCE,Computer Science and Engineering,KCET,2023,60633,71537,14249,22826,169245,146419,Yes
BNMIT,Biotechnology,KCET,2023,67439,63537,9405,24787,165168,140381,No
SIT,Electrical and Electronics Engineering,KCET,2023,64337,69458,17734,14553,166082,151529,Yes
VSM,Biotechnology,KCET,2023,55293,72530,15483,29538,172844,143306,No
RVUNIV,Mechanical Engineering,KCET,2023,50627,88828,8300,12983,160738,147755,Yes
DBIT,Chemical Engineering,KCET,2024,64722,70538,11640,17625,164525,146900,Yes
NHCE,Information Science and Engineering,KCET,2024,65236,61509,18321,23533,168599,145066,No
CITGubbi,Artificial Intelligence and Data Science,COMEDK,2024,160144,70842,13789,14196,258971,244775,No
AITM,Artificial Intelligence and Data Science,KCET,2024,80880,87426,14797,24341,207444,183103,No
SJBIT,Data Science,COMEDK,2023,228727,94859,18463,28839,370888,342049,No
REVA,Robotics and Automation Engineering,COMEDK,2024,161827,87093,14812,28806,292538,263732,No
MSRIT,Computer Science and Engineering,KCET,2024,53668,69393,14562,14923,152546,137623,Yes
SITM,Robotics and Automation Engineering,COMEDK,2024,180762,90025,18943,27331,317061,289730,Yes
EastPoint,Mechanical Engineering,COMEDK,2024,200040,68929,13252,28910,311131,282221,No
NCET,Mechanical Engineering,KCET,2024,60780,66694,12541,26214,166229,140015,Yes
DSATM,Electronics and Communication Engineering,COMEDK,2024,203106,62764,14037,24509,304416,279907,No
YKCE,Electrical and Electronics Engineering,KCET,2024,54113,85142,12371,17404,169030,151626,No
GIT,Biotechnology,KCET,2024,56001,71497,15936,27095,170529,143434,Yes
BITM,Aerospace Engineering,KCET,2023,51862,86878,13695,29678,182113,152435,Yes
VVIT,Electrical and Electronics Engineering,COMEDK,2023,215788,70888,15368,14396,316440,302044,No
DSATM,Civil Engineering,COMEDK,2024,199917,81812,10110,19647,311486,291839,Yes
MVJCE,Electronics and Communication Engineering,COMEDK,2024,230494,71157,19434,28053,349138,321085,No
DSATM,Chemical Engineering,KCET,2023,52884,71932,13200,29605,167621,138016,No
REVA,Biotechnology,COMEDK,2023,196477,87187,19030,25566,328260,302694,Yes
KSIT,Chemical Engineering,COMEDK,2023,182069,73938,8123,18685,282815,264130,No
VIT,Artificial Intelligence and Data Science,KCET,2024,75258,77420,11862,24353,188893,164540,No
BMSIT,Chemical Engineering,KCET,2023,70978,63667,8943,29830,173418,143588,Yes
SCEM,Computer Science and Engineering,COMEDK,2023,249916,92110,9358,10007,361391,351384,No
NCET,Computer Science and Engineering,KCET,2023,57757,65049,10728,23640,157174,133534,Yes
RVCE,Artificial Intelligence and Data Science,COMEDK,2024,235375,60999,17416,13171,326961,313790,No
EastPoint,Information Science and Engineering,KCET,2023,61824,87036,10653,25191,184704,159513,Yes
VSM,Computer Science and Engineering,KCET,2024,72463,67493,11402,28669,180027,151358,No
SDMIT,Aerospace Engineering,KCET,2024,76563,82734,13710,23196,196203,173007,No
SJBIT,Biotechnology,KCET,2023,50786,94290,8555,15020,168651,153631,No
KLSGIT,Aerospace Engineering,COMEDK,2023,200067,80540,19271,17098,316976,299878,Yes
BMIT,Civil Engineering,KCET,2024,55234,72140,8180,22350,157904,135554,Yes
SDMCET,Computer Science and Engineering,KCET,2023,83628,65783,15364,17798,182573,164775,No
SCEM,Information Science and Engineering,KCET,2023,69789,80104,12471,25248,187612,162364,Yes
SJBCE,Artificial Intelligence and Data Science,KCET,2023,55506,76874,13709,20881,166970,146089,Yes
PRES,Electronics and Communication Engineering,COMEDK,2023,169668,85184,19857,14533,289242,274709,No
DSATM,Aerospace Engineering,COMEDK,2024,230808,71455,18296,10661,331220,320559,No
GIT,Robotics and Automation Engineering,KCET,2024,76753,72362,18075,17852,185042,167190,No
AIT,Artificial Intelligence and Data Science,COMEDK,2023,161585,86916,16549,27383,292433,265050,No
VVCE,Biotechnology,KCET,2024,52820,60943,12617,10203,136583,126380,No
YKCE,Aerospace Engineering,KCET,2023,69191,63094,9479,26193,167957,141764,Yes
AIT,Chemical Engineering,COMEDK,2023,171580,71615,14417,21321,278933,257612,No
REVA,Robotics and Automation Engineering,KCET,2024,84521,92214,14713,23078,214526,191448,Yes
KLEIT,Chemical Engineering,KCET,2024,55231,76666,8554,26067,166518,140451,No
SDMCET,Data Science,KCET,2023,55753,81974,11785,11201,160713,149512,Yes
GIT,Civil Engineering,COMEDK,2023,185369,85672,11045,13460,295546,282086,Yes
BMSIT,Artificial Intelligence and Data Science,KCET,2024,53558,67986,15491,16504,153539,137035,No
BITM,Civil Engineering,KCET,2024,65445,71152,16482,12753,165832,153079,Yes
NHCE,Aerospace Engineering,KCET,2023,58446,89144,10420,23575,181585,158010,Yes
YKCE,Biotechnology,KCET,2024,53857,65907,17425,14497,151686,137189,Yes
RVUNIV,Electrical and Electronics Engineering,KCET,2023,63879,71222,9021,19070,163192,144122,No
GMIT,Artificial Intelligence and Data Science,KCET,2023,80130,78914,18898,22559,200501,177942,No
UVCE,Mechanical Engineering,KCET,2024,63107,78484,15961,16596,174148,157552,No
RIT,Chemical Engineering,KCET,2024,53110,66831,12555,18065,150561,132496,Yes
BMIT,Aerospace Engineering,COMEDK,2024,202932,78706,14572,22813,319023,296210,No
KLEIT,Information Science and Engineering,KCET,2023,53583,79341,19036,17388,169348,151960,No
MSRIT,Biotechnology,COMEDK,2024,220445,92185,10292,19056,341978,322922,No
PRES,Robotics and Automation Engineering,KCET,2024,61509,89231,9539,27823,188102,160279,Yes
GIT,Electrical and Electronics Engineering,COMEDK,2023,205979,67674,19949,10469,304071,293602,Yes
CITGubbi,Data Science,KCET,2023,81222,89429,13181,26140,209972,183832,No
GIT,Electrical and Electronics Engineering,KCET,2024,59975,75496,18471,21644,175586,153942,No
NIE,Civil Engineering,COMEDK,2023,245539,85842,9947,23885,365213,341328,No
BMSIT,Data Science,KCET,2024,53834,79249,15585,12908,161576,148668,Yes
VVIT,Information Science and Engineering,COMEDK,2024,239926,76099,10775,28462,355262,326800,No
EastPoint,Computer Science and Engineering,KCET,2024,73593,83183,15749,27084,199609,172525,Yes
DBIT,Electronics and Communication Engineering,KCET,2023,70284,67625,16635,28521,183065,154544,No
NIE,Civil Engineering,KCET,2023,55689,88572,15164,16238,175663,159425,Yes
SJBCE,Electrical and Electronics Engineering,COMEDK,2024,183229,86221,17082,29319,315851,286532,No
PESU,Aerospace Engineering,COMEDK,2024,180223,89234,13447,21928,304832,282904,Yes
PESU,Robotics and Automation Engineering,COMEDK,2023,203112,83427,14319,29809,330667,300858,No
BMIT,Aerospace Engineering,KCET,2023,81381,80252,9450,13295,184378,171083,No
CMRIT,Computer Science and Engineering,KCET,2023,73728,75318,10288,27822,187156,159334,Yes
PRES,Data Science,COMEDK,2024,193004,83053,10366,29584,316007,286423,Yes
UVCE,Data Science,COMEDK,2023,227315,72116,11425,22713,333569,310856,No
SDMIT,Chemical Engineering,COMEDK,2024,214702,71344,16936,11302,314284,302982,Yes
VVCE,Chemical Engineering,COMEDK,2024,203899,77903,15504,26837,324143,297306,No
AEC,Robotics and Automation Engineering,COMEDK,2024,237698,84068,15545,29842,367153,337311,Yes
SDMCET,Electronics and Communication Engineering,COMEDK,2023,160430,91116,14022,18133,283701,265568,No
SJBCE,Artificial Intelligence and Data Science,COMEDK,2023,169402,65991,9826,19727,264946,245219,Yes
JNNCE,Robotics and Automation Engineering,KCET,2024,67467,82641,11341,26100,187549,161449,Yes
EastPoint,Chemical Engineering,KCET,2023,59352,84017,14788,16815,174972,158157,Yes
PESU,Information Science and Engineering,COMEDK,2024,241389,70506,15278,21559,348732,327173,No
PESCE,Chemical Engineering,KCET,2023,84959,72267,18423,14349,189998,175649,No
VVIT,Electronics and Communication Engineering,KCET,2023,55466,64800,12888,12092,145246,133154,No
VemanaIT,Electronics and Communication Engineering,KCET,2023,66796,70000,8443,10331,155570,145239,Yes
BMIT,Aerospace Engineering,COMEDK,2023,173341,72652,9944,10431,266368,255937,Yes
MSRUAS,Biotechnology,COMEDK,2023,219164,79792,16464,13903,329323,315420,No
NCET,Computer Science and Engineering,KCET,2023,53927,84150,15735,19015,172827,153812,Yes
MSRUAS,Chemical Engineering,COMEDK,2024,229025,92836,17934,11691,351486,339795,No
BMIT,Electronics and Communication Engineering,COMEDK,2023,187833,73750,8446,28837,298866,270029,No
MSRIT,Mechanical Engineering,KCET,2024,70579,89194,12776,29370,201919,172549,Yes
HKBK,Data Science,COMEDK,2024,184742,72591,13968,10855,282156,271301,Yes
SDMCET,Biotechnology,KCET,2024,53961,92539,17985,29939,194424,164485,Yes
KLSGIT,Information Science and Engineering,COMEDK,2024,191226,74576,8355,29220,303377,274157,No
SDMCET,Artificial Intelligence and Data Science,KCET,2023,72711,66112,19373,15265,173461,158196,No
BMIT,Electronics and Communication Engineering,KCET,2024,62809,88762,17912,12503,181986,169483,Yes
CMRIT,Aerospace Engineering,COMEDK,2023,226267,73254,8641,14679,322841,308162,No
AITM,Electronics and Communication Engineering,COMEDK,2023,215833,69752,9406,11069,306060,294991,Yes
SDMCET,Chemical Engineering,COMEDK,2023,178345,73372,16337,17177,285231,268054,Yes
YKCE,Aerospace Engineering,COMEDK,2023,239224,86698,12878,12343,351143,338800,No
VIT,Computer Science and Engineering,KCET,2024,82802,60781,13658,29306,186547,157241,Yes
VIT,Electronics and Communication Engineering,COMEDK,2023,223055,78151,19231,11067,331504,320437,Yes
BMSIT,Information Science and Engineering,KCET,2024,65623,76610,11745,14349,168327,153978,Yes
EastPoint,Electronics and Communication Engineering,KCET,2023,54061,94084,19256,13243,180644,167401,No
BIT,Artificial Intelligence and Data Science,KCET,2023,83246,87657,17589,18954,207446,188492,Yes
VIT,Artificial Intelligence and Data Science,KCET,2024,72424,93781,12545,15005,193755,178750,No
VSM,Robotics and Automation Engineering,KCET,2024,56290,73061,8567,11978,149896,137918,No
MVJCE,Biotechnology,COMEDK,2023,185830,62912,10703,27605,287050,259445,No
DSATM,Biotechnology,COMEDK,2024,193699,64497,15501,19442,293139,273697,No
JSSSTU,Artificial Intelligence and Data Science,KCET,2023,80688,60161,17612,25632,184093,158461,No
DSATM,Computer Science and Engineering,KCET,2024,71777,73236,16365,10336,171714,161378,Yes
JNNCE,Chemical Engineering,COMEDK,2024,224440,62769,16712,27934,331855,303921,No
MSRIT,Chemical Engineering,KCET,2024,80522,93008,9951,12335,195816,183481,Yes
NCET,Electrical and Electronics Engineering,COMEDK,2023,201008,85181,8008,17490,311687,294197,Yes
SITM,Mechanical Engineering,KCET,2023,58423,79016,11640,20594,169673,149079,Yes
ACU,Chemical Engineering,COMEDK,2024,194645,71807,19851,17974,304277,286303,No
SITM,Electronics and Communication Engineering,COMEDK,2024,180857,87196,17209,17752,303014,285262,No
VVIT,Information Science and Engineering,COMEDK,2024,167679,60080,13348,29123,270230,241107,No
GIT,Biotechnology,COMEDK,2024,172688,81912,8359,20821,283780,262959,No
AITM,Biotechnology,COMEDK,2023,226238,82678,13933,29046,351895,322849,Yes
SJBIT,Civil Engineering,KCET,2023,70231,62498,18511,28046,179286,151240,Yes
DrAIT,Biotechnology,COMEDK,2023,174521,64573,17566,10703,267363,256660,No
VemanaIT,Mechanical Engineering,KCET,2023,65492,86948,15408,17113,184961,167848,Yes
CMRIT,Robotics and Automation Engineering,KCET,2024,81614,73206,14837,18893,188550,169657,Yes
JSSSTU,Electrical and Electronics Engineering,KCET,2023,68263,94505,17702,21754,202224,180470,Yes
MVJCE,Robotics and Automation Engineering,KCET,2024,77162,75609,8220,24115,185106,160991,No
DSATM,Computer Science and Engineering,KCET,2023,51236,68506,10063,25662,155467,129805,Yes
DSCE,Biotechnology,KCET,2023,63367,78997,12884,24245,179493,155248,Yes
CMRIT,Civil Engineering,KCET,2024,57165,75955,17531,29426,180077,150651,No
BIT,Robotics and Automation Engineering,KCET,2023,62232,71880,13648,16834,164594,147760,Yes
MVJCE,Robotics and Automation Engineering,COMEDK,2023,191316,79026,15704,18287,304333,286046,Yes
RIT,Data Science,COMEDK,2023,196888,70389,10408,13460,291145,277685,No
AEC,Electrical and Electronics Engineering,KCET,2024,62598,74344,17367,28315,182624,154309,Yes
MSRUAS,Computer Science and Engineering,KCET,2024,55094,72216,12616,13003,152929,139926,Yes
AECMandya,Mechanical Engineering,KCET,2024,66032,64924,15434,17210,163600,146390,No
DSATM,Civil Engineering,KCET,2024,51811,69924,10819,16641,149195,132554,Yes
RNSIT,Robotics and Automation Engineering,COMEDK,2023,211955,73181,14285,16737,316158,299421,No
BNMIT,Robotics and Automation Engineering,COMEDK,2024,229224,86012,16702,22522,354460,331938,No
VIT,Information Science and Engineering,KCET,2024,66231,81984,11382,16381,175978,159597,No
VIT,Civil Engineering,KCET,2023,82479,78660,10020,14332,185491,171159,No
PRES,Biotechnology,KCET,2023,59045,81502,19170,12991,172708,159717,No
VVIT,Biotechnology,KCET,2024,76970,67773,14560,23154,182457,159303,No
RVUNIV,Electronics and Communication Engineering,KCET,2024,83061,68172,8702,24788,184723,159935,No
DSATM,Artificial Intelligence and Data Science,COMEDK,2024,171530,87995,14261,13566,287352,273786,No
SJBIT,Biotechnology,KCET,2024,74579,67534,14401,20578,177092,156514,No
JSSSTU,Mechanical Engineering,COMEDK,2023,193185,86916,19524,18584,318209,299625,Yes
HKBK,Robotics and Automation Engineering,COMEDK,2024,190426,90072,11394,20398,312290,291892,No
EastPoint,Electrical and Electronics Engineering,COMEDK,2024,170949,94508,19290,25873,310620,284747,Yes
VVCE,Mechanical Engineering,KCET,2024,53160,84743,15340,15645,168888,153243,No
GIT,Electronics and Communication Engineering,COMEDK,2023,249839,84262,9425,24561,368087,343526,Yes
BITM,Computer Science and Engineering,COMEDK,2023,209274,67143,15759,18126,310302,292176,Yes
RNSIT,Data Science,KCET,2023,63582,82459,10194,27485,183720,156235,Yes
HKBK,Electrical and Electronics Engineering,COMEDK,2023,202869,82149,9493,22945,317456,294511,No
JIT,Chemical Engineering,COMEDK,2024,188663,60741,12286,22266,283956,261690,No
ACU,Computer Science and Engineering,COMEDK,2024,225325,78791,16148,25835,346099,320264,Yes
JSSSTU,Aerospace Engineering,COMEDK,2023,219913,79702,18524,21791,339930,318139,Yes
RNSIT,Aerospace Engineering,KCET,2024,69873,81432,12701,27163,191169,164006,Yes
KLSGIT,Data Science,COMEDK,2024,223755,64244,13053,14537,315589,301052,Yes
ACU,Biotechnology,KCET,2024,71148,73878,19276,14603,178905,164302,No
RAIT,Aerospace Engineering,COMEDK,2024,248510,86112,16169,29719,380510,350791,No
SCEM,Biotechnology,KCET,2024,52285,69763,19993,12563,154604,142041,No
BIT,Mechanical Engineering,COMEDK,2023,200708,80517,19945,25114,326284,301170,Yes
PRES,Electrical and Electronics Engineering,KCET,2023,75811,62861,14002,18042,170716,152674,No
NCET,Artificial Intelligence and Data Science,KCET,2024,63769,68428,17926,17783,167906,150123,Yes
YKCE,Aerospace Engineering,KCET,2024,59297,62562,10518,12790,145167,132377,No
ACU,Robotics and Automation Engineering,KCET,2024,74937,76277,9176,28144,188534,160390,No
BMSCE,Chemical Engineering,KCET,2023,83250,74534,18763,13655,190202,176547,No
HKBK,Artificial Intelligence and Data Science,KCET,2023,59785,65793,18998,14962,159538,144576,No
BITM,Mechanical Engineering,KCET,2024,68293,79617,14067,14229,176206,161977,No
AEC,Electrical and Electronics Engineering,COMEDK,2024,209754,85831,16184,15136,326905,311769,Yes
PESCE,Aerospace Engineering,COMEDK,2024,181360,65325,8525,13088,268298,255210,Yes
BMSIT,Mechanical Engineering,KCET,2024,73403,91369,19703,25518,209993,184475,No
KSIT,Computer Science and Engineering,COMEDK,2023,196047,84013,18396,25239,323695,298456,Yes
AEC,Aerospace Engineering,KCET,2024,58118,89666,15023,17711,180518,162807,No
UVCE,Computer Science and Engineering,COMEDK,2023,236692,88815,8633,19844,353984,334140,No
AEC,Mechanical Engineering,KCET,2024,79037,72364,14598,17627,183626,165999,Yes
BMSIT,Electrical and Electronics Engineering,COMEDK,2023,173142,64293,10958,24125,272518,248393,Yes
KLSGIT,Electrical and Electronics Engineering,COMEDK,2024,248306,87278,16015,22479,374078,351599,Yes
UVCE,Aerospace Engineering,KCET,2024,75177,77847,8026,21151,182201,161050,No
KLSGIT,Mechanical Engineering,COMEDK,2023,218990,69601,17283,23829,329703,305874,Yes
GMIT,Civil Engineering,KCET,2024,63106,79158,12656,12021,166941,154920,Yes
DrAIT,Artificial Intelligence and Data Science,KCET,2024,51518,91867,10533,19474,173392,153918,Yes
JIT,Artificial Intelligence and Data Science,COMEDK,2023,247446,72837,18710,29488,368481,338993,Yes
DSATM,Data Science,COMEDK,2023,228547,63521,10167,14996,317231,302235,No
MVJCE,Data Science,KCET,2023,54156,68180,13093,11274,146703,135429,Yes
DBIT,Aerospace Engineering,KCET,2023,58367,92612,15946,13413,180338,166925,No
BMSCE,Electronics and Communication Engineering,KCET,2023,77446,69057,18957,20507,185967,165460,No
MVJCE,Mechanical Engineering,KCET,2023,66771,71571,11960,26280,176582,150302,No
GMIT,Computer Science and Engineering,KCET,2024,51514,88391,16533,21055,177493,156438,No
VemanaIT,Robotics and Automation Engineering,COMEDK,2024,208022,65346,8967,26704,309039,282335,Yes
DSATM,Computer Science and Engineering,COMEDK,2023,244704,78031,15537,29551,367823,338272,No
BMSIT,Aerospace Engineering,KCET,2023,63951,62073,11661,13852,151537,137685,Yes
NHCE,Chemical Engineering,KCET,2024,77386,71864,14466,16788,180504,163716,No
KLSGIT,Aerospace Engineering,COMEDK,2023,237333,94550,17848,18707,368438,349731,No
SIT,Data Science,KCET,2024,58707,73961,9224,13183,155075,141892,Yes
CITGubbi,Data Science,COMEDK,2024,199656,74735,14389,17989,306769,288780,Yes
VIT,Electrical and Electronics Engineering,KCET,2023,59910,93939,9751,23954,187554,163600,Yes
EastPoint,Robotics and Automation Engineering,KCET,2023,84784,91330,9746,10855,196715,185860,No
DSCE,Artificial Intelligence and Data Science,KCET,2023,54919,81266,17714,18260,172159,153899,No
PESCE,Mechanical Engineering,KCET,2023,59225,87183,15688,11055,173151,162096,Yes
REVA,Chemical Engineering,COMEDK,2024,227950,78766,8313,25978,341007,315029,No
GMIT,Artificial Intelligence and Data Science,COMEDK,2023,195636,82753,17102,22300,317791,295491,Yes
KLSGIT,Data Science,KCET,2023,58913,61539,16912,10721,148085,137364,No
CMRIT,Data Science,KCET,2024,80437,85741,12837,25731,204746,179015,Yes
SDMCET,Data Science,KCET,2024,81932,73828,13681,17526,186967,169441,Yes
BNMIT,Computer Science and Engineering,KCET,2024,62578,73649,8195,20487,164909,144422,Yes
AITM,Biotechnology,KCET,2024,59224,63795,16573,13612,153204,139592,Yes
RVCE,Artificial Intelligence and Data Science,KCET,2023,75464,60558,15362,16265,167649,151384,No
RVCE,Chemical Engineering,KCET,2024,80689,73511,17314,21441,192955,171514,No
SDMIT,Electronics and Communication Engineering,KCET,2023,74115,81277,14921,27179,197492,170313,Yes
AEC,Data Science,COMEDK,2024,204429,66160,18248,15520,304357,288837,Yes
ACU,Information Science and Engineering,COMEDK,2024,167545,73622,12619,20545,274331,253786,No
AITM,Information Science and Engineering,KCET,2024,72857,74391,12735,23080,183063,159983,Yes
CITGubbi,Robotics and Automation Engineering,KCET,2023,62876,85222,19918,14378,182394,168016,Yes
BITM,Aerospace Engineering,KCET,2024,62359,85137,13287,21393,182176,160783,No
VVCE,Artificial Intelligence and Data Science,COMEDK,2023,178074,76264,16092,25651,296081,270430,Yes
BMSIT,Civil Engineering,COMEDK,2024,244753,78763,19848,28768,372132,343364,No
SJBIT,Aerospace Engineering,COMEDK,2023,249051,62522,14413,25678,351664,325986,Yes
RVCE,Robotics and Automation Engineering,KCET,2023,66056,66487,9075,15132,156750,141618,No
VSM,Aerospace Engineering,KCET,2024,76288,60412,10792,21789,169281,147492,No
YKCE,Mechanical Engineering,COMEDK,2023,172790,61869,9823,23160,267642,244482,No
CMRIT,Data Science,COMEDK,2024,186307,63118,9892,28328,287645,259317,No
VemanaIT,Robotics and Automation Engineering,KCET,2023,63015,63018,14209,27489,167731,140242,Yes
VSM,Data Science,COMEDK,2023,199670,90258,14613,29774,334315,304541,No
BITM,Chemical Engineering,KCET,2023,69930,90421,12931,11039,184321,173282,Yes
JSSSTU,Data Science,COMEDK,2024,206803,77573,14605,17086,316067,298981,Yes
VSM,Robotics and Automation Engineering,KCET,2023,74337,74402,14797,25505,189041,163536,Yes
BMIT,Data Science,COMEDK,2023,237409,77741,14955,24830,354935,330105,No
MSRIT,Electronics and Communication Engineering,KCET,2023,65057,86623,12939,16499,181118,164619,No
VVCE,Biotechnology,KCET,2024,77324,86176,14481,25653,203634,177981,Yes
MVJCE,Biotechnology,KCET,2024,81371,70700,19013,18781,189865,171084,Yes
SIT,Electrical and Electronics Engineering,KCET,2024,59270,88208,14619,26910,189007,162097,No
AITM,Biotechnology,KCET,2023,50612,60327,13810,13486,138235,124749,No
VVIT,Data Science,COMEDK,2023,218297,92556,13800,18019,342672,324653,Yes
AITM,Chemical Engineering,COMEDK,2023,245048,68682,17510,21886,353126,331240,No
AITM,Electronics and Communication Engineering,COMEDK,2024,202311,63279,18303,29032,312925,283893,No
KSIT,Artificial Intelligence and Data Science,COMEDK,2023,175415,86365,17229,17379,296388,279009,Yes
GMIT,Chemical Engineering,KCET,2023,72923,73041,10840,28629,185433,156804,Yes
SITM,Computer Science and Engineering,COMEDK,2024,224715,73559,13386,12346,324006,311660,Yes
SITM,Chemical Engineering,COMEDK,2024,220440,72968,18117,20141,331666,311525,Yes
VSM,Computer Science and Engineering,COMEDK,2024,211840,76900,8510,27822,325072,297250,Yes
BNMIT,Biotechnology,COMEDK,2024,174086,61726,12172,26386,274370,247984,No
CITGubbi,Biotechnology,COMEDK,2023,230687,85811,16270,21430,354198,332768,No
KSIT,Robotics and Automation Engineering,KCET,2024,80643,68259,18475,29343,196720,167377,No
NMIT,Civil Engineering,COMEDK,2023,194312,88662,13804,18633,315411,296778,Yes
AECMandya,Data Science,KCET,2023,80935,92586,17933,28469,219923,191454,No
YKCE,Data Science,KCET,2024,59768,62871,8373,29950,160962,131012,No
SIT,Robotics and Automation Engineering,KCET,2024,84221,62436,17709,11310,175676,164366,Yes
VemanaIT,Aerospace Engineering,KCET,2023,71389,87177,18419,25081,202066,176985,No
VSM,Artificial Intelligence and Data Science,COMEDK,2024,175438,85228,16413,19846,296925,277079,No
KLSGIT,Computer Science and Engineering,KCET,2024,60578,77564,18547,24860,181549,156689,No
DrAIT,Civil Engineering,KCET,2023,80917,79593,17086,18041,195637,177596,Yes
SJBIT,Robotics and Automation Engineering,COMEDK,2023,195019,86031,11192,18418,310660,292242,No
ACU,Aerospace Engineering,KCET,2024,51612,62478,12401,18173,144664,126491,Yes
VIT,Electrical and Electronics Engineering,KCET,2024,59572,78519,19240,20332,177663,157331,Yes
AITM,Artificial Intelligence and Data Science,COMEDK,2024,197266,88495,18565,15869,320195,304326,No
SCEM,Computer Science and Engineering,KCET,2024,57975,93044,15685,17611,184315,166704,No
RAIT,Data Science,KCET,2023,71496,83238,11113,18277,184124,165847,Yes
CITGubbi,Chemical Engineering,KCET,2024,66798,86973,12946,13263,179980,166717,No
BIT,Computer Science and Engineering,COMEDK,2024,163944,94597,13480,24974,296995,272021,No
SJBIT,Data Science,KCET,2024,81452,77456,19967,10346,189221,178875,No
RIT,Electronics and Communication Engineering,COMEDK,2024,228885,76301,13254,23448,341888,318440,No
BNMIT,Robotics and Automation Engineering,COMEDK,2024,178242,81821,16047,10141,286251,276110,Yes
VemanaIT,Mechanical Engineering,COMEDK,2024,167325,87816,17018,12347,284506,272159,No
MVJCE,Biotechnology,COMEDK,2024,184745,85724,13963,22473,306905,284432,No
YKCE,Mechanical Engineering,KCET,2023,58391,68075,9608,22545,158619,136074,No
KLSGIT,Chemical Engineering,KCET,2023,55552,90162,16037,28302,190053,161751,Yes
NHCE,Aerospace Engineering,KCET,2024,52975,79632,8756,14789,156152,141363,Yes
DrAIT,Civil Engineering,COMEDK,2024,198052,88260,18762,25951,331025,305074,No
BIT,Electrical and Electronics Engineering,KCET,2023,67538,77198,16839,15997,177572,161575,Yes
MSRIT,Civil Engineering,COMEDK,2024,236024,62813,15082,24956,338875,313919,No
SCEM,Computer Science and Engineering,COMEDK,2023,171955,82046,14347,11029,279377,268348,No
RAIT,Data Science,COMEDK,2023,193566,72422,16585,21890,304463,282573,No
PESCE,Computer Science and Engineering,KCET,2024,61515,60224,15122,26103,162964,136861,No
VIT,Aerospace Engineering,KCET,2024,84698,73493,9618,20565,188374,167809,Yes
PRES,Computer Science and Engineering,KCET,2023,84329,79755,17723,10932,192739,181807,No
RVCE,Electrical and Electronics Engineering,KCET,2023,52101,64133,11389,29372,156995,127623,Yes
GIT,Electronics and Communication Engineering,COMEDK,2024,191233,91899,16847,28625,328604,299979,Yes
VVIT,Aerospace Engineering,KCET,2023,67785,89162,19645,25083,201675,176592,Yes
JIT,Electronics and Communication Engineering,COMEDK,2024,214918,72122,12051,10604,309695,299091,Yes
SDMIT,Electronics and Communication Engineering,COMEDK,2024,247938,77828,9599,23330,358695,335365,Yes
MSRUAS,Data Science,KCET,2024,76999,91482,14702,14387,197570,183183,No
VVCE,Civil Engineering,KCET,2023,53856,69865,9201,15102,148024,132922,No
AECMandya,Artificial Intelligence and Data Science,COMEDK,2023,224976,82960,13274,12099,333309,321210,No
YKCE,Civil Engineering,KCET,2024,74255,88117,16753,14174,193299,179125,No
DSCE,Aerospace Engineering,KCET,2024,73835,66829,14370,14841,169875,155034,Yes
PESU,Electrical and Electronics Engineering,KCET,2024,69141,81298,19559,14944,184942,169998,Yes
VemanaIT,Information Science and Engineering,KCET,2024,83504,83426,15782,21777,204489,182712,Yes
VSM,Computer Science and Engineering,KCET,2024,62662,69798,17936,16404,166800,150396,No
MVJCE,Information Science and Engineering,KCET,2024,61434,73556,17945,14884,167819,152935,No
VIT,Civil Engineering,COMEDK,2023,241203,80698,8448,15992,346341,330349,Yes
JNNCE,Computer Science and Engineering,COMEDK,2024,187591,69843,8803,20460,286697,266237,No
DBIT,Information Science and Engineering,COMEDK,2023,161760,86320,9524,27606,285210,257604,No
SDMCET,Chemical Engineering,COMEDK,2023,227896,68950,11354,28357,336557,308200,Yes
ACU,Mechanical Engineering,KCET,2023,79172,68478,17088,21895,186633,164738,Yes
VVCE,Artificial Intelligence and Data Science,KCET,2023,74205,63110,11772,13678,162765,149087,Yes
CITGubbi,Chemical Engineering,KCET,2024,65648,81485,14142,17525,178800,161275,Yes
ACU,Computer Science and Engineering,COMEDK,2023,169768,75812,13153,24306,283039,258733,Yes
SITM,Mechanical Engineering,KCET,2024,62122,84268,8692,26172,181254,155082,Yes
BMSIT,Information Science and Engineering,COMEDK,2023,198338,94749,13817,25638,332542,306904,No
PESU,Biotechnology,COMEDK,2024,166158,94998,13295,14566,289017,274451,Yes
KLSGIT,Chemical Engineering,COMEDK,2024,201734,82427,11142,27188,322491,295303,No
VIT,Robotics and Automation Engineering,KCET,2024,61666,67211,11290,21169,161336,140167,Yes
VSM,Robotics and Automation Engineering,KCET,2023,72808,67727,10788,28119,179442,151323,No
AEC,Chemical Engineering,KCET,2023,74533,61693,11171,24581,171978,147397,No
VVCE,Information Science and Engineering,KCET,2023,54453,71314,16055,14325,156147,141822,No
DSCE,Robotics and Automation Engineering,KCET,2023,81266,76263,16290,12272,186091,173819,No
YKCE,Biotechnology,KCET,2024,83563,65912,15649,18798,183922,165124,Yes
SJBCE,Robotics and Automation Engineering,KCET,2023,52111,91297,12751,15884,172043,156159,Yes
NCET,Data Science,KCET,2024,78546,65359,13767,18700,176372,157672,No
CITGubbi,Robotics and Automation Engineering,COMEDK,2023,236518,74189,14753,17495,342955,325460,No
SJBIT,Civil Engineering,COMEDK,2024,246431,84485,19197,10299,360412,350113,No
AIT,Civil Engineering,COMEDK,2023,187271,93732,9727,23381,314111,290730,No
DSCE,Civil Engineering,COMEDK,2024,240667,82903,15698,18929,358197,339268,No
YKCE,Computer Science and Engineering,COMEDK,2023,168092,76817,11294,23551,279754,256203,Yes
SIT,Aerospace Engineering,KCET,2023,61301,76525,19093,15040,171959,156919,No
JNNCE,Biotechnology,COMEDK,2024,203535,79632,11837,28746,323750,295004,Yes
NCET,Data Science,KCET,2024,62658,63152,19573,11289,156672,145383,Yes
MSRIT,Electronics and Communication Engineering,COMEDK,2023,174646,68057,17613,18893,279209,260316,Yes
JIT,Computer Science and Engineering,KCET,2023,70281,66318,11788,26497,174884,148387,Yes
PESU,Mechanical Engineering,KCET,2024,50088,72970,16334,26222,165614,139392,Yes
NIE,Computer Science and Engineering,COMEDK,2024,244478,92128,8078,12022,356706,344684,No
BMSCE,Data Science,COMEDK,2023,249676,62408,18984,16980,348048,331068,Yes
CITGubbi,Chemical Engineering,KCET,2023,53409,75082,9737,21625,159853,138228,No
BITM,Data Science,KCET,2023,76640,93654,12323,22607,205224,182617,No
CITGubbi,Artificial Intelligence and Data Science,COMEDK,2023,240298,94358,19128,23998,377782,353784,No
JSSSTU,Artificial Intelligence and Data Science,KCET,2023,69177,62534,10481,28025,170217,142192,No
MSRUAS,Mechanical Engineering,COMEDK,2023,182843,65539,19227,10936,278545,267609,No
HKBK,Computer Science and Engineering,KCET,2023,69799,67281,14642,12971,164693,151722,Yes
CMRIT,Electrical and Electronics Engineering,KCET,2023,57415,65243,19070,13513,155241,141728,No
NIE,Mechanical Engineering,KCET,2024,71587,93041,8299,18067,190994,172927,No
SJBIT,Information Science and Engineering,COMEDK,2024,232839,69608,19253,21706,343406,321700,Yes
NHCE,Robotics and Automation Engineering,COMEDK,2024,223518,94696,9021,14743,341978,327235,Yes
VVCE,Electronics and Communication Engineering,COMEDK,2023,189163,61313,15718,10729,276923,266194,Yes
VVCE,Biotechnology,COMEDK,2024,207693,91908,12901,22779,335281,312502,Yes
ACU,Aerospace Engineering,KCET,2024,64768,91843,18820,14358,189789,175431,Yes
SDMIT,Biotechnology,COMEDK,2023,235175,86601,15332,28173,365281,337108,No
PESU,Artificial Intelligence and Data Science,KCET,2023,59243,88193,18028,10523,175987,165464,Yes
JIT,Biotechnology,COMEDK,2023,189970,78261,15269,21597,305097,283500,Yes
NIE,Electronics and Communication Engineering,KCET,2024,53206,73065,18039,21749,166059,144310,Yes
DSCE,Data Science,KCET,2023,67924,72660,16977,22084,179645,157561,Yes
REVA,Data Science,COMEDK,2024,168124,81917,18626,11273,279940,268667,No
AITM,Mechanical Engineering,COMEDK,2024,209600,75273,19865,25194,329932,304738,No
YKCE,Artificial Intelligence and Data Science,COMEDK,2024,215017,77747,10798,12721,316283,303562,No
GMIT,Electronics and Communication Engineering,KCET,2023,61058,91783,15136,23984,191961,167977,No
PRES,Chemical Engineering,KCET,2023,55575,68327,14265,13391,151558,138167,Yes
KSIT,Aerospace Engineering,KCET,2024,62088,65826,11636,14826,154376,139550,No
DBIT,Computer Science and Engineering,COMEDK,2024,234150,90941,15463,10376,350930,340554,No
RAIT,Mechanical Engineering,KCET,2023,68732,80406,17525,29457,196120,166663,No
REVA,Computer Science and Engineering,KCET,2023,66628,80236,17447,23730,188041,164311,Yes
JSSSTU,Robotics and Automation Engineering,KCET,2024,75106,63619,17237,10921,166883,155962,No
ACU,Electrical and Electronics Engineering,KCET,2023,63147,78010,18397,10318,169872,159554,No
VSM,Computer Science and Engineering,COMEDK,2023,190904,67783,16819,18125,293631,275506,Yes
VVCE,Aerospace Engineering,KCET,2024,50130,85033,17548,10359,163070,152711,Yes
PESU,Artificial Intelligence and Data Science,KCET,2023,65246,82121,10402,10565,168334,157769,Yes
SJBIT,Electrical and Electronics Engineering,KCET,2024,59900,92209,13933,15797,181839,166042,Yes
RVUNIV,Robotics and Automation Engineering,KCET,2023,66888,73046,12387,11337,163658,152321,Yes
AITM,Electronics and Communication Engineering,KCET,2024,54070,61305,11405,17003,143783,126780,Yes
HKBK,Robotics and Automation Engineering,KCET,2023,83404,94619,18665,27506,224194,196688,Yes
PRES,Computer Science and Engineering,COMEDK,2024,176877,71176,19747,27480,295280,267800,No
PESCE,Mechanical Engineering,COMEDK,2024,233660,67150,14941,15176,330927,315751,Yes
CITGubbi,Mechanical Engineering,KCET,2023,67966,79268,15519,24045,186798,162753,No
GMIT,Aerospace Engineering,KCET,2024,83759,89813,15913,28377,217862,189485,No
BIT,Electronics and Communication Engineering,COMEDK,2023,214413,91203,16607,12235,334458,322223,No
ACU,Electronics and Communication Engineering,KCET,2024,57314,83033,18153,26347,184847,158500,Yes
CITGubbi,Artificial Intelligence and Data Science,COMEDK,2024,183376,74692,16037,21874,295979,274105,Yes
PESCE,Computer Science and Engineering,COMEDK,2024,215229,94409,19200,13161,341999,328838,No
RNSIT,Artificial Intelligence and Data Science,COMEDK,2024,215419,82144,15408,11460,324431,312971,No
MSRUAS,Artificial Intelligence and Data Science,COMEDK,2024,172421,73258,9456,11284,266419,255135,Yes
SDMCET,Mechanical Engineering,KCET,2024,74480,76960,11981,14219,177640,163421,No
AEC,Chemical Engineering,KCET,2023,70166,65624,19796,25220,180806,155586,No
RNSIT,Information Science and Engineering,KCET,2024,53835,84314,14715,29382,182246,152864,No
MVJCE,Electronics and Communication Engineering,COMEDK,2024,244023,67914,12734,13160,337831,324671,Yes
EastPoint,Data Science,KCET,2024,57530,92011,10728,15121,175390,160269,Yes
NHCE,Data Science,COMEDK,2023,197170,63261,13743,16231,290405,274174,Yes
CMRIT,Civil Engineering,KCET,2023,70658,82901,9502,26202,189263,163061,Yes
HKBK,Biotechnology,KCET,2023,59986,89002,8819,11289,169096,157807,No
SCEM,Civil Engineering,COMEDK,2024,216867,80372,11746,27300,336285,308985,No
PESU,Civil Engineering,COMEDK,2023,222570,86987,8011,14364,331932,317568,No
RAIT,Electrical and Electronics Engineering,KCET,2023,65243,73445,18240,13685,170613,156928,Yes
BMSIT,Civil Engineering,KCET,2024,61661,80051,15748,23899,181359,157460,No
JNNCE,Electrical and Electronics Engineering,KCET,2023,63640,67510,16155,17198,164503,147305,No
KLEIT,Civil Engineering,KCET,2024,72217,90507,11046,27289,201059,173770,Yes
VVCE,Artificial Intelligence and Data Science,COMEDK,2024,249295,82930,17622,23468,373315,349847,Yes
YKCE,Biotechnology,KCET,2023,70626,91292,14796,14565,191279,176714,Yes
ACU,Mechanical Engineering,KCET,2023,68928,81507,16777,15352,182564,167212,No
KLSGIT,Information Science and Engineering,KCET,2023,62789,73538,12340,11171,159838,148667,No
GMIT,Electrical and Electronics Engineering,KCET,2024,70718,89765,18393,11510,190386,178876,Yes
SDMIT,Data Science,COMEDK,2023,163636,82793,17670,20239,284338,264099,No
AITM,Data Science,KCET,2024,78590,63807,14596,21799,178792,156993,No
DrAIT,Mechanical Engineering,KCET,2023,81658,72887,18934,11856,185335,173479,Yes
DBIT,Robotics and Automation Engineering,COMEDK,2024,201355,84023,12585,24660,322623,297963,Yes
VVCE,Chemical Engineering,COMEDK,2023,207650,70685,9242,28791,316368,287577,Yes
GMIT,Electrical and Electronics Engineering,KCET,2023,72406,73960,8843,13292,168501,155209,No
VIT,Computer Science and Engineering,COMEDK,2024,182022,81998,12075,25333,301428,276095,Yes
YKCE,Electrical and Electronics Engineering,KCET,2024,80471,89203,8588,29458,207720,178262,No
SITM,Computer Science and Engineering,COMEDK,2024,196011,88284,18124,24226,326645,302419,No
AEC,Data Science,KCET,2023,58754,63160,19099,24932,165945,141013,No
CMRIT,Robotics and Automation Engineering,COMEDK,2024,227795,78429,8117,20793,335134,314341,No
DSCE,Mechanical Engineering,COMEDK,2024,193149,94899,14202,24846,327096,302250,Yes
DSATM,Aerospace Engineering,KCET,2023,53378,91846,9105,23081,177410,154329,Yes
VemanaIT,Mechanical Engineering,KCET,2024,53563,65921,8666,16624,144774,128150,No
REVA,Chemical Engineering,COMEDK,2023,235154,88266,18174,12949,354543,341594,Yes
SDMIT,Biotechnology,KCET,2023,60664,76798,14801,18128,170391,152263,Yes
RVCE,Civil Engineering,KCET,2023,75923,75084,14966,27733,193706,165973,No
JIT,Mechanical Engineering,KCET,2023,66566,60263,19271,15730,161830,146100,Yes
VVIT,Robotics and Automation Engineering,COMEDK,2024,172585,69927,14102,20145,276759,256614,Yes
SITM,Robotics and Automation Engineering,COMEDK,2023,236728,79866,11840,21694,350128,328434,Yes
DrAIT,Data Science,COMEDK,2023,238495,68693,19788,16933,343909,326976,Yes
NCET,Chemical Engineering,COMEDK,2023,172610,79335,8973,13474,274392,260918,No
CMRIT,Information Science and Engineering,KCET,2023,65705,87402,16215,21773,191095,169322,No
SDMCET,Data Science,COMEDK,2023,228776,87441,18527,25646,360390,334744,Yes
PESCE,Electronics and Communication Engineering,COMEDK,2024,239873,94860,13967,29593,378293,348700,No
SCEM,Artificial Intelligence and Data Science,KCET,2023,64877,81831,13115,19409,179232,159823,No
GMIT,Robotics and Automation Engineering,COMEDK,2023,160879,61576,19477,21542,263474,241932,No
BMSIT,Mechanical Engineering,COMEDK,2024,182842,83156,12947,10944,289889,278945,Yes
VemanaIT,Aerospace Engineering,KCET,2024,73798,63613,14432,22167,174010,151843,No
BMSCE,Mechanical Engineering,COMEDK,2023,187406,85512,14517,12653,300088,287435,Yes
RNSIT,Artificial Intelligence and Data Science,KCET,2023,53807,76071,9279,20121,159278,139157,No
SJBCE,Chemical Engineering,KCET,2023,58920,60375,18322,21591,159208,137617,Yes
VemanaIT,Chemical Engineering,KCET,2023,57541,81952,9240,28624,177357,148733,No
JIT,Robotics and Automation Engineering,COMEDK,2023,212231,66003,10037,23058,311329,288271,Yes
KSIT,Robotics and Automation Engineering,COMEDK,2024,193068,65431,8506,23595,290600,267005,No
YKCE,Electrical and Electronics Engineering,KCET,2024,51033,82333,10074,11498,154938,143440,No
VIT,Civil Engineering,COMEDK,2023,226785,87472,14437,23270,351964,328694,Yes
KSIT,Data Science,COMEDK,2023,212545,65577,16241,21608,315971,294363,No
SJBCE,Data Science,COMEDK,2024,218325,62753,9078,16932,307088,290156,Yes
RNSIT,Biotechnology,COMEDK,2023,248393,94882,16565,29764,389604,359840,Yes
RIT,Electrical and Electronics Engineering,COMEDK,2023,173173,65710,18163,27223,284269,257046,No
JNNCE,Information Science and Engineering,COMEDK,2024,167228,76403,10175,20457,274263,253806,Yes
RIT,Chemical Engineering,COMEDK,2023,184395,73629,9882,21561,289467,267906,No
JNNCE,Information Science and Engineering,KCET,2023,68479,93884,17770,28440,208573,180133,Yes
BMSIT,Electrical and Electronics Engineering,COMEDK,2024,199102,82207,15106,25075,321490,296415,No
PESCE,Electronics and Communication Engineering,KCET,2023,54824,62183,15582,12910,145499,132589,No
RVCE,Computer Science and Engineering,COMEDK,2024,240955,92250,18983,24267,376455,352188,No
REVA,Artificial Intelligence and Data Science,KCET,2023,67898,88077,16784,24360,197119,172759,No
PESU,Information Science and Engineering,KCET,2024,82637,78379,12894,17589,191499,173910,No
BMIT,Electronics and Communication Engineering,COMEDK,2024,162690,69047,8615,29435,269787,240352,Yes
YKCE,Information Science and Engineering,KCET,2024,56257,89519,8532,24896,179204,154308,No
SIT,Chemical Engineering,COMEDK,2024,232350,67271,19852,17392,336865,319473,Yes
SDMCET,Civil Engineering,COMEDK,2024,211325,65556,18329,21318,316528,295210,No
SITM,Aerospace Engineering,KCET,2024,53467,75188,9669,10428,148752,138324,No
RVUNIV,Biotechnology,KCET,2023,73529,92120,19898,21668,207215,185547,No
AECMandya,Computer Science and Engineering,COMEDK,2023,232146,63456,17822,13126,326550,313424,No
SITM,Robotics and Automation Engineering,KCET,2023,69911,68189,8564,10742,157406,146664,Yes
JSSSTU,Mechanical Engineering,KCET,2024,71193,66061,15336,27833,180423,152590,No
SJBCE,Robotics and Automation Engineering,KCET,2024,68014,67993,19828,26018,181853,155835,Yes
RIT,Civil Engineering,KCET,2024,65873,68807,8234,24847,167761,142914,No
CMRIT,Data Science,KCET,2024,65775,68530,13797,21481,169583,148102,Yes
RIT,Aerospace Engineering,COMEDK,2024,178998,76176,9978,23415,288567,265152,Yes
CMRIT,Mechanical Engineering,COMEDK,2023,239665,86321,19005,24993,369984,344991,No
JNNCE,Computer Science and Engineering,COMEDK,2023,234211,68660,14449,26803,344123,317320,Yes
VIT,Computer Science and Engineering,COMEDK,2024,212793,85633,16511,18903,333840,314937,No
JNNCE,Aerospace Engineering,KCET,2023,56741,86730,9384,28191,181046,152855,No
NCET,Chemical Engineering,COMEDK,2024,231917,77015,15612,19701,344245,324544,Yes
VVIT,Data Science,KCET,2023,75386,80541,16419,21912,194258,172346,Yes
UVCE,Computer Science and Engineering,KCET,2023,75399,69107,18838,24111,187455,163344,Yes
SDMIT,Data Science,COMEDK,2023,237414,80669,9328,12151,339562,327411,Yes
SIT,Chemical Engineering,COMEDK,2024,244735,71031,12679,10487,338932,328445,Yes
ACU,Electrical and Electronics Engineering,COMEDK,2023,169655,91892,15578,27540,304665,277125,Yes
SJBCE,Biotechnology,KCET,2023,57132,75659,11814,18281,162886,144605,Yes
RAIT,Information Science and Engineering,COMEDK,2024,168173,88890,8343,20129,285535,265406,No
HKBK,Civil Engineering,KCET,2023,55529,82997,12465,11621,162612,150991,No
ACU,Biotechnology,KCET,2024,60536,71994,18627,15631,166788,151157,Yes
SCEM,Mechanical Engineering,COMEDK,2024,167523,94258,12015,24107,297903,273796,Yes
SJBIT,Information Science and Engineering,KCET,2023,55794,73430,17466,28269,174959,146690,No
NHCE,Chemical Engineering,COMEDK,2023,237407,70437,16113,10399,334356,323957,No
SIT,Biotechnology,KCET,2023,75950,73133,17035,25498,191616,166118,No
GMIT,Information Science and Engineering,KCET,2023,67783,87945,15439,12814,183981,171167,No
BMSCE,Artificial Intelligence and Data Science,COMEDK,2023,202984,88214,16261,19536,326995,307459,No
SJBCE,Electrical and Electronics Engineering,KCET,2024,72291,78418,11505,11576,173790,162214,No
RNSIT,Civil Engineering,KCET,2024,66967,85477,12169,25866,190479,164613,Yes
PESU,Data Science,COMEDK,2024,179296,91603,13623,26954,311476,284522,Yes
NHCE,Aerospace Engineering,KCET,2023,67551,63534,8300,16657,156042,139385,No
KLSGIT,Electrical and Electronics Engineering,COMEDK,2024,242006,66198,18115,17972,344291,326319,Yes
PESU,Robotics and Automation Engineering,KCET,2023,63961,94420,14023,13729,186133,172404,Yes
SJBCE,Mechanical Engineering,COMEDK,2023,192139,85264,9056,27124,313583,286459,No
DSCE,Civil Engineering,KCET,2023,61854,87062,8641,12175,169732,157557,No
AIT,Chemical Engineering,KCET,2024,78043,72087,11006,22737,183873,161136,Yes
NHCE,Mechanical Engineering,KCET,2024,80699,81799,16330,25994,204822,178828,No
BNMIT,Electrical and Electronics Engineering,COMEDK,2023,240048,73619,14511,22700,350878,328178,Yes
GMIT,Information Science and Engineering,KCET,2024,83717,67304,12337,23462,186820,163358,No
UVCE,Robotics and Automation Engineering,COMEDK,2024,169816,93718,9906,29500,302940,273440,No
BITM,Mechanical Engineering,KCET,2024,52085,81066,9435,11664,154250,142586,Yes
NIE,Computer Science and Engineering,KCET,2024,61447,76466,13272,19463,170648,151185,Yes
VIT,Robotics and Automation Engineering,KCET,2024,69697,69592,17598,29360,186247,156887,Yes
CITGubbi,Information Science and Engineering,COMEDK,2024,230025,62127,18619,26113,336884,310771,No
EastPoint,Robotics and Automation Engineering,KCET,2023,79255,92092,10281,27937,209565,181628,Yes
BMSCE,Data Science,KCET,2023,72707,66899,17216,15943,172765,156822,Yes
NIE,Electronics and Communication Engineering,COMEDK,2023,235365,82204,10356,17767,345692,327925,No
NMIT,Electrical and Electronics Engineering,KCET,2023,72435,61247,14656,19151,167489,148338,No
YKCE,Biotechnology,KCET,2023,72754,82302,14714,26486,196256,169770,Yes
VIT,Biotechnology,COMEDK,2023,204033,71676,11715,11775,299199,287424,No
JIT,Computer Science and Engineering,COMEDK,2024,214256,69346,12139,29777,325518,295741,Yes
PESCE,Information Science and Engineering,KCET,2023,80497,60856,18145,11223,170721,159498,Yes
GIT,Electrical and Electronics Engineering,KCET,2023,57971,81133,11639,24934,175677,150743,Yes
SCEM,Data Science,KCET,2023,55087,88559,13464,25043,182153,157110,No
PRES,Robotics and Automation Engineering,KCET,2023,77790,68504,10922,25057,182273,157216,No
SDMIT,Information Science and Engineering,KCET,2023,77235,80575,8636,20588,187034,166446,No
RNSIT,Electronics and Communication Engineering,KCET,2024,77759,68198,17895,10183,174035,163852,No
MSRIT,Civil Engineering,COMEDK,2024,206359,94970,11665,16671,329665,312994,No
MSRUAS,Data Science,KCET,2024,72371,74083,15981,15159,177594,162435,Yes
HKBK,Chemical Engineering,KCET,2023,54868,75903,17259,10718,158748,148030,Yes
NIE,Civil Engineering,COMEDK,2024,205893,92896,13590,26136,338515,312379,No
RNSIT,Electronics and Communication Engineering,KCET,2024,81347,87940,17265,26422,212974,186552,No
SITM,Electronics and Communication Engineering,KCET,2024,54058,70721,14762,15652,155193,139541,No
KSIT,Robotics and Automation Engineering,KCET,2023,78300,65363,11527,12762,167952,155190,No
DBIT,Civil Engineering,KCET,2023,83114,76971,14950,11178,186213,175035,No
CITGubbi,Computer Science and Engineering,COMEDK,2024,164683,73231,17527,11098,266539,255441,Yes
SDMIT,Information Science and Engineering,COMEDK,2023,208866,75707,19178,17832,321583,303751,No
VemanaIT,Electronics and Communication Engineering,COMEDK,2023,180779,65907,14863,29682,291231,261549,No
DrAIT,Data Science,KCET,2024,65725,66666,17373,25459,175223,149764,Yes
MSRUAS,Computer Science and Engineering,KCET,2024,56376,88033,15176,12331,171916,159585,Yes
BMSIT,Civil Engineering,KCET,2023,84507,68352,12367,20511,185737,165226,Yes
RAIT,Information Science and Engineering,COMEDK,2023,226548,88063,10039,10043,334693,324650,Yes
DSCE,Civil Engineering,COMEDK,2023,240704,70978,17010,20675,349367,328692,No
HKBK,Aerospace Engineering,KCET,2023,82115,61734,19829,14860,178538,163678,No
VSM,Mechanical Engineering,COMEDK,2024,203190,83155,12813,13607,312765,299158,No
RAIT,Chemical Engineering,KCET,2023,55299,91988,14417,20371,182075,161704,Yes
DrAIT,Chemical Engineering,COMEDK,2023,244354,80722,9084,18603,352763,334160,Yes
AIT,Robotics and Automation Engineering,KCET,2024,64244,67096,16285,22145,169770,147625,No
ACU,Artificial Intelligence and Data Science,KCET,2024,77242,72154,17949,29742,197087,167345,No
RVUNIV,Data Science,KCET,2024,54095,63449,11282,29141,157967,128826,Yes
JNNCE,Artificial Intelligence and Data Science,KCET,2024,54581,91399,15287,15855,177122,161267,No
RVUNIV,Information Science and Engineering,KCET,2024,51397,75707,15831,27826,170761,142935,No
YKCE,Computer Science and Engineering,COMEDK,2023,164640,65414,19614,23833,273501,249668,No
PESCE,Electronics and Communication Engineering,COMEDK,2023,173519,70336,11668,13911,269434,255523,No
SITM,Aerospace Engineering,KCET,2024,53010,65103,14779,11518,144410,132892,Yes
PESU,Information Science and Engineering,COMEDK,2023,160345,69872,16198,13569,259984,246415,Yes
ACU,Chemical Engineering,KCET,2024,62982,62474,11699,13677,150832,137155,Yes
CITGubbi,Data Science,COMEDK,2023,243333,88388,18473,25405,375599,350194,No
DrAIT,Chemical Engineering,KCET,2024,58994,84341,10366,23100,176801,153701,No
VemanaIT,Civil Engineering,KCET,2024,67860,93042,19819,22037,202758,180721,Yes
AIT,Information Science and Engineering,COMEDK,2024,161191,75900,15436,20530,273057,252527,No
VVCE,Biotechnology,KCET,2023,62031,77873,12887,21273,174064,152791,Yes
GMIT,Data Science,COMEDK,2024,171507,87575,8280,17557,284919,267362,No
SJBCE,Chemical Engineering,COMEDK,2023,194082,78600,14799,23670,311151,287481,Yes
RNSIT,Aerospace Engineering,KCET,2023,66169,72469,12585,18990,170213,151223,Yes
CITGubbi,Electronics and Communication Engineering,KCET,2023,65862,84102,10186,20272,180422,160150,Yes
BMIT,Artificial Intelligence and Data Science,KCET,2024,79597,61101,16731,26032,183461,157429,No
CMRIT,Aerospace Engineering,COMEDK,2024,175490,61793,16297,28175,281755,253580,Yes
BMSIT,Artificial Intelligence and Data Science,COMEDK,2023,245564,92775,16492,14632,369463,354831,No
DSCE,Information Science and Engineering,COMEDK,2024,226893,77522,18061,11046,333522,322476,Yes
RIT,Information Science and Engineering,KCET,2024,83671,71488,13326,28219,196704,168485,No
BIT,Aerospace Engineering,KCET,2024,83908,68862,19187,28780,200737,171957,No
VemanaIT,Mechanical Engineering,COMEDK,2024,211541,63671,17465,28999,321676,292677,Yes
VVIT,Data Science,COMEDK,2024,194472,62648,14222,26902,298244,271342,No
PRES,Chemical Engineering,KCET,2024,61567,70521,19848,26309,178245,151936,Yes
SDMCET,Biotechnology,COMEDK,2024,185323,82623,16587,11392,295925,284533,Yes
RVUNIV,Aerospace Engineering,COMEDK,2023,170308,66537,15767,23828,276440,252612,No
SDMIT,Data Science,COMEDK,2024,168388,82670,15989,12218,279265,267047,No
VemanaIT,Electronics and Communication Engineering,KCET,2024,64402,83570,18898,21275,188145,166870,No
AIT,Mechanical Engineering,COMEDK,2024,193558,79683,13645,23106,309992,286886,No
SJBCE,Biotechnology,COMEDK,2023,174412,82473,15653,17107,289645,272538,No
NIE,Electrical and Electronics Engineering,KCET,2024,80579,83735,10342,16340,190996,174656,Yes
SDMCET,Robotics and Automation Engineering,COMEDK,2023,204665,68877,19738,12799,306079,293280,No
VVCE,Computer Science and Engineering,COMEDK,2023,248976,81823,19712,24473,374984,350511,No
SJBIT,Artificial Intelligence and Data Science,COMEDK,2024,197751,66705,15424,23250,303130,279880,Yes
RAIT,Artificial Intelligence and Data Science,KCET,2024,58932,75788,15466,12761,162947,150186,No
AECMandya,Biotechnology,KCET,2023,56188,90248,17387,27209,191032,163823,Yes
SITM,Aerospace Engineering,KCET,2023,83488,64066,17426,12164,177144,164980,No
SJBIT,Chemical Engineering,KCET,2024,76448,62051,14483,15382,168364,152982,Yes
VVIT,Civil Engineering,KCET,2023,50160,76510,9169,11664,147503,135839,No
ACU,Artificial Intelligence and Data Science,KCET,2024,78164,70628,11260,23601,183653,160052,No
RAIT,Robotics and Automation Engineering,KCET,2024,52113,91776,15584,21116,180589,159473,Yes
VIT,Data Science,COMEDK,2024,189942,81000,11963,11650,294555,282905,No
PESU,Electrical and Electronics Engineering,COMEDK,2024,243508,93135,10851,11374,358868,347494,Yes
KLEIT,Chemical Engineering,KCET,2024,81749,67943,13345,25788,188825,163037,No
SIT,Artificial Intelligence and Data Science,KCET,2023,57434,88476,19833,15641,181384,165743,Yes
AEC,Mechanical Engineering,COMEDK,2024,195658,82418,16166,15593,309835,294242,Yes
BMSIT,Chemical Engineering,KCET,2024,71298,82616,14919,25334,194167,168833,No
AECMandya,Computer Science and Engineering,COMEDK,2024,178919,60192,16397,11438,266946,255508,No
PESU,Electrical and Electronics Engineering,KCET,2024,59575,80811,16357,16989,173732,156743,No
SJBCE,Chemical Engineering,KCET,2023,62772,77324,14493,15783,170372,154589,No
DrAIT,Artificial Intelligence and Data Science,KCET,2024,71095,61028,11286,29151,172560,143409,No
CMRIT,Electronics and Communication Engineering,KCET,2023,56352,62693,11576,15203,145824,130621,No
MSRUAS,Chemical Engineering,COMEDK,2023,245734,84339,17644,27358,375075,347717,Yes
SITM,Data Science,KCET,2023,51332,67611,15297,22592,156832,134240,Yes
YKCE,Electronics and Communication Engineering,KCET,2023,50807,83189,10675,25439,170110,144671,No
BNMIT,Aerospace Engineering,KCET,2024,72864,92975,13584,25143,204566,179423,No
DSCE,Data Science,COMEDK,2023,184275,64445,11035,20021,279776,259755,No
RVUNIV,Data Science,COMEDK,2023,207776,63633,15671,26608,313688,287080,No
RIT,Electrical and Electronics Engineering,KCET,2023,59567,76329,8508,24671,169075,144404,No
RVCE,Chemical Engineering,KCET,2024,80896,92243,10199,24026,207364,183338,Yes
AECMandya,Computer Science and Engineering,COMEDK,2024,205367,79808,8686,15363,309224,293861,No
CITGubbi,Computer Science and Engineering,KCET,2023,80109,86752,11124,14369,192354,177985,No
DSCE,Mechanical Engineering,KCET,2023,57206,86155,15040,10953,169354,158401,Yes
KSIT,Data Science,KCET,2024,53898,92815,16799,26798,190310,163512,No
NMIT,Data Science,KCET,2024,79864,73787,11422,27231,192304,165073,No
BIT,Data Science,COMEDK,2024,160925,79793,12404,22380,275502,253122,Yes
AITM,Civil Engineering,KCET,2023,50611,65892,13173,14138,143814,129676,No
PESU,Civil Engineering,COMEDK,2023,163614,80409,19167,29527,292717,263190,Yes
MSRIT,Information Science and Engineering,COMEDK,2024,197202,65557,16775,18531,298065,279534,Yes
AITM,Data Science,KCET,2023,74827,91062,9339,18150,193378,175228,Yes
BIT,Computer Science and Engineering,COMEDK,2023,233100,79319,19209,26448,358076,331628,No
PESU,Robotics and Automation Engineering,COMEDK,2023,173365,62789,17068,14809,268031,253222,No
KLEIT,Biotechnology,COMEDK,2024,185940,86826,18808,11229,302803,291574,Yes
CITGubbi,Chemical Engineering,COMEDK,2024,234756,68326,13072,25395,341549,316154,No
GMIT,Electronics and Communication Engineering,COMEDK,2024,226179,71531,13488,24565,335763,311198,No
NHCE,Mechanical Engineering,KCET,2023,83303,75093,19014,16303,193713,177410,No
KSIT,Biotechnology,KCET,2023,66503,71648,14199,20531,172881,152350,No
KSIT,Information Science and Engineering,KCET,2023,65569,74639,14958,25107,180273,155166,No
RVUNIV,Electronics and Communication Engineering,KCET,2023,53870,89739,17031,21635,182275,160640,Yes
SIT,Civil Engineering,COMEDK,2023,183891,80496,8042,26525,298954,272429,No
RVUNIV,Computer Science and Engineering,KCET,2023,84017,75018,13977,25089,198101,173012,No
NIE,Computer Science and Engineering,COMEDK,2023,230896,71006,8606,27571,338079,310508,Yes
NIE,Information Science and Engineering,KCET,2023,61243,80756,8987,17053,168039,150986,Yes
AECMandya,Chemical Engineering,COMEDK,2024,244835,60009,15030,11621,331495,319874,Yes
RVUNIV,Electronics and Communication Engineering,COMEDK,2024,215753,78438,19330,10989,324510,313521,No
CMRIT,Mechanical Engineering,KCET,2024,69989,75949,15897,17117,178952,161835,Yes
BMSCE,Chemical Engineering,COMEDK,2024,215393,79075,13522,29937,337927,307990,No
KSIT,Biotechnology,KCET,2023,54659,90594,15503,11869,172625,160756,No
VVCE,Information Science and Engineering,KCET,2023,61129,78396,9073,15908,164506,148598,Yes
CMRIT,Data Science,COMEDK,2024,182564,94034,14836,16303,307737,291434,No
HKBK,Civil Engineering,COMEDK,2024,222856,92358,10436,27990,353640,325650,No
RVUNIV,Robotics and Automation Engineering,KCET,2023,84229,68259,13974,19571,186033,166462,No
AECMandya,Aerospace Engineering,KCET,2023,57176,82059,9138,13904,162277,148373,Yes
DrAIT,Civil Engineering,KCET,2023,51875,63266,19622,16574,151337,134763,Yes
JIT,Biotechnology,KCET,2024,75416,63923,13043,27372,179754,152382,No
RIT,Civil Engineering,COMEDK,2024,201300,81873,13738,29713,326624,296911,Yes
DSATM,Civil Engineering,KCET,2024,54777,71105,9467,21405,156754,135349,Yes
PRES,Aerospace Engineering,KCET,2023,82769,61047,11309,22880,178005,155125,Yes
BMIT,Mechanical Engineering,KCET,2024,81531,69742,18569,13294,183136,169842,Yes
YKCE,Biotechnology,COMEDK,2024,167623,63001,17221,23028,270873,247845,No
RVCE,Chemical Engineering,KCET,2024,58404,86551,8192,23643,176790,153147,No
MSRIT,Electronics and Communication Engineering,KCET,2024,52934,92118,13666,16864,175582,158718,No
SITM,Artificial Intelligence and Data Science,COMEDK,2023,218755,75451,13813,26195,334214,308019,Yes
JSSSTU,Data Science,KCET,2024,53014,81497,12667,24122,171300,147178,Yes
NHCE,Computer Science and Engineering,COMEDK,2023,165961,92712,16882,24845,300400,275555,Yes
SDMCET,Electrical and Electronics Engineering,COMEDK,2023,161839,65012,8480,28187,263518,235331,No
EastPoint,Mechanical Engineering,KCET,2024,76501,77857,17614,19172,191144,171972,Yes
CMRIT,Artificial Intelligence and Data Science,COMEDK,2023,212109,86579,19266,26493,344447,317954,Yes
VVIT,Data Science,KCET,2023,78685,61384,9122,29876,179067,149191,No
ACU,Mechanical Engineering,COMEDK,2024,227232,76164,13579,12431,329406,316975,Yes
SDMIT,Biotechnology,COMEDK,2024,161023,64352,15252,16021,256648,240627,No
PRES,Electronics and Communication Engineering,COMEDK,2024,217389,91502,17603,25330,351824,326494,No
VemanaIT,Robotics and Automation Engineering,KCET,2023,79748,77713,11290,16253,185004,168751,Yes
BMIT,Artificial Intelligence and Data Science,COMEDK,2023,170086,70129,17918,20456,278589,258133,Yes
BMSIT,Information Science and Engineering,KCET,2023,77638,93870,12633,28522,212663,184141,No
RAIT,Electronics and Communication Engineering,KCET,2024,84749,62583,12394,13768,173494,159726,No
KLEIT,Mechanical Engineering,KCET,2024,60646,62895,9968,29481,162990,133509,No
RNSIT,Artificial Intelligence and Data Science,COMEDK,2024,174934,66905,18617,13114,273570,260456,Yes
BMIT,Artificial Intelligence and Data Science,KCET,2023,77870,85880,19496,24274,207520,183246,No
ACU,Information Science and Engineering,KCET,2023,64649,61425,15158,12519,153751,141232,Yes
SDMIT,Artificial Intelligence and Data Science,COMEDK,2023,212503,88322,12895,10841,324561,313720,No
NIE,Electronics and Communication Engineering,KCET,2023,65135,64315,8531,27365,165346,137981,Yes
SDMIT,Information Science and Engineering,COMEDK,2023,243903,75415,11790,12292,343400,331108,Yes
NMIT,Electronics and Communication Engineering,COMEDK,2023,231988,66075,10840,12493,321396,308903,No
RNSIT,Aerospace Engineering,KCET,2024,82629,66321,15045,16836,180831,163995,No
VIT,Electronics and Communication Engineering,COMEDK,2024,175322,75019,19782,26232,296355,270123,Yes
KLEIT,Aerospace Engineering,COMEDK,2023,216261,60611,13133,25065,315070,290005,Yes
BMSIT,Chemical Engineering,COMEDK,2024,239125,70827,10180,13613,333745,320132,Yes
RVCE,Computer Science and Engineering,KCET,2024,57886,80378,19731,10697,168692,157995,No
RAIT,Aerospace Engineering,COMEDK,2023,178532,77790,8518,14920,279760,264840,No
VVIT,Chemical Engineering,KCET,2023,84656,64930,19987,28061,197634,169573,No
UVCE,Electrical and Electronics Engineering,KCET,2024,74324,70840,9796,28913,183873,154960,No
MVJCE,Electronics and Communication Engineering,KCET,2024,72303,80132,18451,10919,181805,170886,No
REVA,Information Science and Engineering,KCET,2023,60261,69510,14603,19268,163642,144374,Yes
SCEM,Computer Science and Engineering,KCET,2023,69261,89119,18498,11286,188164,176878,Yes
ACU,Mechanical Engineering,KCET,2024,66834,81931,18101,24237,191103,166866,No
KSIT,Artificial Intelligence and Data Science,KCET,2023,53342,91671,17249,17227,179489,162262,Yes
BMSCE,Electrical and Electronics Engineering,COMEDK,2023,167797,73239,10035,21587,272658,251071,No
AITM,Robotics and Automation Engineering,KCET,2024,74279,78043,8805,12003,173130,161127,No
SDMCET,Civil Engineering,KCET,2024,65534,67419,9584,17696,160233,142537,No
BMSCE,Robotics and Automation Engineering,KCET,2024,62322,81869,11743,27210,183144,155934,No
SJBCE,Data Science,COMEDK,2024,214228,82533,8317,10019,315097,305078,Yes
SDMIT,Aerospace Engineering,COMEDK,2023,164067,67931,15581,17302,264881,247579,Yes
AITM,Electrical and Electronics Engineering,COMEDK,2023,184770,82502,19695,20369,307336,286967,Yes
BITM,Electrical and Electronics Engineering,KCET,2024,62326,83649,10883,11283,168141,156858,No
VVCE,Chemical Engineering,COMEDK,2024,226995,63487,18046,10451,318979,308528,Yes
BMIT,Aerospace Engineering,COMEDK,2024,217734,79006,9812,24097,330649,306552,No
NHCE,Civil Engineering,COMEDK,2024,240615,85454,16916,15172,358157,342985,No
HKBK,Robotics and Automation Engineering,COMEDK,2023,218358,65288,17018,28852,329516,300664,Yes
RIT,Artificial Intelligence and Data Science,COMEDK,2023,198335,68674,10140,26506,303655,277149,Yes
GIT,Civil Engineering,KCET,2023,69600,63025,19976,10219,162820,152601,No
JSSSTU,Electrical and Electronics Engineering,COMEDK,2023,169980,85228,8170,16016,279394,263378,No
SITM,Computer Science and Engineering,COMEDK,2024,230911,80434,9554,20178,341077,320899,Yes
BMSCE,Aerospace Engineering,KCET,2024,56635,85727,18581,18272,179215,160943,Yes
NHCE,Aerospace Engineering,COMEDK,2023,231365,86634,15271,14045,347315,333270,No
VemanaIT,Information Science and Engineering,COMEDK,2024,219474,71920,16501,10654,318549,307895,Yes
REVA,Civil Engineering,KCET,2023,54377,64181,10037,24305,152900,128595,Yes
AECMandya,Aerospace Engineering,KCET,2024,61448,60776,19295,17253,158772,141519,Yes
VVIT,Electrical and Electronics Engineering,KCET,2024,58606,72167,14305,20350,165428,145078,Yes
PESU,Aerospace Engineering,COMEDK,2023,162577,89487,8769,13162,273995,260833,Yes
JIT,Electrical and Electronics Engineering,COMEDK,2023,175646,90313,9142,23249,298350,275101,Yes
ACU,Mechanical Engineering,KCET,2024,69631,85665,8453,16098,179847,163749,No
VVIT,Data Science,COMEDK,2023,209516,65321,16137,25864,316838,290974,No
GMIT,Data Science,KCET,2024,77371,70715,8617,10115,166818,156703,No
RIT,Robotics and Automation Engineering,COMEDK,2024,232276,80926,11037,17841,342080,324239,Yes
CITGubbi,Civil Engineering,KCET,2024,76025,94529,9793,26688,207035,180347,No
KSIT,Data Science,COMEDK,2023,228277,61466,16370,13465,319578,306113,Yes
KLSGIT,Mechanical Engineering,KCET,2023,68644,62593,8972,19611,159820,140209,Yes
SITM,Data Science,COMEDK,2024,207167,80809,9455,23484,320915,297431,No
PRES,Artificial Intelligence and Data Science,COMEDK,2024,233908,81146,10423,11882,337359,325477,Yes
AECMandya,Aerospace Engineering,KCET,2024,58584,75136,16893,21540,172153,150613,Yes
SDMCET,Robotics and Automation Engineering,COMEDK,2024,220166,93542,13141,12019,338868,326849,Yes
REVA,Electrical and Electronics Engineering,COMEDK,2024,202659,72360,18389,27538,320946,293408,No
UVCE,Chemical Engineering,KCET,2023,67064,69770,12594,21764,171192,149428,Yes
SDMIT,Robotics and Automation Engineering,COMEDK,2023,240555,78180,18846,17045,354626,337581,Yes
DSCE,Electrical and Electronics Engineering,COMEDK,2024,245712,71832,11413,18277,347234,328957,No
VVCE,Electronics and Communication Engineering,COMEDK,2024,232630,65274,17687,17637,333228,315591,Yes
NIE,Chemical Engineering,KCET,2024,74344,80179,13032,23059,190614,167555,No
CITGubbi,Electrical and Electronics Engineering,COMEDK,2024,248260,67415,15571,15872,347118,331246,No
EastPoint,Robotics and Automation Engineering,KCET,2023,82628,69843,8998,29524,190993,161469,No
BITM,Civil Engineering,COMEDK,2024,184711,81284,16269,29287,311551,282264,No
AEC,Aerospace Engineering,COMEDK,2024,190514,92155,16699,19024,318392,299368,Yes
KLEIT,Electronics and Communication Engineering,COMEDK,2024,161689,79969,19132,12588,273378,260790,Yes
SDMIT,Biotechnology,COMEDK,2023,216997,65462,14391,18474,315324,296850,No
BMIT,Electrical and Electronics Engineering,KCET,2024,70898,74124,18831,20848,184701,163853,Yes
RVCE,Artificial Intelligence and Data Science,COMEDK,2023,187770,67938,9569,29199,294476,265277,Yes
CMRIT,Electrical and Electronics Engineering,KCET,2024,62033,76891,8758,19233,166915,147682,Yes
SITM,Chemical Engineering,KCET,2023,74860,74522,15640,11450,176472,165022,No
VemanaIT,Mechanical Engineering,COMEDK,2024,224472,76431,8057,20758,329718,308960,Yes
SJBCE,Artificial Intelligence and Data Science,COMEDK,2023,230382,87062,13835,11669,342948,331279,Yes
BMSCE,Electronics and Communication Engineering,KCET,2023,64431,89304,16472,18424,188631,170207,No
DBIT,Chemical Engineering,COMEDK,2023,207432,93237,12177,20178,333024,312846,Yes
RVUNIV,Information Science and Engineering,COMEDK,2023,204962,87138,15288,26919,334307,307388,Yes
RVUNIV,Biotechnology,KCET,2023,58952,68586,9474,28889,165901,137012,No
BITM,Electronics and Communication Engineering,KCET,2023,83241,66555,13817,14917,178530,163613,Yes
ACU,Robotics and Automation Engineering,COMEDK,2023,246577,81623,10609,11032,349841,338809,Yes
SJBCE,Computer Science and Engineering,COMEDK,2023,246462,84915,17978,27485,376840,349355,Yes
RIT,Robotics and Automation Engineering,COMEDK,2024,215778,93900,12600,24821,347099,322278,Yes
AECMandya,Electronics and Communication Engineering,COMEDK,2023,194087,73297,8918,14598,290900,276302,No
JSSSTU,Information Science and Engineering,KCET,2023,68434,88971,11336,26904,195645,168741,No
AEC,Artificial Intelligence and Data Science,COMEDK,2024,175294,72499,19306,15908,283007,267099,Yes
REVA,Information Science and Engineering,KCET,2023,63030,68440,15575,24600,171645,147045,No
MSRIT,Electrical and Electronics Engineering,KCET,2024,62662,63453,11848,16907,154870,137963,Yes
CMRIT,Artificial Intelligence and Data Science,KCET,2024,55977,75387,17074,21434,169872,148438,No
BMIT,Mechanical Engineering,KCET,2024,84217,62362,9581,14463,170623,156160,Yes
NHCE,Data Science,KCET,2024,50484,88200,17347,29364,185395,156031,Yes
GIT,Data Science,COMEDK,2024,245908,61421,15345,29982,352656,322674,Yes
BMSCE,Computer Science and Engineering,COMEDK,2023,191917,83863,14193,16549,306522,289973,Yes
KSIT,Artificial Intelligence and Data Science,COMEDK,2024,208540,78446,18374,15517,320877,305360,No
REVA,Biotechnology,COMEDK,2023,225118,83468,9756,23583,341925,318342,Yes
MVJCE,Electronics and Communication Engineering,KCET,2023,75717,65499,17046,13427,171689,158262,No
SITM,Electrical and Electronics Engineering,COMEDK,2023,193584,92098,19133,14623,319438,304815,No
SITM,Biotechnology,KCET,2023,73954,70230,9968,10996,165148,154152,No
BIT,Data Science,COMEDK,2024,163724,69978,17791,20971,272464,251493,Yes
EastPoint,Civil Engineering,KCET,2024,84012,83530,10928,20710,199180,178470,No
NIE,Aerospace Engineering,COMEDK,2024,242048,69305,13700,19675,344728,325053,No
SJBCE,Computer Science and Engineering,KCET,2024,62972,89788,8841,10926,172527,161601,No
NHCE,Biotechnology,COMEDK,2023,191341,60735,16370,13772,282218,268446,No
AITM,Robotics and Automation Engineering,KCET,2023,63162,89096,13570,23502,189330,165828,Yes
PESU,Mechanical Engineering,COMEDK,2023,191761,81126,9159,11619,293665,282046,No
VemanaIT,Electrical and Electronics Engineering,KCET,2023,62776,61699,9950,27325,161750,134425,Yes
UVCE,Civil Engineering,KCET,2023,56538,89923,14812,19915,181188,161273,Yes
EastPoint,Data Science,COMEDK,2024,231185,92143,14298,14583,352209,337626,No
JNNCE,Chemical Engineering,COMEDK,2024,205726,61387,18347,26864,312324,285460,No
BMIT,Aerospace Engineering,COMEDK,2023,225935,87578,15941,26038,355492,329454,No
CMRIT,Chemical Engineering,COMEDK,2024,226191,73066,11207,16949,327413,310464,Yes
DBIT,Computer Science and Engineering,COMEDK,2023,207374,80447,14826,28303,330950,302647,Yes
BNMIT,Electrical and Electronics Engineering,KCET,2024,64384,62028,9572,22500,158484,135984,Yes
JIT,Data Science,KCET,2024,64497,61574,11675,10546,148292,137746,Yes
GIT,Electrical and Electronics Engineering,COMEDK,2024,216480,91352,9057,29400,346289,316889,No
MSRUAS,Computer Science and Engineering,KCET,2023,60824,94170,15501,22820,193315,170495,Yes
SJBIT,Electrical and Electronics Engineering,COMEDK,2023,172320,73634,16081,14118,276153,262035,No
BMSCE,Robotics and Automation Engineering,COMEDK,2023,179968,63885,9235,22454,275542,253088,Yes
DSCE,Information Science and Engineering,COMEDK,2023,164084,93768,17468,27386,302706,275320,No
AEC,Aerospace Engineering,KCET,2024,70043,94206,17512,20929,202690,181761,Yes
RVCE,Computer Science and Engineering,KCET,2024,71354,66502,12736,17148,167740,150592,Yes
JNNCE,Electronics and Communication Engineering,KCET,2024,57390,91998,14303,13002,176693,163691,Yes
KLSGIT,Robotics and Automation Engineering,COMEDK,2023,172559,66402,16145,20064,275170,255106,Yes
DSCE,Information Science and Engineering,COMEDK,2024,229351,60719,8614,14612,313296,298684,Yes
RVCE,Data Science,COMEDK,2024,198215,60367,18397,23382,300361,276979,No
DrAIT,Civil Engineering,KCET,2024,51100,69317,9454,25117,154988,129871,Yes
BMSCE,Biotechnology,COMEDK,2023,214771,68094,9228,20887,312980,292093,Yes
BMIT,Artificial Intelligence and Data Science,COMEDK,2023,173213,80948,15878,20160,290199,270039,Yes
MVJCE,Civil Engineering,COMEDK,2023,189266,82668,12891,16078,300903,284825,Yes
AEC,Electrical and Electronics Engineering,COMEDK,2023,229123,63095,11478,17907,321603,303696,Yes
VVIT,Computer Science and Engineering,COMEDK,2023,168070,85832,18330,17251,289483,272232,Yes
VemanaIT,Electrical and Electronics Engineering,KCET,2024,78533,63319,16126,26656,184634,157978,Yes
AECMandya,Electrical and Electronics Engineering,COMEDK,2024,201846,80015,14051,15879,311791,295912,No
NIE,Robotics and Automation Engineering,KCET,2024,58388,74297,9534,29416,171635,142219,No
GMIT,Mechanical Engineering,KCET,2024,75563,86150,17039,25700,204452,178752,No
NMIT,Artificial Intelligence and Data Science,COMEDK,2024,203354,70690,12411,20013,306468,286455,No
PESCE,Data Science,COMEDK,2024,162943,90591,15286,19178,287998,268820,No
NCET,Chemical Engineering,COMEDK,2024,170216,63601,19638,23874,277329,253455,No
BMSCE,Chemical Engineering,KCET,2023,61056,74494,12987,26056,174593,148537,No
CITGubbi,Civil Engineering,COMEDK,2024,166285,86806,16013,25769,294873,269104,Yes
KSIT,Electrical and Electronics Engineering,COMEDK,2023,228054,77601,13051,18175,336881,318706,Yes
JSSSTU,Chemical Engineering,KCET,2023,66207,93924,15227,26376,201734,175358,Yes
CMRIT,Computer Science and Engineering,KCET,2024,51661,87790,17326,15349,172126,156777,No
KLEIT,Information Science and Engineering,KCET,2023,70154,75918,11323,11290,168685,157395,Yes
BIT,Data Science,KCET,2024,68803,67646,10212,22429,169090,146661,No
MSRIT,Electronics and Communication Engineering,COMEDK,2023,212727,86780,11529,24721,335757,311036,No
RVUNIV,Information Science and Engineering,COMEDK,2023,189861,81181,9644,22644,303330,280686,No
AEC,Artificial Intelligence and Data Science,KCET,2023,53079,69037,19264,16585,157965,141380,Yes
EastPoint,Information Science and Engineering,COMEDK,2023,179049,70447,12707,14090,276293,262203,No
SDMIT,Mechanical Engineering,KCET,2024,52926,92232,8144,29704,183006,153302,Yes
VemanaIT,Electrical and Electronics Engineering,KCET,2023,82615,69605,13346,27850,193416,165566,No
AEC,Chemical Engineering,COMEDK,2024,162842,60762,12427,17045,253076,236031,Yes
VIT,Electronics and Communication Engineering,KCET,2023,65376,77088,17471,21743,181678,159935,No
RVCE,Mechanical Engineering,KCET,2024,57936,72214,19811,28183,178144,149961,No
JSSSTU,Artificial Intelligence and Data Science,KCET,2024,71832,72688,10848,17410,172778,155368,No
VVIT,Information Science and Engineering,COMEDK,2023,197892,71848,16824,16354,302918,286564,No
BMIT,Chemical Engineering,KCET,2024,63369,84669,19118,24051,191207,167156,Yes
UVCE,Chemical Engineering,KCET,2024,67878,92830,15238,26591,202537,175946,Yes
RVCE,Electrical and Electronics Engineering,KCET,2024,81313,62211,13450,10684,167658,156974,Yes
CMRIT,Mechanical Engineering,COMEDK,2023,204311,79406,15347,12199,311263,299064,No
KSIT,Electronics and Communication Engineering,KCET,2024,63484,69440,9758,14737,157419,142682,Yes
NIE,Computer Science and Engineering,COMEDK,2023,220887,71229,8985,27778,328879,301101,No
DSCE,Electronics and Communication Engineering,KCET,2024,61822,68123,8458,24703,163106,138403,No
GIT,Electronics and Communication Engineering,KCET,2024,51430,66160,18279,27526,163395,135869,Yes
VVCE,Mechanical Engineering,KCET,2023,78278,88633,18762,10461,196134,185673,No
BIT,Robotics and Automation Engineering,KCET,2024,58587,81048,10993,11631,162259,150628,No
ACU,Civil Engineering,KCET,2023,58964,61356,13955,15098,149373,134275,No
RIT,Mechanical Engineering,KCET,2023,80090,87391,18596,28917,214994,186077,No
SDMCET,Information Science and Engineering,KCET,2023,71546,91724,12623,15576,191469,175893,Yes
RVCE,Computer Science and Engineering,KCET,2024,74276,80556,17909,23636,196377,172741,Yes
GIT,Aerospace Engineering,KCET,2023,77120,86035,19111,23258,205524,182266,Yes
VVIT,Artificial Intelligence and Data Science,KCET,2024,70875,79162,10774,12532,173343,160811,No
DSATM,Chemical Engineering,COMEDK,2024,226538,71742,10802,20962,330044,309082,Yes
SJBCE,Data Science,COMEDK,2024,185374,61036,13726,20530,280666,260136,No
RAIT,Robotics and Automation Engineering,KCET,2023,76663,86583,11307,24879,199432,174553,Yes
SIT,Civil Engineering,KCET,2023,80474,80068,11980,15808,188330,172522,No
DBIT,Artificial Intelligence and Data Science,KCET,2024,52974,80239,16023,28248,177484,149236,Yes
VemanaIT,Electrical and Electronics Engineering,KCET,2024,64625,71440,18865,22075,177005,154930,No
NCET,Civil Engineering,COMEDK,2024,180574,74511,9559,29438,294082,264644,No
KLSGIT,Computer Science and Engineering,KCET,2024,79977,72939,16792,15885,185593,169708,Yes
JSSSTU,Robotics and Automation Engineering,KCET,2024,82383,77235,10443,13319,183380,170061,Yes
RIT,Biotechnology,KCET,2023,75071,87478,13916,17116,193581,176465,No
VSM,Biotechnology,COMEDK,2024,218051,62427,15963,29504,325945,296441,Yes
KSIT,Chemical Engineering,KCET,2023,56511,74290,11652,24041,166494,142453,Yes
CITGubbi,Chemical Engineering,KCET,2023,68635,93106,12845,20379,194965,174586,No
DBIT,Artificial Intelligence and Data Science,COMEDK,2024,168064,60192,16839,17749,262844,245095,No
NMIT,Computer Science and Engineering,COMEDK,2023,172535,79019,13639,25571,290764,265193,Yes
RVCE,Data Science,KCET,2024,59459,91083,10724,29138,190404,161266,Yes
MSRIT,Data Science,COMEDK,2023,160918,64308,14272,11714,251212,239498,Yes
RAIT,Civil Engineering,KCET,2024,60543,82831,8485,25038,176897,151859,Yes
NHCE,Information Science and Engineering,KCET,2023,64551,81937,13134,24838,184460,159622,Yes
HKBK,Artificial Intelligence and Data Science,COMEDK,2024,178164,89419,16378,19117,303078,283961,No
KLEIT,Information Science and Engineering,COMEDK,2024,248535,89204,10641,11578,359958,348380,No
NCET,Chemical Engineering,KCET,2023,71566,91195,9959,13605,186325,172720,Yes
PESCE,Robotics and Automation Engineering,KCET,2023,58431,61184,19710,29064,168389,139325,Yes
RVUNIV,Mechanical Engineering,COMEDK,2023,234169,93481,13158,13002,353810,340808,Yes
CITGubbi,Aerospace Engineering,COMEDK,2024,170071,80400,15810,10424,276705,266281,No
AEC,Computer Science and Engineering,KCET,2024,51447,74742,8702,15827,150718,134891,No
BITM,Robotics and Automation Engineering,COMEDK,2023,222569,60835,9572,29978,322954,292976,Yes
JNNCE,Robotics and Automation Engineering,COMEDK,2023,244710,86255,19891,13773,364629,350856,No
VIT,Chemical Engineering,KCET,2023,70214,60783,15693,23462,170152,146690,No
VVIT,Aerospace Engineering,KCET,2024,83406,66553,9461,23699,183119,159420,Yes
VemanaIT,Electrical and Electronics Engineering,COMEDK,2024,175137,92480,17708,25918,311243,285325,No
BMIT,Civil Engineering,KCET,2024,60459,62749,14102,14299,151609,137310,Yes
AEC,Mechanical Engineering,KCET,2024,52201,64507,8062,17057,141827,124770,No
SITM,Aerospace Engineering,KCET,2023,83479,70731,13191,13316,180717,167401,Yes
BNMIT,Civil Engineering,COMEDK,2024,224684,70486,11018,17659,323847,306188,Yes
RIT,Computer Science and Engineering,KCET,2023,66797,91939,13762,26362,198860,172498,Yes
NMIT,Information Science and Engineering,KCET,2023,65555,93921,17400,12495,189371,176876,No
DBIT,Civil Engineering,COMEDK,2024,202237,67919,14669,22642,307467,284825,Yes
AEC,Robotics and Automation Engineering,COMEDK,2023,238658,67570,15936,14729,336893,322164,Yes
MSRIT,Computer Science and Engineering,COMEDK,2024,185742,63254,12552,27903,289451,261548,No
KLSGIT,Biotechnology,KCET,2023,84236,90664,19962,26600,221462,194862,No
KLSGIT,Chemical Engineering,COMEDK,2023,236519,60437,9479,20707,327142,306435,Yes
RVCE,Mechanical Engineering,KCET,2023,55246,83306,9123,29420,177095,147675,No
VVCE,Computer Science and Engineering,KCET,2023,67835,75092,19722,27558,190207,162649,No
DrAIT,Data Science,COMEDK,2024,205758,89370,14688,19645,329461,309816,Yes
KLSGIT,Aerospace Engineering,KCET,2024,53233,68409,17511,16464,155617,139153,No
SDMIT,Robotics and Automation Engineering,COMEDK,2024,199768,67051,11911,17295,296025,278730,Yes
DrAIT,Mechanical Engineering,COMEDK,2024,235362,82919,18914,17340,354535,337195,Yes
NCET,Electrical and Electronics Engineering,KCET,2023,65613,84330,18406,15844,184193,168349,Yes
BIT,Information Science and Engineering,COMEDK,2024,178475,64552,10385,23341,276753,253412,No
BIT,Artificial Intelligence and Data Science,COMEDK,2024,181320,88061,11787,17410,298578,281168,No
VemanaIT,Computer Science and Engineering,COMEDK,2024,163286,65569,13201,25224,267280,242056,Yes
ACU,Electronics and Communication Engineering,KCET,2024,54749,85613,12644,11925,164931,153006,Yes
JNNCE,Computer Science and Engineering,KCET,2023,69747,72456,9502,25335,177040,151705,No
KSIT,Electrical and Electronics Engineering,KCET,2024,56755,74892,9775,26197,167619,141422,Yes
NIE,Electronics and Communication Engineering,KCET,2023,50357,82923,17716,10399,161395,150996,No
BMSCE,Robotics and Automation Engineering,COMEDK,2023,235949,88780,10065,15070,349864,334794,No
AIT,Robotics and Automation Engineering,KCET,2024,69255,77451,10875,28572,186153,157581,No
JSSSTU,Electronics and Communication Engineering,COMEDK,2023,163812,75074,19983,14565,273434,258869,Yes
BMSIT,Artificial Intelligence and Data Science,KCET,2024,78266,77809,10431,15078,181584,166506,Yes
SITM,Chemical Engineering,COMEDK,2024,208471,77977,13370,12834,312652,299818,No
PRES,Biotechnology,COMEDK,2024,194353,87646,13846,16095,311940,295845,No
NCET,Aerospace Engineering,KCET,2023,70257,78429,15747,14548,178981,164433,Yes
RVUNIV,Computer Science and Engineering,COMEDK,2024,205939,61961,15677,28259,311836,283577,Yes
DSCE,Electrical and Electronics Engineering,COMEDK,2024,172316,86768,15361,26242,300687,274445,Yes
VVIT,Aerospace Engineering,KCET,2023,67790,89134,19408,13939,190271,176332,No
SDMCET,Computer Science and Engineering,COMEDK,2023,164143,75910,10483,28383,278919,250536,No
NHCE,Biotechnology,KCET,2024,71455,73136,16873,14154,175618,161464,Yes
AITM,Biotechnology,KCET,2024,69477,76880,8146,28260,182763,154503,Yes
DSCE,Biotechnology,COMEDK,2023,206861,73188,17991,28874,326914,298040,Yes
NCET,Civil Engineering,COMEDK,2023,232937,77631,8576,17253,336397,319144,Yes
NCET,Electronics and Communication Engineering,COMEDK,2024,180141,77913,14547,15845,288446,272601,No
NIE,Data Science,KCET,2023,64067,66675,9148,23820,163710,139890,No
NHCE,Robotics and Automation Engineering,KCET,2023,69244,90357,13670,15529,188800,173271,Yes
DSATM,Computer Science and Engineering,KCET,2023,76375,60406,16349,16313,169443,153130,Yes
DrAIT,Robotics and Automation Engineering,KCET,2024,63280,84508,17247,17782,182817,165035,Yes
SDMCET,Robotics and Automation Engineering,KCET,2024,65539,84377,10594,25096,185606,160510,Yes
MSRUAS,Chemical Engineering,COMEDK,2024,240612,86423,10723,22975,360733,337758,No
UVCE,Artificial Intelligence and Data Science,COMEDK,2024,173181,71406,14099,21552,280238,258686,No
NHCE,Artificial Intelligence and Data Science,COMEDK,2023,161288,86913,11408,23732,283341,259609,No
SDMIT,Robotics and Automation Engineering,KCET,2024,73861,75311,11173,20590,180935,160345,No
VVCE,Computer Science and Engineering,COMEDK,2024,226290,83162,12107,23725,345284,321559,Yes
KLSGIT,Chemical Engineering,KCET,2024,62885,61393,14704,23542,162524,138982,No
GMIT,Data Science,KCET,2024,79496,83359,13914,28508,205277,176769,Yes
MSRIT,Data Science,COMEDK,2024,175970,60760,17860,20342,274932,254590,Yes
SJBCE,Electronics and Communication Engineering,KCET,2023,69460,70871,8030,23272,171633,148361,Yes
JSSSTU,Biotechnology,KCET,2023,82954,62488,12930,24532,182904,158372,Yes
GMIT,Aerospace Engineering,COMEDK,2024,183166,88563,11140,27995,310864,282869,Yes
BIT,Aerospace Engineering,KCET,2023,75045,78402,18631,13758,185836,172078,Yes
SCEM,Data Science,KCET,2024,69388,65932,12295,17540,165155,147615,Yes
NHCE,Civil Engineering,COMEDK,2023,204073,62019,19145,21527,306764,285237,No
DSCE,Electronics and Communication Engineering,KCET,2024,68791,62368,9095,17261,157515,140254,Yes
ACU,Electronics and Communication Engineering,COMEDK,2024,226100,62624,15287,18045,322056,304011,Yes
VIT,Electrical and Electronics Engineering,COMEDK,2024,210801,93930,14841,17247,336819,319572,Yes
SJBIT,Robotics and Automation Engineering,KCET,2023,66716,91306,19740,21595,199357,177762,Yes
PRES,Artificial Intelligence and Data Science,COMEDK,2023,162360,86395,13647,12687,275089,262402,Yes
VemanaIT,Artificial Intelligence and Data Science,COMEDK,2023,221377,66386,13088,14168,315019,300851,Yes
UVCE,Aerospace Engineering,COMEDK,2023,237187,60750,17280,13509,328726,315217,No
BNMIT,Artificial Intelligence and Data Science,COMEDK,2024,241056,71171,14854,28018,355099,327081,No
ACU,Civil Engineering,COMEDK,2023,236434,92646,18377,17190,364647,347457,No
JIT,Data Science,KCET,2023,59673,94691,18140,22768,195272,172504,Yes
SDMCET,Mechanical Engineering,COMEDK,2023,246501,74017,16385,20528,357431,336903,No
BNMIT,Electrical and Electronics Engineering,KCET,2023,54594,67570,8667,19010,149841,130831,No
DSCE,Civil Engineering,KCET,2023,74387,80229,10411,20010,185037,165027,Yes
JNNCE,Biotechnology,COMEDK,2024,198175,63174,17138,22892,301379,278487,Yes
JNNCE,Civil Engineering,KCET,2024,58368,62323,8990,19917,149598,129681,Yes
JSSSTU,Computer Science and Engineering,KCET,2023,83292,91609,12321,24442,211664,187222,Yes
NMIT,Information Science and Engineering,COMEDK,2023,237812,83680,19841,29816,371149,341333,No
PRES,Biotechnology,COMEDK,2023,230228,69761,9780,14604,324373,309769,No
JNNCE,Data Science,COMEDK,2023,163988,61286,12299,11930,249503,237573,Yes
JSSSTU,Data Science,KCET,2024,67376,81980,17916,20283,187555,167272,No
JSSSTU,Chemical Engineering,COMEDK,2024,181393,63279,17156,23997,285825,261828,No
DBIT,Computer Science and Engineering,KCET,2024,71802,73142,16555,20646,182145,161499,Yes
AITM,Biotechnology,COMEDK,2023,167991,68158,13100,19790,269039,249249,Yes
SCEM,Artificial Intelligence and Data Science,KCET,2024,68530,71216,19257,13364,172367,159003,Yes
BIT,Electrical and Electronics Engineering,COMEDK,2024,198819,61528,8710,10073,279130,269057,Yes
SDMIT,Computer Science and Engineering,KCET,2024,55547,79478,9054,13649,157728,144079,No
DSCE,Robotics and Automation Engineering,COMEDK,2023,185145,63659,10958,10000,269762,259762,No
KSIT,Information Science and Engineering,KCET,2023,72054,75943,12355,20836,181188,160352,No
SIT,Aerospace Engineering,KCET,2023,56741,91102,14239,11511,173593,162082,No
SJBCE,Artificial Intelligence and Data Science,COMEDK,2023,219445,91154,12769,13253,336621,323368,No
NIE,Biotechnology,COMEDK,2023,192757,84408,9146,27541,313852,286311,Yes
RVCE,Information Science and Engineering,COMEDK,2023,168406,75208,13792,14752,272158,257406,Yes
SDMCET,Data Science,KCET,2023,52712,65581,17682,27712,163687,135975,Yes
EastPoint,Artificial Intelligence and Data Science,COMEDK,2024,181215,90477,8702,28365,308759,280394,No
NCET,Electronics and Communication Engineering,COMEDK,2024,209388,68621,11444,28395,317848,289453,No
NIE,Biotechnology,KCET,2023,69260,69378,11383,13152,163173,150021,No
JIT,Electronics and Communication Engineering,KCET,2024,74718,83578,16748,19314,194358,175044,No
CITGubbi,Civil Engineering,KCET,2024,58015,86520,10536,27510,182581,155071,No
JNNCE,Robotics and Automation Engineering,KCET,2024,75670,65562,18040,20827,180099,159272,Yes
JNNCE,Chemical Engineering,KCET,2024,79466,76261,13219,18891,187837,168946,No
BITM,Biotechnology,KCET,2024,59552,93339,9005,17150,179046,161896,Yes
YKCE,Information Science and Engineering,COMEDK,2023,222763,75376,15052,26428,339619,313191,Yes
RIT,Aerospace Engineering,COMEDK,2023,239300,82328,9618,25386,356632,331246,Yes
ACU,Electrical and Electronics Engineering,COMEDK,2024,215425,93702,8495,14775,332397,317622,Yes
GIT,Information Science and Engineering,KCET,2024,52342,92550,8683,26080,179655,153575,Yes
SDMIT,Biotechnology,KCET,2024,65697,65931,11966,21528,165122,143594,No
SJBCE,Biotechnology,COMEDK,2023,181085,64406,16809,22125,284425,262300,Yes
RNSIT,Artificial Intelligence and Data Science,KCET,2023,71736,94845,19764,11069,197414,186345,No
RAIT,Aerospace Engineering,KCET,2023,75668,93996,16476,27065,213205,186140,No
YKCE,Information Science and Engineering,COMEDK,2024,224469,83259,14196,28063,349987,321924,Yes
MVJCE,Civil Engineering,KCET,2023,84456,63901,18874,19001,186232,167231,No
MSRUAS,Artificial Intelligence and Data Science,COMEDK,2024,220897,86905,9471,24100,341373,317273,Yes
PESCE,Artificial Intelligence and Data Science,COMEDK,2023,244869,82180,19400,29210,375659,346449,No
SJBCE,Information Science and Engineering,COMEDK,2023,176125,73558,9438,16038,275159,259121,Yes
SITM,Civil Engineering,COMEDK,2024,238108,93082,18666,21289,371145,349856,No
REVA,Data Science,COMEDK,2024,190303,89688,9578,18336,307905,289569,Yes
AEC,Civil Engineering,KCET,2023,61909,61243,18705,21872,163729,141857,Yes
MSRIT,Mechanical Engineering,COMEDK,2023,178794,85191,16557,14420,294962,280542,No
REVA,Biotechnology,COMEDK,2024,186752,68800,16389,27767,299708,271941,No
SJBIT,Robotics and Automation Engineering,KCET,2024,57319,68113,14292,14919,154643,139724,No
MVJCE,Electronics and Communication Engineering,KCET,2024,61215,78204,12247,16280,167946,151666,Yes
SDMCET,Computer Science and Engineering,KCET,2024,65564,78279,18389,12382,174614,162232,No
DrAIT,Electronics and Communication Engineering,KCET,2023,54317,68536,14357,27378,164588,137210,Yes
BMSIT,Aerospace Engineering,KCET,2024,61240,89409,10279,18381,179309,160928,Yes
RNSIT,Artificial Intelligence and Data Science,KCET,2024,76445,66813,14957,23876,182091,158215,Yes
SIT,Artificial Intelligence and Data Science,KCET,2023,75245,64517,12198,13741,165701,151960,Yes
SJBCE,Artificial Intelligence and Data Science,KCET,2024,56719,66841,14536,16583,154679,138096,Yes
RNSIT,Computer Science and Engineering,KCET,2024,69249,75966,14431,16277,175923,159646,No
SJBCE,Biotechnology,KCET,2024,71142,75400,16176,22540,185258,162718,Yes
DSCE,Biotechnology,KCET,2023,80650,80660,17287,14428,193025,178597,No
HKBK,Aerospace Engineering,KCET,2023,66104,76528,18363,25760,186755,160995,No
AIT,Computer Science and Engineering,COMEDK,2024,165901,74665,12928,27045,280539,253494,No
PESU,Mechanical Engineering,KCET,2024,70791,91626,8729,15313,186459,171146,No
BITM,Mechanical Engineering,COMEDK,2024,197203,92035,17642,17873,324753,306880,Yes
EastPoint,Information Science and Engineering,KCET,2023,67258,80993,16593,14472,179316,164844,No
CMRIT,Artificial Intelligence and Data Science,COMEDK,2024,218574,63016,10919,27313,319822,292509,Yes
DBIT,Aerospace Engineering,COMEDK,2024,230933,73892,8103,16397,329325,312928,Yes
RVCE,Chemical Engineering,KCET,2024,72038,74700,11291,29065,187094,158029,Yes
MSRUAS,Biotechnology,KCET,2023,66624,77033,10994,20640,175291,154651,No
BMIT,Data Science,KCET,2023,68620,76356,12243,27041,184260,157219,No
AECMandya,Robotics and Automation Engineering,KCET,2024,63445,87094,14566,23434,188539,165105,No
MVJCE,Electrical and Electronics Engineering,COMEDK,2023,223347,62256,10918,21461,317982,296521,Yes
BMSCE,Chemical Engineering,COMEDK,2024,203770,84836,12214,21280,322100,300820,No
PESU,Chemical Engineering,COMEDK,2024,192444,78046,18227,19381,308098,288717,No
SITM,Chemical Engineering,COMEDK,2023,181486,84299,12077,17708,295570,277862,Yes
DBIT,Information Science and Engineering,KCET,2024,73180,90812,18815,19941,202748,182807,No
AECMandya,Robotics and Automation Engineering,COMEDK,2024,185348,86667,16742,20592,309349,288757,No
PESCE,Biotechnology,KCET,2023,59661,61410,10439,28741,160251,131510,Yes
BITM,Data Science,KCET,2024,69005,92762,12741,22625,197133,174508,No
JNNCE,Data Science,COMEDK,2023,200425,61964,11133,18893,292415,273522,Yes
YKCE,Electronics and Communication Engineering,COMEDK,2023,236770,84897,15745,19127,356539,337412,Yes
PESCE,Aerospace Engineering,KCET,2024,74977,92166,11132,19365,197640,178275,Yes
DSCE,Civil Engineering,COMEDK,2024,221716,82216,18229,23853,346014,322161,No
JIT,Computer Science and Engineering,COMEDK,2023,249940,89179,12928,15813,367860,352047,Yes
BMSIT,Robotics and Automation Engineering,COMEDK,2024,191567,83565,14756,19148,309036,289888,No
JIT,Information Science and Engineering,COMEDK,2024,231449,70578,13762,29134,344923,315789,No
HKBK,Artificial Intelligence and Data Science,COMEDK,2023,171777,68539,9696,14074,264086,250012,Yes
EastPoint,Information Science and Engineering,KCET,2024,75834,72280,12914,24073,185101,161028,No
KLEIT,Electronics and Communication Engineering,KCET,2023,60309,69545,9152,19716,158722,139006,Yes
VemanaIT,Computer Science and Engineering,KCET,2023,62159,86829,14228,14419,177635,163216,Yes
DSCE,Chemical Engineering,KCET,2023,75308,85321,17026,24085,201740,177655,No
GMIT,Electrical and Electronics Engineering,COMEDK,2023,214047,82337,8183,12501,317068,304567,Yes
EastPoint,Computer Science and Engineering,KCET,2024,66847,67680,16090,15163,165780,150617,Yes
AITM,Computer Science and Engineering,KCET,2023,64029,88660,16365,29268,198322,169054,Yes
PESCE,Artificial Intelligence and Data Science,COMEDK,2024,228742,89713,11817,12786,343058,330272,Yes
BMIT,Mechanical Engineering,KCET,2024,73313,70295,12870,13903,170381,156478,No
BMSCE,Computer Science and Engineering,COMEDK,2023,193945,62793,19032,23547,299317,275770,Yes
CITGubbi,Robotics and Automation Engineering,COMEDK,2024,207784,84770,18198,20646,331398,310752,No
BMIT,Civil Engineering,KCET,2023,64950,85211,16180,24063,190404,166341,Yes
NCET,Civil Engineering,KCET,2023,72484,69822,17666,28401,188373,159972,No
JNNCE,Computer Science and Engineering,KCET,2024,71512,78192,13368,28364,191436,163072,No
MVJCE,Mechanical Engineering,COMEDK,2024,170327,66429,13682,28692,279130,250438,Yes
BMIT,Aerospace Engineering,KCET,2024,56248,91171,18602,21793,187814,166021,Yes
NMIT,Aerospace Engineering,COMEDK,2023,183985,63560,10796,14020,272361,258341,No
EastPoint,Civil Engineering,KCET,2024,54300,65784,10445,21083,151612,130529,Yes
NHCE,Chemical Engineering,KCET,2024,59075,84352,16092,24379,183898,159519,Yes
JNNCE,Biotechnology,KCET,2023,76050,88272,19995,11749,196066,184317,Yes
RAIT,Aerospace Engineering,COMEDK,2024,224253,62634,11431,19296,317614,298318,Yes
SIT,Civil Engineering,COMEDK,2024,202785,86823,19604,26024,335236,309212,No
RAIT,Data Science,KCET,2024,55379,74166,18071,18953,166569,147616,No
BITM,Information Science and Engineering,KCET,2024,57299,83167,18104,10404,168974,158570,Yes
MSRUAS,Aerospace Engineering,COMEDK,2023,244082,81622,14702,24222,364628,340406,No
SIT,Robotics and Automation Engineering,KCET,2023,83120,94274,14294,10446,202134,191688,No
SJBCE,Electrical and Electronics Engineering,KCET,2024,82367,64412,12966,23906,183651,159745,No
BMSCE,Chemical Engineering,KCET,2023,69018,80320,10601,25813,185752,159939,Yes
DrAIT,Information Science and Engineering,KCET,2023,60251,72654,15435,10561,158901,148340,Yes
REVA,Biotechnology,COMEDK,2024,204617,93646,12402,26449,337114,310665,No
MVJCE,Artificial Intelligence and Data Science,KCET,2024,63155,68287,17633,13460,162535,149075,Yes
NHCE,Chemical Engineering,COMEDK,2023,187845,87742,15017,19452,310056,290604,Yes
BNMIT,Aerospace Engineering,COMEDK,2023,182362,75961,16427,19329,294079,274750,No
VVIT,Aerospace Engineering,COMEDK,2024,177058,89737,12409,12943,292147,279204,Yes
DBIT,Robotics and Automation Engineering,KCET,2024,71970,64766,9012,13720,159468,145748,Yes
GMIT,Mechanical Engineering,KCET,2023,73553,74454,19217,13009,180233,167224,Yes
SIT,Computer Science and Engineering,KCET,2023,73486,72136,10579,14421,170622,156201,No
BMSCE,Electrical and Electronics Engineering,COMEDK,2023,244384,83233,16976,18894,363487,344593,Yes
CMRIT,Computer Science and Engineering,KCET,2023,53915,81922,18927,22179,176943,154764,Yes
UVCE,Chemical Engineering,KCET,2023,53833,76196,9508,16693,156230,139537,No
KLEIT,Civil Engineering,COMEDK,2024,206426,84823,9439,19078,319766,300688,Yes
NIE,Electronics and Communication Engineering,COMEDK,2024,167443,64917,13181,24623,270164,245541,Yes
MVJCE,Electrical and Electronics Engineering,COMEDK,2024,229239,73111,18280,16856,337486,320630,No
SJBIT,Mechanical Engineering,COMEDK,2023,201121,83324,18976,27422,330843,303421,No
BNMIT,Chemical Engineering,COMEDK,2024,241502,69221,8232,27308,346263,318955,No
AECMandya,Aerospace Engineering,KCET,2024,56966,82973,17807,10023,167769,157746,No
PESU,Artificial Intelligence and Data Science,KCET,2023,83719,70942,13347,20943,188951,168008,No
SDMIT,Information Science and Engineering,KCET,2024,53058,86270,15861,24847,180036,155189,Yes
EastPoint,Chemical Engineering,COMEDK,2023,183029,83456,11523,13033,291041,278008,No
NMIT,Biotechnology,COMEDK,2023,198181,74897,18943,21596,313617,292021,No
RVUNIV,Civil Engineering,COMEDK,2024,161403,76196,10000,21740,269339,247599,No
VIT,Electronics and Communication Engineering,KCET,2024,71279,68915,18854,26979,186027,159048,Yes
VIT,Data Science,KCET,2023,70863,79758,18269,24633,193523,168890,No
UVCE,Artificial Intelligence and Data Science,COMEDK,2024,204142,83222,14038,21231,322633,301402,No
VemanaIT,Mechanical Engineering,COMEDK,2023,188834,73066,18785,18746,299431,280685,Yes
EastPoint,Robotics and Automation Engineering,COMEDK,2024,210120,71248,19040,17248,317656,300408,Yes
KLEIT,Artificial Intelligence and Data Science,COMEDK,2023,246376,65037,18795,23555,353763,330208,No
MVJCE,Electrical and Electronics Engineering,KCET,2023,80690,80945,16142,10528,188305,177777,No
BMSCE,Information Science and Engineering,KCET,2024,61366,72291,16812,11626,162095,150469,No
CITGubbi,Computer Science and Engineering,KCET,2023,58501,74364,16760,14654,164279,149625,Yes
SCEM,Electronics and Communication Engineering,COMEDK,2024,219888,88515,14124,24684,347211,322527,Yes
PESCE,Electronics and Communication Engineering,KCET,2024,81312,69573,19364,15567,185816,170249,Yes
DrAIT,Computer Science and Engineering,COMEDK,2023,186148,70369,18955,21800,297272,275472,No
MSRUAS,Biotechnology,KCET,2023,57524,69740,15738,21072,164074,143002,No
BNMIT,Computer Science and Engineering,KCET,2023,77680,63309,14602,17953,173544,155591,Yes
SJBCE,Electronics and Communication Engineering,COMEDK,2024,223698,74325,14315,16823,329161,312338,Yes
JSSSTU,Civil Engineering,KCET,2023,73827,91363,16498,21384,203072,181688,No
GMIT,Mechanical Engineering,COMEDK,2024,176338,70808,11762,14011,272919,258908,Yes
JNNCE,Electronics and Communication Engineering,COMEDK,2024,232874,61790,19759,13182,327605,314423,Yes
RNSIT,Artificial Intelligence and Data Science,KCET,2023,79793,94296,16154,12274,202517,190243,Yes
BITM,Electronics and Communication Engineering,KCET,2024,61690,65363,16243,29235,172531,143296,Yes
SJBCE,Biotechnology,KCET,2024,84254,69338,19538,20674,193804,173130,No
AITM,Electrical and Electronics Engineering,KCET,2024,55003,67779,10415,14481,147678,133197,Yes
PESCE,Mechanical Engineering,COMEDK,2024,172584,93022,8314,24467,298387,273920,Yes
NMIT,Robotics and Automation Engineering,KCET,2023,81753,62578,10608,25913,180852,154939,No
PESCE,Biotechnology,COMEDK,2023,227904,64852,9482,12189,314427,302238,No
BNMIT,Mechanical Engineering,KCET,2024,75788,78172,11217,12813,177990,165177,No
DSCE,Mechanical Engineering,COMEDK,2023,247078,64983,11189,14773,338023,323250,No
SJBIT,Electrical and Electronics Engineering,COMEDK,2024,200404,60998,18843,13995,294240,280245,No
SJBCE,Aerospace Engineering,COMEDK,2024,184814,90369,18353,23789,317325,293536,No
DSCE,Electrical and Electronics Engineering,COMEDK,2023,217057,91253,8716,29147,346173,317026,No
CITGubbi,Mechanical Engineering,COMEDK,2023,180081,80430,16964,18908,296383,277475,No
CITGubbi,Aerospace Engineering,KCET,2023,75578,79664,8517,12574,176333,163759,No
ACU,Robotics and Automation Engineering,COMEDK,2024,240430,65719,11288,23455,340892,317437,Yes
VemanaIT,Robotics and Automation Engineering,COMEDK,2023,165222,75281,11688,15716,267907,252191,No
HKBK,Chemical Engineering,COMEDK,2023,202205,80103,11056,11194,304558,293364,Yes
VVIT,Electrical and Electronics Engineering,KCET,2024,51623,75135,10448,24451,161657,137206,No
CITGubbi,Information Science and Engineering,COMEDK,2024,194355,86904,15036,22617,318912,296295,No
EastPoint,Electrical and Electronics Engineering,COMEDK,2023,184461,86569,11828,22166,305024,282858,No
MSRUAS,Civil Engineering,KCET,2023,57585,91566,19915,26144,195210,169066,No
SDMIT,Biotechnology,KCET,2023,60603,92969,12837,16940,183349,166409,No
SJBCE,Aerospace Engineering,COMEDK,2024,185773,75609,12080,11612,285074,273462,Yes
YKCE,Robotics and Automation Engineering,COMEDK,2023,176894,68529,11696,15340,272459,257119,No
AIT,Computer Science and Engineering,COMEDK,2023,162431,62991,10183,20240,255845,235605,Yes
JIT,Chemical Engineering,COMEDK,2024,161588,82283,19456,25715,289042,263327,Yes
UVCE,Data Science,KCET,2023,81555,84822,12994,13373,192744,179371,No
PESU,Civil Engineering,COMEDK,2023,185419,65125,10603,12273,273420,261147,Yes
SITM,Electronics and Communication Engineering,KCET,2024,65311,69923,9071,15740,160045,144305,No
PESU,Robotics and Automation Engineering,KCET,2023,64615,86563,12171,15097,178446,163349,Yes
BIT,Data Science,KCET,2024,78311,86732,13391,25909,204343,178434,Yes
REVA,Electronics and Communication Engineering,COMEDK,2024,169312,76168,8358,19307,273145,253838,Yes
RAIT,Mechanical Engineering,COMEDK,2024,237984,88527,16754,12391,355656,343265,No
SCEM,Civil Engineering,KCET,2023,75210,93102,13907,19656,201875,182219,Yes
BMIT,Civil Engineering,COMEDK,2023,184209,93726,16886,25659,320480,294821,Yes
DSCE,Information Science and Engineering,KCET,2023,80389,79534,19491,29128,208542,179414,No
SJBIT,Electrical and Electronics Engineering,COMEDK,2024,202394,71788,9393,25405,308980,283575,Yes
REVA,Chemical Engineering,KCET,2023,82862,63892,10945,12503,170202,157699,No
ACU,Artificial Intelligence and Data Science,KCET,2024,53937,62632,16861,20590,154020,133430,Yes
GIT,Civil Engineering,COMEDK,2023,172063,81619,16830,25056,295568,270512,No
VVIT,Electronics and Communication Engineering,COMEDK,2024,190454,84669,13449,25845,314417,288572,No
RNSIT,Civil Engineering,COMEDK,2023,164717,83126,16343,12745,276931,264186,No
EastPoint,Data Science,KCET,2023,51658,71440,15424,11693,150215,138522,No
BMIT,Robotics and Automation Engineering,KCET,2024,75036,63440,19629,12148,170253,158105,No
SJBCE,Mechanical Engineering,KCET,2024,50174,90870,15639,14895,171578,156683,No
YKCE,Chemical Engineering,KCET,2024,50125,78816,19289,25311,173541,148230,No
MVJCE,Artificial Intelligence and Data Science,COMEDK,2023,225633,67897,9094,27459,330083,302624,No
AIT,Biotechnology,KCET,2024,52522,85085,12179,22928,172714,149786,No
BMIT,Information Science and Engineering,COMEDK,2023,197253,88697,16803,10820,313573,302753,No
CITGubbi,Chemical Engineering,KCET,2023,80708,64765,8048,25037,178558,153521,No
AITM,Aerospace Engineering,KCET,2023,80035,85379,19601,24486,209501,185015,Yes
BIT,Biotechnology,KCET,2024,71807,76613,16844,23678,188942,165264,Yes
DBIT,Electrical and Electronics Engineering,COMEDK,2024,214133,82216,11272,15567,323188,307621,No
SCEM,Civil Engineering,COMEDK,2023,210412,65069,13378,18050,306909,288859,Yes
AITM,Computer Science and Engineering,KCET,2023,73091,82382,10471,29883,195827,165944,No
SIT,Artificial Intelligence and Data Science,KCET,2023,59803,70229,16659,16043,162734,146691,Yes
MSRIT,Artificial Intelligence and Data Science,COMEDK,2023,179653,83029,11374,21649,295705,274056,No
SJBIT,Computer Science and Engineering,COMEDK,2023,231748,62022,12385,13454,319609,306155,No
RNSIT,Biotechnology,KCET,2024,50636,73827,15824,19418,159705,140287,No
BIT,Electronics and Communication Engineering,KCET,2023,72461,66205,10923,16751,166340,149589,No
NMIT,Mechanical Engineering,KCET,2024,61918,84621,15482,14755,176776,162021,Yes
VIT,Electrical and Electronics Engineering,COMEDK,2024,204633,77221,19183,15227,316264,301037,Yes
SDMCET,Electronics and Communication Engineering,COMEDK,2023,187902,70850,12602,27932,299286,271354,No
YKCE,Electrical and Electronics Engineering,KCET,2024,77308,85940,13326,17066,193640,176574,No
RIT,Electronics and Communication Engineering,KCET,2023,56114,79140,10103,10809,156166,145357,No
DSCE,Electrical and Electronics Engineering,KCET,2023,73606,84179,17613,14433,189831,175398,Yes
KLEIT,Aerospace Engineering,KCET,2024,84427,65700,10423,29433,189983,160550,Yes
MSRIT,Aerospace Engineering,KCET,2023,50248,68703,12856,17987,149794,131807,No
VVIT,Civil Engineering,KCET,2024,63063,74428,15175,29510,182176,152666,Yes
SJBIT,Electrical and Electronics Engineering,COMEDK,2023,179253,75838,9693,29827,294611,264784,Yes
JNNCE,Electrical and Electronics Engineering,KCET,2024,79871,86632,13897,22681,203081,180400,Yes
PESU,Robotics and Automation Engineering,KCET,2024,61172,86528,9183,15554,172437,156883,No
NHCE,Mechanical Engineering,KCET,2023,70964,66859,15716,23350,176889,153539,No
SJBCE,Artificial Intelligence and Data Science,KCET,2023,72363,89611,16525,21827,200326,178499,Yes
PESCE,Aerospace Engineering,KCET,2024,74329,60509,10261,23904,169003,145099,No
GIT,Electronics and Communication Engineering,COMEDK,2024,222005,79220,11339,23272,335836,312564,No
AITM,Electronics and Communication Engineering,COMEDK,2024,164387,90004,14860,15853,285104,269251,No
PRES,Robotics and Automation Engineering,COMEDK,2023,228812,63728,19082,14517,326139,311622,Yes
JIT,Mechanical Engineering,COMEDK,2024,180234,75024,12112,25903,293273,267370,Yes
GIT,Mechanical Engineering,COMEDK,2023,211028,71902,14185,28211,325326,297115,Yes
BIT,Civil Engineering,KCET,2023,80766,72012,14509,18957,186244,167287,Yes
DBIT,Civil Engineering,KCET,2024,69898,89689,12566,16397,188550,172153,No
RNSIT,Civil Engineering,COMEDK,2023,205184,94459,17713,24349,341705,317356,No
JNNCE,Electrical and Electronics Engineering,COMEDK,2024,216912,68410,19002,14591,318915,304324,No
VemanaIT,Electrical and Electronics Engineering,KCET,2024,52070,83045,9860,29373,174348,144975,No
SJBIT,Chemical Engineering,COMEDK,2023,225667,89100,19935,22286,356988,334702,Yes
CITGubbi,Artificial Intelligence and Data Science,COMEDK,2024,231537,77451,16147,28652,353787,325135,Yes
